Zipcode,Total_POP,TMale,TMale21 ,TMale35,TMale65,TFemale21,TFemale35,TFemale65,TFemal
71937,1988,1014,0,56,19,0,49,61,974
72044,670,282,10,0,8,0,0,21,388
56171,1792,880,9,40,32,6,23,15,912
52585,1018,500,0,35,11,0,42,10,518
47520,2854,1430,12,68,57,26,51,89,1424
49464,28770,14157,235,772,195,169,1049,319,14613
49919,246,141,0,2,9,0,7,2,105
52401,2168,1348,40,113,8,0,52,12,820
35979,1608,841,0,42,0,0,30,49,767
36350,6628,3108,6,141,59,56,230,95,3520
38401,59009,27993,249,2034,581,371,1948,879,31016
55302,7093,3503,24,132,127,41,138,128,3590
29607,40940,19038,230,1110,224,386,1504,500,21902
31826,2238,1019,13,78,11,18,86,47,1219
18947,5996,3081,59,147,93,8,121,83,2915
14043,24420,12302,70,613,209,174,636,269,12118
15482,397,198,0,0,0,7,7,5,199
33446,24983,11885,75,287,539,28,343,382,13098
27915,665,401,0,0,0,0,0,0,264
26253,4401,2249,12,118,28,2,120,36,2152
2472,35387,16425,181,1385,523,221,1847,509,18962
623,42427,20286,283,1094,490,440,1550,465,22141
52163,308,150,2,12,2,0,5,5,158
52216,1192,598,3,14,10,0,21,12,594
53031,0,0,0,0,0,0,0,0,0
60651,63218,29134,459,1711,334,649,2514,768,34084
62090,1293,571,0,31,8,0,25,6,722
62420,4762,2325,28,125,59,5,188,114,2437
64503,12231,5810,16,370,131,74,271,180,6421
65325,3437,1692,13,124,10,0,47,79,1745
65638,495,232,0,7,6,12,5,16,263
74801,22194,10828,145,657,201,128,687,428,11366
75475,148,73,0,5,0,0,14,9,75
75757,12408,6377,147,412,93,207,506,290,6031
63436,1457,709,2,63,15,9,22,22,748
57440,622,292,2,8,4,20,18,11,330
72112,10966,5131,50,301,68,70,548,210,5835
72714,12954,6344,7,442,174,32,616,218,6610
99671,473,267,5,6,4,3,10,1,206
97304,31701,15843,329,957,519,301,1152,440,15858
97414,202,158,0,0,0,0,0,0,44
81148,312,148,10,3,1,6,9,2,164
81423,1751,894,0,68,13,0,35,19,857
81505,10298,5191,22,241,104,50,333,83,5107
81624,1408,775,21,50,14,2,45,21,633
82718,26340,13505,121,1215,183,210,1021,354,12835
89317,278,167,0,0,0,0,18,0,111
93234,7260,3584,53,209,64,33,243,123,3676
93529,508,328,0,0,54,0,0,0,180
94931,8601,3857,108,263,89,124,215,121,4744
95322,10546,5118,122,214,85,21,427,57,5428
30334,0,0,0,0,0,0,0,0,0
36879,1936,910,1,10,51,0,47,17,1026
38017,54372,26361,151,1475,873,148,1783,775,28011
46787,3732,1866,0,173,30,25,177,33,1866
31606,3543,1808,39,160,7,9,56,140,1735
55992,4911,2415,28,121,44,33,171,28,2496
13827,11315,5633,73,356,286,88,252,245,5682
14739,2746,1375,7,112,31,18,51,19,1371
15227,28633,13943,165,1085,265,129,967,543,14690
16877,2049,1019,10,57,15,14,60,45,1030
32621,5394,2639,36,97,81,0,107,92,2755
21634,200,101,0,0,5,0,0,0,99
35004,11762,5842,143,429,135,30,339,188,5920
27834,56458,26134,571,1603,622,801,2054,724,30324
28373,2602,1249,22,88,11,0,114,12,1353
11703,15952,7140,59,486,206,145,403,265,8812
2909,40572,20148,256,1606,251,499,1464,320,20424
4617,814,360,0,0,26,5,9,19,454
7961,0,0,0,0,0,0,0,0,0
767,34166,16549,208,1205,430,368,867,539,17617
36744,6487,2950,0,229,137,78,232,78,3537
37616,4606,2388,3,152,65,3,199,34,2218
50519,623,305,0,25,5,0,6,7,318
90038,27660,14742,289,1592,141,197,904,239,12918
90063,52951,26376,502,2519,488,403,1837,509,26575
84530,388,129,0,0,0,0,0,27,259
38138,24972,12042,113,682,264,83,953,495,12930
56517,244,116,0,1,0,0,7,0,128
58323,76,41,0,0,0,0,0,1,35
58533,1021,488,6,34,16,0,25,8,533
58771,603,323,0,6,4,0,0,17,280
58793,528,284,3,11,3,1,23,10,244
53189,26685,13327,154,1029,381,107,980,398,13358
56091,343,161,0,8,7,0,15,6,182
43733,0,0,0,0,0,0,0,0,0
47613,3156,1576,35,67,32,2,63,12,1580
51049,495,259,0,11,5,0,14,10,236
53014,7787,3972,34,208,140,26,241,112,3815
43334,6317,3371,30,222,152,2,162,15,2946
62206,15121,7106,11,646,114,307,951,265,8015
64155,22917,11259,168,982,229,76,646,202,11658
48215,11979,5827,77,213,116,49,354,197,6152
30531,10818,5343,20,313,120,65,410,172,5475
23176,331,121,0,0,0,0,0,64,210
16830,13371,6425,61,423,225,82,324,183,6946
16876,310,171,4,9,2,0,6,10,139
12442,785,341,0,24,0,17,0,18,444
13334,1121,629,4,60,9,0,80,23,492
13626,2245,1117,37,57,12,19,56,11,1128
24620,2594,1270,33,73,52,11,80,54,1324
25521,811,433,0,27,0,0,13,17,378
17866,10362,6340,93,451,130,26,195,224,4022
18466,17472,8576,197,464,225,147,660,254,8896
28039,86,42,0,0,0,0,0,11,44
28206,11919,5616,43,477,78,131,299,144,6303
28282,0,0,0,0,0,0,0,0,0
96778,15125,7681,111,454,229,107,472,387,7444
97538,1650,887,0,43,56,0,25,16,763
98520,24116,13171,134,975,305,81,767,293,10945
98579,13394,6625,94,343,194,10,507,283,6769
93701,10274,5069,107,254,65,86,408,61,5205
16601,32019,15947,141,889,367,259,1133,540,16072
17301,4315,2076,9,106,41,3,141,82,2239
32503,34520,16946,538,877,355,713,803,417,17574
36268,5814,2633,6,116,34,44,315,42,3181
24292,393,206,1,7,5,0,11,5,187
26267,298,154,16,16,10,0,13,0,144
27341,5263,2753,104,124,54,0,154,65,2510
8887,1004,422,0,23,7,0,50,34,582
71423,4335,2324,76,68,19,30,114,47,2011
48226,6935,3980,129,368,55,22,223,63,2955
48503,25903,12034,189,598,147,267,694,315,13869
49756,3464,1769,4,39,95,13,78,66,1695
50675,2315,1157,4,28,39,16,68,13,1158
78650,1672,808,0,43,22,13,52,31,864
83121,0,0,0,0,0,0,0,0,0
93255,556,241,0,0,0,0,0,16,315
75010,28974,14249,169,938,266,86,1011,421,14725
76054,12119,5804,80,329,235,80,358,186,6315
68743,581,313,0,5,8,0,10,7,268
85268,24812,11585,26,555,536,16,417,627,13227
45841,818,456,0,19,11,2,23,21,362
65047,1372,622,0,53,24,0,88,42,750
67954,770,369,4,20,6,2,12,6,401
68792,385,176,0,3,4,1,7,6,209
75961,15644,7277,407,437,109,623,519,202,8367
76452,108,71,0,12,10,0,0,0,37
80235,8742,4349,81,400,57,7,231,98,4393
80620,19407,9806,103,607,103,86,587,135,9601
81001,30764,15842,207,864,204,289,974,350,14922
83401,43012,21326,352,1404,357,139,1522,392,21686
57481,464,312,0,3,0,0,2,0,152
58723,254,159,2,0,4,0,3,11,95
78349,603,301,12,33,4,0,0,0,302
79381,1601,793,9,66,15,0,69,25,808
63626,1629,912,0,0,0,0,0,0,717
23486,39,16,0,0,0,0,0,0,23
24069,2087,1024,43,72,25,14,22,30,1063
15773,537,262,0,5,16,0,3,0,275
16665,294,156,0,9,0,0,32,1,138
16927,586,323,0,10,16,0,4,5,263
30746,940,467,0,0,14,0,49,33,473
32830,5,5,0,0,0,0,0,0,0
33756,33649,15843,190,1050,607,368,957,357,17806
20868,864,381,25,39,29,15,15,0,483
21849,3299,1677,0,45,20,0,120,9,1622
17570,206,130,0,32,0,0,17,0,76
18456,350,180,0,2,5,0,14,3,170
18834,3505,1753,31,51,61,13,122,36,1752
19134,61509,29598,240,2595,464,446,1910,600,31911
29164,5190,2683,16,74,75,27,222,64,2507
54020,6898,3274,38,216,82,35,263,129,3624
55125,43438,20797,325,1388,327,290,1466,684,22641
56039,970,476,1,32,11,2,23,14,494
39154,10347,5207,175,234,94,81,244,173,5140
8817,44823,22689,193,2193,365,203,1665,753,22134
10965,15517,7481,158,317,85,126,393,171,8036
12151,792,376,0,17,8,3,18,28,416
12195,121,31,0,0,8,0,0,0,90
18216,1038,506,9,43,13,0,21,16,532
2169,56584,26826,225,1967,619,157,2279,880,29758
2375,10218,4797,22,220,90,53,251,127,5421
2639,3160,1629,19,72,27,0,92,85,1531
77590,31498,15039,333,910,278,188,1066,295,16459
78013,6143,3201,82,171,88,185,137,65,2942
68832,2203,1124,7,30,39,0,62,24,1079
62611,1115,580,0,27,14,0,27,18,535
70005,25200,12130,214,674,402,163,788,329,13070
71048,54,30,0,0,5,0,0,1,24
26865,257,193,0,29,0,0,0,13,64
28007,714,333,0,0,0,11,38,20,381
54964,979,475,3,18,22,4,6,15,504
56011,9311,4543,45,378,60,29,427,106,4768
50167,697,313,7,18,0,1,53,18,384
80202,13756,7770,113,705,103,137,274,199,5986
84305,788,435,7,20,3,2,28,2,353
85382,39556,18581,251,1192,352,437,1139,774,20975
93465,8914,4225,38,160,77,0,184,173,4689
95383,3828,2103,2,88,89,15,206,145,1725
95665,4664,2392,10,91,94,0,323,137,2272
90301,37291,18288,217,1204,324,269,1444,331,19003
60974,294,136,0,6,5,0,12,3,158
62001,1796,838,0,59,0,2,20,17,958
92543,37615,17426,156,809,308,235,1237,604,20189
14617,22589,10915,81,513,368,67,705,468,11674
15238,13019,6396,80,391,294,16,412,291,6623
21767,1019,380,0,0,0,0,56,23,639
2886,29007,13393,49,741,281,223,789,383,15614
4981,2419,1194,31,47,32,24,50,46,1225
5061,1447,767,61,45,12,29,4,8,680
5648,439,232,0,25,13,0,11,9,207
982,14241,6503,89,336,131,114,498,235,7738
37407,10535,5288,26,305,57,109,451,139,5247
38704,0,0,0,0,0,0,0,0,0
30415,6161,2755,8,208,61,48,183,46,3406
31525,29803,13900,243,824,171,125,764,446,15903
32798,2595,1442,0,0,13,0,0,33,1153
43719,2689,1447,6,33,34,34,34,40,1242
43748,2752,1468,15,107,37,46,110,26,1284
47649,1519,788,6,60,17,0,57,22,731
35576,2958,1518,31,98,39,24,87,43,1440
36535,30187,14015,84,889,493,197,1141,637,16172
37367,12152,7231,224,463,146,20,249,158,4921
27107,47610,22193,257,1196,447,358,1531,570,25417
24324,1757,858,0,15,46,19,67,28,899
41132,335,146,0,0,0,0,0,10,189
43506,14192,6593,47,474,196,57,320,208,7599
28584,12265,5957,96,414,199,13,345,287,6308
29325,15562,7337,219,312,228,197,340,338,8225
95965,20460,10542,178,539,186,166,642,215,9918
97844,4221,2184,7,69,24,14,114,81,2037
83429,714,366,0,0,25,0,4,25,348
78148,21750,10478,57,611,214,131,767,385,11272
78588,204,123,0,9,17,0,2,0,81
65777,437,243,0,16,45,0,0,0,194
67050,1939,1068,3,77,16,23,63,20,871
67645,900,471,0,8,49,9,2,32,429
56522,455,229,1,26,3,0,18,11,226
58405,428,192,36,0,0,40,0,0,236
60025,41014,19786,138,1056,483,119,1431,640,21228
50278,788,412,0,22,17,0,8,15,376
50569,609,276,0,10,20,5,19,40,333
52156,591,307,3,14,2,0,30,2,284
51530,621,328,5,13,4,9,12,15,293
51656,52,24,0,1,1,0,5,3,28
55381,2003,1035,11,59,22,8,70,26,968
30263,58705,28600,340,1789,518,216,1872,657,30105
30728,20609,10224,113,645,197,225,747,290,10385
31714,5866,2845,36,276,46,9,187,122,3021
33315,13362,7032,101,409,98,0,356,271,6330
34209,34794,16862,119,781,537,141,582,500,17932
37050,1325,710,3,39,31,3,14,65,615
15665,1494,593,0,57,0,0,15,33,901
17265,621,337,3,44,12,0,52,13,284
19511,94,63,0,8,0,0,9,0,31
8406,10232,4851,167,232,129,167,255,145,5381
29520,13892,6359,191,183,144,0,398,220,7533
29615,37681,17858,302,1262,254,181,1129,541,19823
11716,9957,5075,57,377,98,61,196,162,4882
12719,1284,648,23,51,38,23,20,14,636
23435,30018,14673,181,1156,357,290,1138,386,15345
24550,7772,3932,18,213,114,0,182,153,3840
25918,4478,2275,28,159,30,7,155,73,2203
27028,26044,12866,89,896,400,198,905,457,13178
95655,4178,2017,78,122,20,62,201,46,2161
98604,37036,17925,174,872,377,253,1155,513,19111
87413,16955,8601,104,506,199,136,372,119,8354
2382,14961,7284,63,418,97,135,500,131,7677
2719,16026,7622,85,625,215,71,469,156,8404
79370,1590,858,11,72,12,0,25,48,732
71226,1951,942,11,96,67,0,20,22,1009
72542,3712,1841,4,83,77,8,80,93,1871
72686,122,93,0,0,0,0,0,0,29
72927,8338,4120,7,280,108,104,359,135,4218
83355,4450,2316,66,166,28,20,104,92,2134
83641,3400,1723,12,93,39,5,133,40,1677
84307,1137,603,0,22,17,2,35,17,534
60139,34364,17164,284,1308,393,179,1313,492,17200
60438,28960,12583,148,839,403,395,1014,590,16377
68636,1299,625,13,26,22,0,10,35,674
66532,759,384,0,24,3,1,13,16,375
55723,2226,1111,7,27,67,0,49,47,1115
39478,2100,1062,0,16,9,20,8,49,1038
61107,30905,14907,162,884,319,22,827,545,15998
58072,7587,3750,74,161,112,102,212,69,3837
59333,14,7,0,0,0,0,0,3,7
42163,84,0,0,0,0,0,47,0,84
43735,438,195,0,76,0,0,54,8,243
44403,3904,1875,0,100,24,11,109,58,2029
50581,935,459,0,26,11,7,30,15,476
33850,7802,3832,0,187,93,79,276,126,3970
35593,1691,932,28,10,34,0,20,49,759
40118,9788,4734,97,257,80,156,365,141,5054
40371,3128,1480,0,74,41,16,112,95,1648
15564,67,22,0,3,1,2,2,1,45
15944,3081,1573,4,121,61,17,103,46,1508
17052,1526,784,24,47,24,8,44,13,742
30747,15438,8341,176,612,119,45,550,136,7097
32746,43232,21132,153,1370,582,175,1810,580,22100
33801,35305,17404,495,1041,392,496,923,500,17901
10998,3157,1662,49,100,9,0,96,11,1495
21623,2000,1082,0,89,9,6,64,29,918
11560,6365,2989,12,104,54,45,139,98,3376
18355,1553,862,0,11,8,32,13,20,691
36538,407,237,0,28,12,0,0,6,170
37322,8359,4163,14,299,112,48,177,136,4196
43081,61572,29143,367,2446,609,267,1868,646,32429
27105,40530,19672,204,1151,351,190,1196,513,20858
46731,595,263,0,29,9,0,26,0,332
2875,546,282,0,0,0,0,21,17,264
4630,1384,642,13,34,32,20,48,26,742
6053,34772,17426,494,1239,313,201,1112,377,17346
714,17998,8455,158,459,204,110,657,296,9543
2126,29591,13954,153,769,303,141,1535,366,15637
14150,40825,19381,263,1030,342,211,1057,808,21444
30339,23373,10959,86,873,136,205,879,226,12414
32361,256,136,0,18,0,0,0,0,120
33523,18387,8770,125,360,183,169,483,159,9617
33706,16294,8100,33,404,238,11,315,347,8194
24605,8685,3982,17,162,125,126,169,122,4703
25444,182,90,0,31,0,0,0,0,92
26280,1805,889,5,44,3,6,42,25,916
18465,1390,722,18,46,14,4,42,22,668
12197,2023,961,20,29,29,8,38,11,1062
13147,1147,592,4,29,13,19,26,19,555
28519,260,123,0,5,6,0,5,2,137
82937,4375,2202,35,114,116,9,80,98,2173
64070,3443,1685,12,58,39,11,53,40,1758
64471,428,222,0,14,1,0,5,3,206
75075,36917,18086,164,1287,524,96,1043,568,18831
68118,10134,5065,62,396,113,18,369,171,5069
79080,519,257,6,9,15,0,6,2,262
92114,70039,34909,446,2070,636,524,1975,1053,35130
98144,31845,16088,207,1542,373,125,1599,196,15757
98833,162,89,0,3,0,0,3,0,73
95692,5152,2689,24,111,31,27,129,80,2463
95826,38256,18406,386,1256,353,559,722,469,19850
93458,57369,28951,459,2107,274,495,1778,513,28418
61866,14296,6977,88,377,132,74,571,199,7319
77046,970,326,0,15,0,0,69,31,644
77581,49612,23681,229,1670,383,232,1792,461,25931
67149,863,490,0,26,8,1,19,4,373
57231,1640,848,0,54,30,2,25,31,792
74061,2025,1071,0,9,30,0,60,16,954
82412,523,216,15,15,18,0,9,11,307
75756,4611,2178,3,178,75,171,104,62,2433
85225,70066,35765,625,2518,592,423,2512,715,34301
86508,726,326,0,4,7,16,19,24,400
87579,888,515,4,62,16,7,70,13,373
93215,55269,31769,724,1925,375,228,1555,455,23500
94973,1342,725,0,5,58,0,0,43,617
98587,754,415,14,25,10,0,17,6,339
98639,1055,486,41,40,0,25,40,17,569
4747,1324,694,2,34,21,0,28,31,630
5452,21444,10326,130,637,249,171,568,245,11118
6410,29138,15384,290,804,225,75,665,426,13754
2769,12082,6307,72,298,89,131,278,179,5775
54875,1082,575,0,44,16,4,55,21,507
55018,916,485,4,31,14,10,10,14,431
37421,50927,24787,273,1399,503,227,1457,574,26140
5155,871,415,0,36,54,0,44,20,456
6074,25823,12749,80,643,243,131,1016,302,13074
17010,302,95,0,29,0,0,0,0,207
58370,1270,627,0,40,1,8,15,21,643
72536,415,224,0,0,24,0,10,18,191
73644,14668,7628,60,468,112,148,451,173,7040
74330,3331,1495,0,172,16,37,128,94,1836
30354,16398,6929,36,612,130,238,678,224,9469
80454,1347,650,0,36,0,0,128,10,697
37774,17811,9032,71,383,332,84,397,328,8779
44022,16604,8033,34,408,179,0,445,354,8571
72774,5726,2754,10,168,95,8,250,158,2972
53803,1276,651,0,45,13,3,27,17,625
54565,57,33,0,1,0,0,0,2,24
54757,3430,1792,7,114,42,15,92,53,1638
55054,2620,1369,0,128,40,35,180,16,1251
62248,391,188,2,26,0,2,10,0,203
42104,33415,16027,368,1075,182,223,1241,554,17388
43115,1493,640,3,25,16,12,101,21,853
44333,18778,9094,97,514,254,29,569,313,9684
34101,0,0,0,0,0,0,0,0,0
39067,1508,821,2,61,20,23,40,6,687
23025,266,82,0,0,0,0,0,0,184
23228,35950,17235,228,1437,311,185,1549,673,18715
28386,5997,2708,50,122,96,39,336,68,3289
73834,1513,698,0,23,21,0,34,37,815
81422,691,370,0,26,4,2,17,21,321
82242,35,14,1,8,0,0,8,3,21
85262,11546,5897,71,102,415,35,230,321,5649
93308,53702,27362,380,1769,472,500,1494,607,26340
93611,48473,23474,288,1680,484,251,1675,671,24999
94131,29902,16425,80,1671,355,45,1198,396,13477
96062,1007,486,0,18,8,4,9,26,521
97378,8345,4783,35,465,112,34,208,47,3562
15555,100,44,0,3,0,0,4,3,56
16662,5516,2579,5,167,74,24,147,69,2937
16940,268,135,0,2,5,0,8,8,133
17212,785,398,5,18,0,0,37,6,387
8835,10283,4821,130,456,104,42,340,164,5462
12771,14757,7037,75,311,199,143,408,316,7720
12810,747,349,3,18,9,0,14,15,398
13350,9827,4943,68,257,119,25,246,153,4884
22720,744,383,0,38,14,0,29,6,361
13655,3431,1546,0,0,41,0,65,37,1885
3266,2209,1088,11,34,40,7,57,71,1121
77015,56155,28609,435,1526,627,332,1779,588,27546
77550,21449,10604,124,674,285,188,591,361,10845
78041,47261,23216,396,1498,315,439,1501,465,24045
80720,2803,1455,4,92,38,8,72,61,1348
83215,50,22,0,0,0,0,0,0,28
83554,372,205,0,0,45,0,0,0,167
96720,49405,24345,339,1331,474,357,1392,844,25060
97368,3506,1943,58,82,32,32,98,63,1563
97877,257,145,0,8,7,0,0,0,112
89047,115,52,0,5,3,0,7,7,63
89412,195,115,0,0,0,8,0,0,80
99124,315,140,4,14,1,6,8,3,175
99554,837,432,10,18,4,12,16,8,405
28772,1061,520,0,32,41,0,38,59,541
29708,34082,16617,69,1118,260,141,1402,481,17465
31069,20167,10217,142,649,218,57,642,226,9950
36801,24840,11660,62,836,273,91,710,286,13180
47163,1500,786,0,20,0,0,9,0,714
23834,24824,11638,246,899,315,166,673,324,13186
23839,818,364,3,34,2,0,24,16,454
25140,1188,637,75,22,24,0,21,31,551
18221,307,150,0,0,0,0,16,0,157
18825,101,53,0,0,0,0,0,0,48
19115,34479,16064,145,1062,299,62,1154,464,18415
30663,3052,1460,41,109,7,5,82,40,1592
15612,379,181,0,14,35,0,0,0,198
93110,16660,8572,183,496,212,107,336,210,8088
95005,7710,3684,53,255,64,40,312,223,4026
95337,37706,18512,362,1212,194,155,1099,397,19194
98932,5162,2494,36,286,36,96,234,74,2668
87537,2510,1283,10,9,55,18,100,58,1227
37048,6506,3142,44,152,128,19,145,141,3364
62549,6264,3075,0,158,44,20,206,79,3189
63453,579,298,0,8,1,8,11,3,281
63534,788,422,5,18,11,9,26,41,366
63834,6739,4232,51,457,95,0,178,58,2507
72118,21184,10356,244,907,226,100,709,269,10828
78011,1925,901,4,46,30,8,87,61,1024
83547,286,145,0,8,11,0,0,0,141
66075,2431,1107,19,116,34,13,113,40,1324
54931,323,146,0,13,0,5,26,0,177
48164,8551,4386,44,243,115,59,238,106,4165
48444,9869,4871,102,362,79,210,272,99,4998
49245,4781,2327,46,197,63,17,184,46,2454
50001,788,313,0,22,17,0,26,21,475
50128,445,238,0,19,11,3,18,3,207
38824,7405,3582,0,158,61,27,242,65,3823
40078,2301,1195,2,112,44,0,80,49,1106
43430,4504,2243,20,103,92,28,101,37,2261
44618,6787,3265,37,197,77,123,178,56,3522
45418,1871,887,0,93,16,24,94,6,984
45789,150,74,0,28,0,0,28,0,76
46507,9306,4715,48,183,126,128,294,125,4591
36869,21064,10185,353,716,183,349,798,317,10879
37018,2092,1062,7,41,29,27,91,15,1030
39330,2643,1286,0,23,2,0,47,22,1357
62903,3211,1604,180,70,8,35,30,18,1607
72827,166,95,0,0,0,0,16,8,71
74052,1019,522,6,12,8,0,35,6,497
78701,9427,5682,63,639,121,42,267,168,3745
79541,985,549,0,0,10,19,51,13,436
79560,193,100,0,0,3,0,0,2,93
80230,9349,4076,47,216,90,38,465,105,5273
80836,1082,564,21,15,8,2,29,13,518
74570,1111,636,32,76,11,0,37,6,475
76067,20215,10129,179,693,162,83,646,336,10086
76476,2623,1354,15,35,33,30,28,39,1269
76561,1059,514,1,44,11,0,39,8,545
64640,2951,1418,17,49,53,32,66,40,1533
13788,990,566,20,35,25,0,9,32,424
14717,505,277,0,3,13,1,3,14,228
25846,323,130,0,0,0,0,0,0,193
27103,34993,16390,36,1389,283,111,1269,565,18603
30145,7142,3672,30,265,90,36,291,134,3470
31719,9145,4544,222,286,95,16,348,178,4601
32724,36047,17434,326,785,528,321,632,661,18613
32757,26679,12361,57,774,303,182,730,549,14318
36035,1468,812,5,33,7,0,46,35,656
36776,1694,775,0,67,14,0,104,25,919
38844,200,95,0,0,3,0,3,0,105
38954,1373,623,0,65,10,0,58,0,750
45814,3212,1535,3,116,25,5,115,31,1677
47369,1327,627,6,17,18,2,10,26,700
53932,2653,1286,5,122,22,0,87,31,1367
54022,23061,10668,748,698,266,694,543,376,12393
50210,1573,853,0,43,30,1,52,36,720
52206,2514,1340,4,101,0,4,71,35,1174
52760,292,64,0,17,0,0,17,0,228
43014,3507,1781,12,116,42,14,97,83,1726
13459,2405,1151,9,93,28,9,76,20,1254
15323,4633,2421,40,108,59,20,123,55,2212
20711,7085,3345,0,141,152,47,160,83,3740
21105,0,0,0,0,0,0,0,0,0
8629,14108,7056,98,589,108,87,357,48,7052
10986,1791,857,0,0,26,15,23,30,934
29730,55937,26988,574,1799,572,634,1588,738,28949
11763,29018,13936,220,888,229,108,782,532,15082
12139,156,102,12,27,1,0,1,1,54
17560,4644,2252,105,63,109,32,67,51,2392
18045,26344,12501,88,733,358,124,682,410,13843
76066,2443,1210,2,6,19,0,10,39,1233
81062,1775,1194,15,83,14,0,3,106,581
16020,1131,577,3,25,13,6,20,13,554
2815,208,96,0,0,0,0,9,13,112
4461,2980,1408,32,133,38,9,70,90,1572
7032,41523,21205,425,1526,406,376,1528,489,20318
20690,753,416,0,39,12,16,21,10,337
22454,1618,752,0,51,25,68,29,34,866
75459,5285,2680,19,235,70,10,250,37,2605
75904,34059,15906,199,936,207,324,1113,396,18153
84719,77,39,0,0,0,0,0,2,38
92840,55186,28124,401,2249,491,395,1590,806,27062
24639,3102,1410,0,84,9,0,111,19,1692
25053,4654,2296,87,162,56,8,128,69,2358
13135,6689,3370,16,150,107,5,246,167,3319
659,40390,19407,330,1196,317,193,1367,493,20983
1094,282,134,0,0,0,0,0,8,148
26425,1134,535,7,20,21,27,13,28,599
41660,678,285,0,27,0,0,0,0,393
43623,19936,9287,161,413,257,113,551,251,10649
68041,1256,651,0,39,11,11,67,11,605
68783,1011,451,0,27,19,3,24,5,560
58418,332,148,0,3,2,0,4,1,184
62069,3088,1548,19,58,30,13,96,58,1540
37618,13011,6106,24,317,245,193,262,187,6905
98665,26556,13516,259,771,153,253,1144,383,13040
97002,5795,2902,6,120,139,10,121,67,2893
97233,41047,20044,202,1892,328,188,1388,389,21003
76857,1596,822,0,29,46,0,48,23,774
76878,1857,953,2,46,17,0,99,27,904
77478,25277,12613,48,633,183,105,396,393,12664
92583,32692,15975,221,1025,330,201,1146,455,16717
74956,1739,868,20,35,9,0,52,32,871
84073,289,154,0,18,5,0,11,0,135
84316,248,128,6,10,6,0,5,3,120
86054,1718,826,0,43,23,3,29,50,892
65707,2281,1080,5,66,32,1,38,84,1201
87028,733,525,0,143,143,0,47,0,208
89510,1574,896,0,19,73,0,31,67,678
73647,609,360,0,29,37,0,22,20,249
46360,43684,22049,261,1350,412,90,1046,557,21635
46614,30647,14481,165,905,430,283,666,533,16166
40813,453,223,15,0,29,0,0,13,230
38860,6542,2936,85,391,44,141,142,129,3606
62856,391,180,0,13,14,0,19,8,211
62957,931,494,17,21,0,4,24,13,437
64436,791,353,0,43,7,3,36,26,438
56127,426,239,0,13,5,10,3,4,187
58017,277,148,0,9,8,0,3,5,129
52171,879,428,0,17,5,11,27,15,451
49221,40615,20920,651,1563,405,405,1066,712,19695
49336,4232,2207,7,102,87,54,128,67,2025
50525,3487,1730,17,95,42,41,121,77,1757
2840,23211,10853,111,813,254,161,612,251,12358
4495,469,236,2,12,6,6,4,10,233
14301,12594,5806,41,342,147,109,420,160,6788
15480,1855,874,0,17,35,0,67,73,981
16121,4667,1964,64,74,18,10,168,88,2703
23487,5904,2916,90,255,44,122,180,92,2988
25040,487,255,0,36,0,0,0,15,232
19951,2044,1044,13,2,87,0,1,62,1000
27233,3643,1902,11,94,0,117,131,42,1741
13082,4380,2075,0,70,126,15,165,72,2305
76841,25,7,0,0,0,0,0,0,18
78827,1052,508,18,20,13,20,16,13,544
51451,124,66,0,4,6,0,0,2,58
55408,31090,16298,89,1401,244,162,1059,187,14792
59212,598,344,0,29,8,0,20,1,254
60465,17473,7986,169,453,184,133,833,251,9487
65775,25064,12067,182,704,304,152,667,307,12997
70065,51377,25656,394,1520,487,225,1681,778,25721
71751,1186,589,42,2,34,0,75,22,597
72068,411,166,5,29,5,5,25,5,245
73773,2040,1018,14,93,22,17,54,30,1022
75105,190,113,0,4,0,0,0,0,77
31744,2791,1341,0,79,50,27,73,23,1450
32571,35388,18035,221,1201,468,202,931,577,17353
21713,10379,5087,79,252,105,72,313,162,5292
16341,1773,851,3,56,30,15,57,31,922
22640,566,242,0,19,0,0,0,23,324
49080,16214,7744,68,564,196,115,578,246,8470
84038,271,132,0,1,21,0,0,6,139
86413,12574,7414,6,467,222,16,132,151,5160
37743,26291,12832,171,774,249,175,786,397,13459
38468,5251,2587,46,161,68,49,186,90,2664
43986,2332,1191,19,69,11,36,54,19,1141
72338,6,6,0,0,0,0,0,0,0
44102,45514,22703,398,1684,244,312,1475,453,22811
94089,22313,12029,94,890,162,157,798,215,10284
45684,2093,1072,25,3,1,0,84,56,1021
65069,635,345,11,0,8,0,16,0,290
29340,21046,10138,237,366,243,117,698,193,10908
65444,1166,630,27,48,16,0,21,4,536
67052,9357,4759,101,305,70,40,361,86,4598
29645,9643,4560,58,304,89,97,282,87,5083
56083,831,412,4,25,16,5,15,11,419
10506,5693,2556,48,86,43,61,92,113,3137
71068,3553,1714,37,157,13,0,77,73,1839
40014,21609,10815,64,972,264,91,768,316,10794
13312,391,193,0,15,17,4,14,23,198
12789,1952,940,0,34,6,3,37,9,1012
14472,8421,4262,30,148,42,11,204,142,4159
44878,3118,1496,4,70,62,0,95,78,1622
95134,27224,14780,81,1791,120,60,971,146,12444
55953,822,412,0,19,29,0,21,15,410
29014,1763,872,0,28,37,63,38,15,891
50028,1552,805,2,68,23,0,44,17,747
8051,10409,4523,61,275,152,92,424,198,5886
74145,18580,8994,112,595,105,104,535,282,9586
47882,7786,3831,48,174,42,33,285,74,3955
39366,1188,437,0,30,0,43,90,0,751
49267,3866,2071,0,105,52,0,70,96,1795
11783,21265,10367,231,602,217,127,602,310,10898
12861,612,313,4,13,17,0,19,18,299
69135,94,38,0,0,0,0,0,0,56
6513,39781,18815,297,1016,351,316,1435,493,20966
7030,53211,26453,391,3182,215,190,2893,454,26758
62083,237,134,0,0,0,0,9,10,103
62421,660,325,0,6,1,0,24,7,335
64441,136,76,0,0,12,0,0,13,60
78237,39349,19504,208,1234,262,277,1031,429,19845
58705,525,372,98,0,0,41,0,0,153
60069,8186,3900,23,88,47,43,168,124,4286
65446,277,125,0,0,0,0,0,0,152
92320,8597,4245,36,161,89,37,186,97,4352
92410,45641,21683,336,1374,187,349,1309,371,23958
98326,657,428,20,22,0,0,19,31,229
3443,552,242,0,49,14,0,0,37,310
5753,10444,4933,242,230,102,279,246,119,5511
6382,11971,6685,71,465,145,48,330,198,5286
1752,39776,18793,137,1269,418,224,1523,559,20983
30552,1805,904,23,44,44,21,81,66,901
32831,3280,3280,7,373,19,0,0,0,0
33009,41276,19607,157,1180,562,190,1645,928,21669
13860,26,19,0,0,0,0,0,0,7
14612,34259,16814,148,922,392,159,796,563,17445
17861,161,92,0,5,0,0,0,5,69
18630,3114,1572,10,149,42,17,84,52,1542
18653,233,101,0,0,5,0,3,3,132
718,25715,12122,224,760,314,221,1005,390,13593
98387,49910,25018,404,1608,450,354,1750,527,24892
93207,239,124,0,7,10,0,7,1,115
96094,6556,3257,11,114,63,27,152,122,3299
73141,2600,1333,0,99,90,23,108,37,1267
74438,134,58,0,2,4,0,13,1,76
67481,539,305,0,8,5,0,15,6,234
67575,458,244,0,10,7,0,7,6,214
64076,8765,4143,18,245,54,0,347,78,4622
64483,799,420,0,39,17,4,40,2,379
64498,270,130,0,7,6,1,13,0,140
85543,3705,1725,4,155,111,1,124,42,1980
60935,1210,648,16,57,26,2,41,22,562
78146,525,311,0,34,21,0,17,0,214
70001,38876,19236,164,1374,488,235,1238,563,19640
50116,296,155,8,1,4,4,15,0,141
50522,986,522,15,33,14,0,31,10,464
49248,783,408,2,36,18,8,19,9,375
26369,672,322,23,15,0,0,15,14,350
26810,650,303,0,27,0,0,0,26,347
28112,26999,13406,134,736,265,237,807,345,13593
43116,1563,742,0,54,3,0,73,2,821
21250,2415,1191,166,0,0,173,0,0,1224
4681,1074,490,0,16,0,0,13,40,584
5401,28913,14758,1478,861,242,989,840,233,14155
14754,594,243,8,13,6,8,31,11,351
77481,14,6,0,0,0,0,0,0,8
77976,99,65,0,0,0,0,0,0,34
78545,572,306,21,0,0,0,6,0,266
79915,35445,16312,86,610,345,249,842,523,19133
79935,17434,8282,158,574,200,111,493,222,9152
58741,580,335,12,28,8,21,11,3,245
85258,25152,11879,109,618,423,119,762,374,13273
74331,7218,3589,12,139,139,8,199,116,3629
75929,1682,847,0,45,12,0,27,14,835
73170,37699,18523,185,1442,406,323,1337,559,19176
80640,12864,6624,97,695,51,115,433,127,6240
82636,4485,2403,0,174,19,52,202,32,2082
14901,15965,8397,188,666,231,197,301,121,7568
16503,16785,8611,180,514,67,111,473,120,8174
17080,256,137,0,7,1,0,6,0,119
32626,8784,4162,20,174,66,27,205,168,4622
23398,26,6,0,0,0,0,6,0,20
21669,231,143,0,0,10,0,0,19,88
17951,258,144,0,0,10,0,0,0,114
19401,42116,20518,288,1283,387,181,1549,607,21598
12305,5059,2782,99,226,72,46,99,84,2277
26444,3601,1774,0,77,48,52,183,30,1827
28018,4699,2279,76,59,94,17,45,83,2420
28109,340,171,11,0,7,0,2,3,169
52235,827,382,4,16,10,5,23,6,445
52732,26943,12788,124,807,330,273,819,424,14155
13843,2099,1077,0,28,33,0,39,36,1022
24504,9935,4823,173,406,101,18,253,191,5112
25148,555,295,0,39,0,0,0,31,260
19367,0,0,0,0,0,0,0,0,0
75939,4912,2561,44,153,42,83,126,43,2351
84657,665,343,0,72,7,3,14,8,322
65660,158,66,0,0,2,0,0,3,92
67140,916,430,3,36,0,14,27,11,486
68824,1494,767,12,62,14,12,49,8,727
87037,680,330,7,9,4,2,13,0,350
87581,32,17,0,0,0,0,0,0,15
89043,1317,888,41,105,0,0,0,33,429
78211,32568,16530,289,1014,233,211,1203,525,16038
79535,157,73,0,0,8,0,0,0,84
79852,682,340,0,14,7,0,9,23,342
72121,3272,1631,3,169,11,0,145,12,1641
6460,38973,18967,238,1408,412,161,1278,657,20006
7939,212,212,0,24,10,0,0,0,0
8075,28731,13739,301,886,233,305,1088,310,14992
10607,7194,3678,62,255,99,9,107,156,3516
924,49508,21832,301,1031,290,679,1779,658,27676
2139,38272,19218,513,1405,224,391,1332,327,19054
65571,1894,974,0,33,2,15,25,2,920
66223,25468,12834,65,808,128,47,850,356,12634
53167,909,378,0,67,0,0,53,16,531
37659,27868,14239,136,992,312,91,816,305,13629
13664,292,141,0,4,7,0,5,8,151
15341,817,452,16,25,7,0,28,17,365
22959,1423,684,0,8,56,0,37,46,739
43343,1012,553,8,17,7,0,40,48,459
43925,425,324,0,0,0,0,0,0,101
44514,21659,10203,70,668,401,85,679,391,11456
97640,110,51,0,0,2,0,0,19,59
98564,2336,1144,10,24,34,4,47,68,1192
99128,316,181,1,11,2,0,7,4,135
99336,51998,26132,610,1557,245,438,1671,651,25866
56477,2790,1425,29,81,52,13,93,36,1365
57251,173,78,0,5,0,2,0,0,95
57273,1164,595,0,18,5,2,31,27,569
61453,578,310,6,21,14,2,63,9,268
62837,8960,4432,41,199,53,48,250,169,4528
63740,4957,2480,0,147,64,24,140,99,2477
63860,170,78,0,22,0,0,0,0,92
44233,7927,4118,36,239,193,23,175,152,3809
44425,14354,7050,69,527,187,50,435,264,7304
46227,56614,27662,467,1996,583,745,1861,672,28952
49653,2018,1026,15,23,58,8,20,28,992
41503,533,215,0,0,0,0,43,0,318
36032,2336,1053,24,49,12,8,26,23,1283
39272,12626,6332,66,447,69,99,530,24,6294
98648,3128,1607,8,70,53,24,86,60,1521
99767,60,25,0,3,0,0,3,0,35
5060,4495,2285,38,102,80,17,226,84,2210
5481,0,0,0,0,0,0,0,0,0
1938,13901,6720,72,309,193,60,339,215,7181
31071,1200,546,0,33,8,0,42,20,654
47974,1138,562,12,32,32,0,62,60,576
38827,3589,1645,33,137,27,13,136,61,1944
39735,3498,1664,25,45,23,28,135,57,1834
21904,7005,3539,17,124,120,5,113,127,3466
23177,475,221,0,3,30,39,3,0,254
30567,3188,1643,19,128,42,18,216,31,1545
35214,18264,8069,120,484,206,91,717,473,10195
37010,4938,2557,36,112,24,2,142,19,2381
37059,1138,574,0,57,40,5,58,25,564
37086,34223,17303,271,1171,115,286,1327,229,16920
37171,532,309,0,21,0,0,0,27,223
37682,687,286,20,0,0,56,8,0,401
38347,510,232,0,0,0,0,17,0,278
18625,361,192,0,0,20,1,0,20,169
20706,42397,20579,279,1800,359,365,1703,464,21818
21210,15213,7199,424,394,158,529,298,137,8014
23140,6679,3278,44,206,75,46,167,80,3401
43150,2158,1153,3,50,13,18,38,4,1005
27311,3697,1850,0,17,45,45,105,22,1847
27862,649,313,27,1,0,6,9,21,336
38567,423,188,12,16,7,0,11,0,235
50559,287,166,0,14,22,0,15,3,121
50670,2198,1008,3,64,12,8,59,36,1190
52237,1677,921,10,120,2,4,37,10,756
59501,12739,6449,105,412,118,35,413,124,6290
63821,874,495,0,13,34,0,19,17,379
63955,188,96,0,5,3,0,0,0,92
55430,22935,11089,204,977,175,171,858,354,11846
60931,537,265,2,15,8,0,19,10,272
61553,140,60,0,1,1,0,4,5,80
62272,1741,925,36,11,2,23,7,25,816
62346,189,101,0,9,0,0,14,0,88
55045,7598,3987,12,145,106,26,181,170,3611
73447,1319,656,6,25,6,5,35,28,663
32658,376,209,0,18,0,9,18,5,167
15442,1910,956,0,65,17,0,27,27,954
7666,40543,20043,300,1402,507,270,1225,677,20500
33956,3437,1621,0,50,110,0,0,134,1816
35490,4206,2069,11,110,28,3,199,27,2137
35771,3916,1986,0,207,15,0,111,37,1930
98581,469,210,0,0,0,0,0,0,259
56277,3148,1555,7,88,30,63,77,91,1593
57569,267,125,0,9,2,2,1,8,142
57790,1043,517,3,12,18,3,17,18,526
58355,76,37,0,0,0,0,0,0,39
59313,2319,1219,15,90,0,0,60,79,1100
60408,5649,3049,24,135,71,8,161,63,2600
78705,33948,16341,2537,287,22,2891,280,32,17607
95064,10299,4410,315,42,7,332,48,0,5889
87736,151,22,0,0,0,0,0,0,129
88047,2301,1145,11,109,11,0,54,76,1156
89146,18927,9584,130,684,184,97,389,174,9343
90220,53703,25562,651,1471,326,364,1874,510,28141
64657,263,165,0,16,8,2,12,4,98
61546,3767,1889,14,89,43,16,101,55,1878
61870,1320,725,10,35,45,6,14,22,595
58442,467,231,0,12,5,0,9,17,236
58731,266,128,0,9,3,0,8,6,138
54201,5188,2701,16,108,88,30,99,66,2487
62513,1767,798,0,38,16,0,56,11,969
49871,588,295,5,9,6,0,11,15,293
63530,1197,613,12,44,22,9,47,5,584
63367,24228,12250,195,911,242,8,828,239,11978
61450,1787,858,19,54,16,0,44,16,929
62324,1076,591,0,13,8,5,34,4,485
77072,61818,30827,662,2132,561,434,1959,701,30991
83676,4994,2389,0,122,41,7,115,95,2605
77905,14645,7655,27,398,248,46,419,119,6990
85736,4612,2376,0,145,85,0,73,81,2236
78338,51,17,0,5,0,0,7,0,34
79410,10160,5558,502,195,59,315,172,83,4602
79529,1476,730,5,57,8,0,26,30,746
79561,716,401,9,51,2,0,19,19,315
80538,48260,23443,426,1575,609,440,1739,874,24817
97031,19161,9387,193,500,211,225,719,325,9774
97223,49524,24287,145,2064,500,345,2173,712,25237
88135,1583,776,69,47,4,0,39,19,807
95358,33345,17720,251,1015,210,261,1019,271,15625
92553,75830,37527,727,2391,367,775,2634,565,38303
76933,1273,631,0,50,12,1,30,19,642
30450,2192,1034,13,81,2,3,78,34,1158
34974,24163,12130,60,449,266,125,444,354,12033
35739,5048,2700,16,174,9,7,174,94,2348
38315,3448,1614,19,97,71,19,60,53,1834
41018,27663,14147,176,944,219,182,927,532,13516
14482,8189,4059,51,170,46,142,170,65,4130
62871,579,293,0,3,6,0,6,0,286
63057,66,66,0,0,14,0,0,0,0
71023,3422,1656,10,139,71,0,95,36,1766
57574,159,88,0,0,0,0,0,14,71
48768,9639,4866,80,353,120,5,287,194,4773
14214,19775,10168,307,544,230,139,558,250,9607
15236,29159,13580,124,971,238,125,762,455,15579
15311,1627,792,0,64,10,0,58,45,835
17870,15311,7456,254,334,97,370,464,218,7855
18105,27,18,1,0,0,0,0,0,9
19901,37234,18100,279,1043,286,445,1033,436,19134
17253,283,116,3,9,0,3,4,6,167
8091,5487,2686,37,222,37,0,107,39,2801
8840,16392,8073,99,544,180,71,628,199,8319
10917,1855,997,81,67,13,38,83,12,858
667,23590,11509,166,540,310,165,756,292,12081
1007,14967,7510,28,394,145,82,410,299,7457
29038,2169,999,25,25,24,0,106,11,1170
29934,1150,561,0,28,0,0,88,36,589
30014,38445,18007,221,1007,329,342,1531,532,20438
12784,46,40,0,0,0,0,0,0,6
13104,15515,7940,70,421,223,27,528,291,7575
13208,22738,10997,162,741,239,83,740,299,11741
28037,20110,9902,96,448,320,51,655,228,10208
8889,9562,4611,64,261,131,110,330,178,4951
10547,7737,3946,130,184,49,79,120,111,3791
46953,23518,11289,386,725,264,719,530,342,12229
41164,13030,6149,27,314,198,42,314,207,6881
41558,803,399,6,12,5,16,6,4,404
53065,2236,1136,3,65,41,23,68,25,1100
55985,1909,987,6,68,25,2,80,29,922
56052,724,382,6,17,5,0,12,12,342
45617,279,54,0,0,0,0,0,0,225
36024,4942,2373,25,72,77,0,174,91,2569
39320,1289,700,0,0,11,0,17,66,589
45410,16079,8222,43,486,117,137,494,295,7857
3592,1060,562,3,1,38,16,12,8,498
6250,4741,2277,43,85,54,60,191,125,2464
17257,29238,14012,490,666,273,588,813,321,15226
11937,15984,7778,70,416,159,76,430,338,8206
12527,0,0,0,0,0,0,0,0,0
13658,2288,1097,0,31,37,29,59,28,1191
84072,448,220,2,27,8,0,15,6,228
91302,26634,12776,185,511,338,110,905,432,13858
92220,33014,15914,148,832,285,124,1058,476,17100
85545,520,272,0,6,21,0,0,0,248
97876,883,461,0,14,13,5,35,7,422
98560,179,113,0,10,3,0,13,6,66
95637,227,146,0,0,0,0,0,0,81
95977,1617,823,22,136,39,0,0,31,794
96121,317,204,23,6,0,0,0,0,113
96797,74262,36971,436,2627,868,372,2046,960,37291
78940,2347,1169,0,81,25,11,41,74,1178
79761,33960,17437,413,1065,152,198,1118,383,16523
51647,131,64,0,0,8,0,20,4,67
54741,1611,837,1,13,13,9,28,12,774
55306,16125,7755,11,445,143,68,580,218,8370
55341,3226,1547,0,91,44,0,116,18,1679
67132,419,207,0,18,7,0,11,7,212
63111,21141,10482,37,941,271,87,786,269,10659
63666,110,48,0,0,0,0,17,0,62
48109,5534,2422,47,0,19,97,6,0,3112
50117,128,65,0,0,0,0,0,8,63
51050,2645,1224,8,53,37,17,89,33,1421
39476,8173,3719,14,321,25,113,263,179,4454
4988,2348,1069,29,29,13,76,64,6,1279
6907,8956,4314,16,343,52,0,433,102,4642
90065,47887,24231,453,1942,388,237,2115,631,23656
98133,47247,22851,249,2332,340,255,1829,516,24396
82635,172,108,0,6,2,0,0,9,64
75980,2472,1169,8,51,25,6,22,28,1303
76040,32005,15684,74,1251,194,122,1489,577,16321
76048,24118,11979,176,556,403,169,804,455,12139
76642,6750,3201,70,238,44,0,176,146,3549
76854,263,103,0,0,0,0,0,0,160
93925,2155,1070,23,86,3,22,33,9,1085
90502,18188,9158,201,739,152,61,483,271,9030
71461,2352,1244,15,42,11,13,67,27,1108
14138,2006,1100,3,60,17,16,57,21,906
8071,9433,4511,112,239,60,17,181,199,4922
5760,1196,615,7,22,19,17,19,12,581
7735,18586,8697,166,498,117,191,494,301,9889
16827,4745,2300,14,89,94,52,128,70,2445
17035,872,450,0,11,11,0,18,28,422
99624,52,27,0,3,0,0,0,0,25
44643,3585,1770,3,68,54,5,58,15,1815
26525,7531,4651,23,579,149,6,215,76,2880
27808,1939,962,0,30,0,0,43,59,977
16037,4743,2425,13,152,45,17,138,32,2318
17834,3350,1694,10,44,66,85,38,29,1656
6468,19621,9508,130,465,228,87,456,335,10113
8827,4085,2040,19,82,136,0,126,49,2045
12515,1499,795,0,51,20,7,42,4,704
22406,25928,12418,97,676,256,236,763,276,13510
3826,2309,1201,7,168,24,42,89,68,1108
4554,911,406,0,22,30,0,0,8,505
13638,362,172,0,7,0,0,21,0,190
14054,1471,734,3,70,11,0,38,19,737
15321,1539,848,27,59,20,0,49,14,691
21161,5221,2498,31,112,37,36,131,110,2723
1929,3713,1852,11,76,52,15,38,40,1861
2724,17686,8341,113,738,119,176,571,324,9345
24974,321,183,0,0,0,0,0,0,138
76648,2789,1361,20,40,35,0,57,88,1428
65344,227,120,0,21,4,6,7,4,107
66711,619,357,0,2,7,0,13,10,262
66853,470,235,0,14,1,8,5,0,235
67022,1446,721,4,53,21,16,33,41,725
67051,433,232,2,4,4,0,39,4,201
19075,7710,3795,14,285,122,43,298,100,3915
24431,2361,1027,0,29,59,0,82,36,1334
24901,9768,4551,80,262,213,0,202,128,5217
26034,4401,1961,59,58,62,0,208,93,2440
26574,694,298,7,39,16,0,38,8,396
27553,2463,1494,18,99,96,0,30,43,969
5747,323,168,3,23,6,0,3,2,155
7974,12407,6128,27,474,93,79,316,171,6279
13333,34,11,0,0,0,0,0,3,23
29545,1444,693,0,78,27,0,60,50,751
13820,21997,10174,558,480,268,762,405,319,11823
14437,11439,6640,30,467,113,155,275,156,4799
35765,3926,2159,20,79,43,12,98,72,1767
37885,5761,3029,4,138,38,33,110,95,2732
43811,835,430,0,29,19,18,22,3,405
44706,17413,8241,97,559,166,108,501,226,9172
45142,3696,1742,12,123,17,30,199,68,1954
46051,2756,1309,6,121,30,0,149,36,1447
46590,4921,2466,73,215,28,81,174,0,2455
28645,46604,22576,239,1339,687,118,1446,573,24028
29065,509,203,0,0,0,0,17,0,306
29644,21182,10422,178,676,129,45,744,351,10760
26590,538,292,0,0,0,0,21,11,246
31822,5929,3033,22,56,66,32,193,87,2896
31906,20742,9230,102,811,210,327,716,305,11512
98613,396,196,0,10,3,0,3,15,200
81429,46,25,0,0,0,0,0,0,21
85390,8706,3930,11,47,179,42,74,225,4776
86045,11634,5303,97,321,89,168,398,133,6331
76107,29851,14071,169,1207,375,164,1121,445,15780
95318,268,169,0,0,0,0,32,0,99
87937,2725,1266,43,58,13,44,105,23,1459
62655,460,251,1,6,6,0,18,14,209
65461,78,45,0,0,0,0,0,0,33
56528,1681,885,12,32,32,2,31,19,796
66548,910,440,10,30,7,7,16,11,470
60922,2389,1263,8,66,51,33,49,49,1126
61329,1185,587,9,54,10,4,49,18,598
62257,2678,1320,5,74,28,18,61,30,1358
20506,0,0,0,0,0,0,0,0,0
78066,640,372,0,26,0,0,41,0,268
64489,2127,1071,17,45,20,5,40,31,1056
65723,3369,1748,7,259,14,0,153,22,1621
67202,1671,1161,0,112,0,41,14,7,510
74557,497,256,0,7,20,0,14,7,241
75477,1204,704,12,20,12,0,49,31,500
75791,13305,6311,14,407,77,180,590,101,6994
64454,2337,1125,5,37,9,0,57,52,1212
80835,947,465,0,45,20,0,33,8,482
82512,182,96,0,5,0,0,0,0,86
56710,607,299,0,21,4,4,20,8,308
92501,21656,11117,62,810,139,164,909,205,10539
92539,4703,2352,44,155,12,1,150,153,2351
92880,69720,34190,468,2649,543,589,3032,607,35530
99117,441,247,2,5,19,0,3,5,194
49918,87,51,0,0,6,0,1,9,36
50475,1486,769,10,63,15,4,40,36,717
66763,3405,1571,16,84,43,67,56,28,1834
67012,16,3,0,0,0,0,0,0,13
15713,346,191,0,0,0,98,0,0,155
16255,1666,811,2,65,25,6,44,22,855
67217,30313,14210,181,898,416,272,992,390,16103
6374,7170,3289,13,152,95,34,160,72,3881
69218,235,136,0,6,0,0,10,8,99
69352,766,418,6,13,17,1,34,7,348
49720,8750,4309,68,172,181,38,268,183,4441
49793,258,119,0,7,8,0,5,10,139
74864,5149,2511,31,101,42,50,131,42,2638
63357,5331,2576,17,98,135,23,99,73,2755
63348,6841,3384,9,138,30,99,151,73,3457
63956,1442,757,41,0,2,0,26,31,685
72727,5659,2809,38,190,48,24,245,57,2850
92024,51496,25456,157,1657,603,188,1720,907,26040
93035,29404,14467,103,952,412,180,993,334,14937
82649,995,504,4,17,21,3,16,9,491
77901,43123,20789,575,1481,358,444,1375,574,22334
84025,23234,12089,149,908,83,27,812,254,11145
55037,4789,2389,44,77,61,28,108,53,2400
31816,5231,2511,30,61,42,25,156,89,2720
14506,1346,660,52,17,28,15,59,15,686
32190,1089,447,0,73,50,0,39,8,642
94589,30668,14516,99,1015,338,222,1088,341,16152
95240,48838,24272,312,1629,458,368,1428,631,24566
56381,2441,1244,6,45,23,6,51,39,1197
41039,2709,1342,21,71,16,0,57,84,1367
44057,19482,9826,141,433,260,79,523,233,9656
45630,80,63,0,0,0,0,0,0,17
32832,24325,12399,155,848,206,39,1249,294,11926
34476,22665,10366,22,264,337,42,383,335,12299
35976,17252,8417,42,529,186,70,535,236,8835
47925,197,61,0,0,0,0,0,0,136
48657,7858,3812,8,169,112,17,165,148,4046
49327,8429,4116,41,284,115,30,253,113,4313
37217,31218,15577,119,1396,145,159,1206,369,15641
78155,48863,23659,353,1255,477,222,1255,646,25204
79229,401,190,2,7,3,0,0,9,211
72661,576,301,0,0,0,0,0,10,275
73638,204,128,2,10,5,0,23,0,76
74137,28241,13451,76,815,310,163,895,442,14790
88323,0,0,0,0,0,0,0,0,0
18219,1469,719,0,39,5,15,31,50,750
1746,14634,7104,23,425,258,90,567,144,7530
4027,6230,3060,33,309,70,0,253,18,3170
4441,1675,812,14,25,67,0,28,68,863
5342,591,277,0,13,1,0,3,13,314
14606,28198,13562,224,817,218,106,710,387,14636
7852,4084,1973,0,86,79,22,158,54,2111
17262,1562,772,4,37,17,10,55,24,790
26408,2858,1370,0,88,34,22,82,41,1488
27804,29938,13735,79,667,314,66,1012,471,16203
51454,1470,719,2,36,17,6,39,5,751
68961,829,439,11,43,9,0,33,9,390
63087,815,421,0,10,7,27,10,7,394
63383,16394,8018,207,417,177,157,623,270,8376
57003,2071,1051,11,81,11,6,70,10,1020
60136,7742,4153,51,569,0,0,520,0,3589
61727,9826,4869,63,354,149,19,348,190,4957
47858,657,358,0,45,0,0,15,0,299
47904,17225,9125,281,795,124,131,594,173,8100
48417,2610,1301,9,77,45,15,79,34,1309
48475,2533,1240,18,78,32,25,37,45,1293
75094,23370,11646,82,866,98,60,912,334,11724
75960,712,360,0,11,3,0,27,0,352
45405,16845,7814,131,379,159,106,623,344,9031
55735,1697,870,6,32,33,0,50,21,827
56279,1350,678,8,39,17,4,49,18,672
56750,2300,1151,9,60,30,0,56,39,1149
53150,25622,12772,97,791,309,169,714,402,12850
55038,22082,11108,58,649,164,79,912,211,10974
55080,2554,1308,0,91,32,4,94,17,1246
55447,21737,10770,78,820,216,158,682,275,10967
56088,1772,890,12,48,19,26,34,16,882
39776,1475,645,2,4,11,41,11,12,830
40049,112,39,0,0,0,0,0,0,73
40849,432,262,0,18,16,0,41,0,170
30148,861,442,0,77,0,0,9,0,419
30187,7918,4027,11,306,123,0,143,97,3891
30303,6719,3701,237,262,73,345,101,0,3018
31066,1492,756,0,15,32,0,78,4,736
32507,31288,15892,125,735,344,11,1003,548,15396
33759,18366,9051,148,677,189,90,533,366,9315
43731,5379,2628,23,79,22,23,130,120,2751
45176,9434,4580,101,272,119,31,350,149,4854
45333,1368,800,0,35,21,0,42,60,568
34471,24898,11776,301,843,396,83,925,278,13122
36041,1401,830,10,62,29,0,94,0,571
42344,1076,358,0,0,0,0,7,12,718
43326,13745,6649,135,361,187,187,323,170,7096
43560,32275,15447,126,884,452,160,745,627,16828
50325,17007,8422,13,645,177,37,575,246,8585
14737,4351,2279,36,89,29,21,93,38,2072
17349,7154,3409,69,141,195,35,211,191,3745
3868,5204,2655,24,162,97,0,186,71,2549
4947,1313,698,7,26,27,14,10,37,615
6160,0,0,0,0,0,0,0,0,0
25607,1153,709,16,59,0,0,48,5,444
18473,763,407,0,18,0,0,25,0,356
18930,2801,1426,19,21,58,11,20,57,1375
12075,2850,1508,0,98,116,0,66,54,1342
1253,672,340,0,11,6,0,5,29,332
1462,11271,5407,10,245,110,13,329,183,5864
61416,294,128,0,14,2,0,26,4,166
56762,2587,1274,22,91,50,6,78,36,1313
32430,1064,503,20,38,9,0,0,0,561
33615,45851,22525,332,1935,305,283,1593,648,23326
39507,16514,7653,107,581,214,54,611,266,8861
46941,994,512,16,29,17,6,46,0,482
48461,8039,3944,43,298,130,50,350,73,4095
49880,978,486,0,21,15,7,9,8,492
12489,1078,955,17,111,0,0,22,0,123
38828,4436,2078,17,299,93,0,102,9,2358
53580,589,289,4,15,11,2,11,1,300
30082,29011,13776,42,1279,354,396,1234,241,15235
27248,4249,2033,4,150,72,15,77,38,2216
28333,11075,5179,11,178,97,122,348,119,5896
31635,6602,3337,114,105,29,26,251,132,3265
23510,8433,4692,157,437,53,33,251,44,3741
12418,573,284,10,23,4,4,31,4,289
28610,10120,5457,11,300,174,17,268,158,4663
25015,4385,1985,135,130,54,69,88,72,2400
92610,14149,6828,46,531,106,132,652,100,7321
87022,853,396,0,24,15,17,27,7,457
88416,35,35,0,0,0,0,0,0,0
89413,571,300,0,9,12,0,15,0,271
90069,20435,12351,155,1459,301,53,799,144,8084
95445,2201,988,0,85,57,0,74,96,1213
95482,31847,15493,102,857,378,195,905,398,16354
95680,10,0,0,0,0,0,0,0,10
97023,10032,4938,35,170,144,52,294,105,5094
11417,31927,15311,207,892,366,220,1069,506,16616
25276,7814,3942,49,266,70,34,224,143,3872
28382,7026,3443,31,209,46,26,193,24,3583
36317,569,233,0,0,24,7,39,7,336
36435,426,249,0,29,0,0,0,5,177
36865,34,22,0,0,1,0,0,0,12
24077,757,350,28,35,15,0,28,17,407
30234,2060,851,0,18,1,3,89,14,1209
31798,843,461,0,0,5,0,0,13,382
73852,2351,1262,0,106,26,0,52,12,1089
97401,44750,22020,1929,1004,462,1749,1435,525,22730
88321,86,48,0,0,3,0,0,2,38
92346,61751,32175,529,2167,358,567,1870,611,29576
94114,34754,20097,37,2404,404,48,1442,249,14657
76179,60286,29138,240,2394,513,329,2576,771,31148
85341,0,0,0,0,0,0,0,0,0
77969,127,52,0,0,20,0,0,0,75
42127,6622,3474,11,158,152,37,186,102,3148
60969,58,33,0,3,0,0,3,1,25
61052,821,439,0,18,2,0,17,14,382
55070,7810,3948,113,408,84,36,341,69,3862
48610,2874,1575,0,61,64,15,51,63,1299
49664,1889,945,20,56,40,6,38,38,944
2641,200,71,0,0,9,0,0,0,129
2669,111,86,0,10,0,0,0,0,25
67482,117,54,0,0,0,0,0,0,63
68531,222,104,35,0,0,0,0,0,118
59872,2023,1015,0,47,38,50,26,29,1008
59901,54647,27058,420,1840,643,164,1549,873,27589
60153,23810,11498,261,603,114,262,630,330,12312
58721,544,304,0,10,7,0,9,6,240
72358,1660,958,5,82,27,0,51,21,702
79556,12914,6555,44,421,191,163,299,157,6359
95425,10586,5038,8,326,96,39,385,246,5548
87416,5390,2715,69,192,30,22,160,73,2675
87533,133,49,0,3,0,0,14,0,84
95139,7293,3768,74,347,148,31,381,88,3525
90095,0,0,0,0,0,0,0,0,0
37902,2349,1424,81,118,26,21,70,9,925
34654,23021,11594,174,585,309,10,555,205,11427
35616,3667,1768,17,15,45,11,35,61,1899
30750,4753,2328,89,130,68,144,120,23,2425
31765,2774,1248,20,56,7,3,98,42,1526
32208,32194,14638,255,684,256,26,1243,534,17556
17742,16,11,0,0,7,0,0,0,5
18851,776,408,7,25,0,0,24,14,368
67553,193,106,0,1,3,0,4,0,87
85743,30217,14735,174,928,412,68,921,299,15482
60401,7779,3882,23,306,135,67,213,166,3897
80432,187,116,0,0,0,0,0,0,71
80546,324,177,0,31,0,0,56,0,147
55369,36800,17952,86,1502,377,123,1251,670,18848
56565,34,17,0,0,3,0,0,0,17
49246,3342,1717,5,100,74,32,119,99,1625
58040,1142,601,7,26,23,5,16,21,541
50478,773,380,0,18,16,10,27,3,393
92503,94512,47098,608,3375,668,623,2936,928,47414
35772,4409,2297,0,196,32,0,154,25,2112
43055,61904,29384,326,1412,653,442,1864,954,32520
99118,750,370,21,0,27,3,18,7,380
45159,3773,1983,2,159,20,13,218,55,1790
50222,513,215,17,1,14,0,0,5,298
37310,4677,2332,24,154,53,0,171,19,2345
67208,17703,8759,134,632,127,143,571,264,8944
54701,40130,19074,500,1417,484,421,1265,376,21056
72568,1158,534,0,28,2,1,13,6,624
69030,335,164,0,30,9,0,1,6,171
73045,11293,5594,64,300,156,31,340,230,5699
80922,29134,14716,167,1108,199,188,1162,203,14418
58580,243,110,0,6,0,0,27,4,133
16030,348,164,5,13,5,0,8,1,184
18461,330,188,9,11,5,0,5,2,142
77320,35762,24105,548,2078,480,118,853,421,11657
10940,49068,23492,343,1302,478,250,1895,468,25576
65807,58304,27572,840,1549,425,1179,1356,599,30732
12930,756,377,6,8,7,3,23,15,379
6804,17291,8539,60,453,209,99,432,214,8752
68439,546,256,0,9,1,0,5,0,290
61761,55222,25848,2164,1478,327,2423,1692,520,29374
16871,40,20,0,0,0,0,0,0,20
77449,122814,58819,1363,4972,523,747,5671,1262,63995
14228,22103,11219,819,526,281,208,771,294,10884
59247,321,174,0,11,4,0,5,1,147
15466,444,252,8,8,3,2,17,0,192
60174,31405,14557,56,808,394,261,650,475,16848
74129,19467,9560,145,706,145,178,693,261,9907
83670,488,267,0,21,24,0,0,0,221
26852,809,450,0,17,14,0,23,12,359
91902,20138,9869,71,638,244,42,559,358,10269
33016,51003,24161,283,1528,425,270,1691,672,26842
98174,0,0,0,0,0,0,0,0,0
98824,445,229,8,14,4,0,11,2,216
95901,33442,16524,235,924,232,229,1084,542,16918
47338,2682,1333,4,87,25,24,122,35,1349
3801,22576,11175,32,676,255,40,693,265,11401
49329,8502,4196,43,370,88,14,282,79,4306
911,7242,3441,56,239,72,22,270,161,3801
43569,2896,1475,4,126,23,6,62,30,1421
31044,3463,1674,24,78,34,0,82,100,1789
32071,3856,2033,11,145,44,0,46,64,1823
10706,8734,3939,16,250,84,40,237,122,4795
32763,23098,10988,56,696,180,62,781,324,12110
28611,1162,716,0,24,0,0,23,27,446
13202,6581,3392,86,155,24,37,167,84,3189
76651,3221,1697,13,128,28,22,118,41,1524
15060,753,389,10,29,20,16,21,8,364
15363,499,242,0,0,0,18,42,0,257
16045,1096,496,0,31,0,0,10,21,600
16881,2338,1366,36,67,37,0,100,0,972
23181,5287,2489,15,123,33,0,92,72,2798
25124,1588,854,0,79,0,25,55,15,734
65582,2451,1227,0,73,15,0,69,23,1224
86331,445,234,0,14,9,0,16,3,211
87102,19912,10293,189,682,218,176,619,166,9619
74359,552,297,0,14,13,0,13,4,255
8072,333,120,0,5,0,0,12,4,213
24440,3406,1849,42,130,8,32,84,35,1557
23180,636,289,0,9,0,0,18,36,347
28036,17824,8546,173,571,169,117,668,160,9278
65236,1516,721,8,30,18,11,49,9,795
67478,54,29,0,0,2,3,0,0,25
69023,293,160,0,0,3,0,0,13,133
54568,5073,2588,0,92,85,0,128,91,2485
96101,5500,2836,3,171,65,0,95,50,2664
87543,85,56,0,0,0,0,0,0,29
71468,852,410,7,63,0,6,2,23,442
98942,17148,8279,46,714,66,96,576,212,8869
79942,22,12,0,0,0,0,0,0,10
99903,0,0,0,0,0,0,0,0,0
72529,4814,2529,73,89,27,0,43,105,2285
84722,679,378,0,23,11,0,7,7,301
45855,154,78,0,2,1,2,2,2,76
76557,5184,2751,41,158,85,74,173,39,2433
42740,1838,957,0,69,82,0,55,16,881
60304,17641,8299,55,639,209,64,732,260,9342
63103,8307,4587,148,302,36,106,304,127,3720
49757,960,468,24,22,21,11,15,22,492
50579,2682,1593,1,76,60,6,21,39,1089
58203,17094,8967,610,344,143,534,393,137,8127
48465,616,330,0,30,10,0,21,17,286
49283,3847,1744,120,83,28,99,57,86,2103
26591,1264,606,0,37,22,0,51,10,658
22701,35087,17377,239,1072,290,90,1345,279,17710
11050,30132,14605,98,1103,293,133,1204,417,15527
23517,4421,2506,0,205,46,27,138,17,1915
27283,3182,1689,0,72,48,0,96,71,1493
6354,6326,3259,7,104,124,0,183,156,3067
28310,6470,5799,919,38,0,20,0,0,671
15834,4283,2140,24,49,56,21,108,120,2143
11418,38517,19354,368,1231,300,200,1124,442,19163
11746,68491,34435,267,2433,890,348,1892,1225,34056
24432,284,153,0,0,0,0,0,0,131
76691,6568,3108,3,264,46,34,91,49,3460
25817,1040,627,0,50,18,0,44,36,413
78727,29509,14931,57,1734,276,16,1408,375,14578
1515,2159,1104,8,68,29,7,74,63,1055
53090,21415,10789,124,838,212,93,700,448,10626
80653,764,370,0,17,21,0,24,19,394
54441,942,490,0,22,8,0,25,28,452
62006,490,237,11,24,1,0,15,4,253
66404,377,205,12,12,0,0,0,12,172
79831,4,4,0,0,0,0,0,0,0
71030,1699,745,0,23,0,0,23,69,954
73015,3011,1438,6,91,37,16,56,23,1573
57313,1285,658,2,21,17,0,10,6,627
5777,3436,1700,13,80,49,10,93,69,1736
30633,9227,4633,33,230,106,68,427,135,4594
2113,7531,3879,98,302,38,62,281,49,3652
60064,15705,7782,173,503,86,153,393,132,7923
23146,3079,1639,32,21,27,1,137,52,1440
29657,15869,7937,175,413,167,144,452,199,7932
19462,15572,7419,62,584,97,46,503,280,8153
21523,199,100,0,0,8,0,0,0,99
99176,156,86,0,0,0,0,0,0,70
28557,15204,7567,107,531,232,28,339,313,7637
61840,819,456,15,7,16,0,37,8,363
47429,8819,4082,6,359,180,80,389,143,4737
48230,16425,7981,112,398,159,35,520,286,8444
48451,14190,7004,56,544,180,51,581,208,7186
49323,10413,5256,10,331,99,74,362,107,5157
45218,3915,1851,51,116,43,9,94,53,2064
45828,6248,3060,35,192,61,26,101,87,3188
46376,263,114,9,10,0,0,6,1,149
49655,3399,1713,16,90,55,13,116,41,1686
50843,468,239,8,7,0,5,7,16,229
41348,979,502,0,60,18,10,47,31,477
43062,29460,14744,197,1267,380,135,983,510,14716
36049,6067,2840,25,221,44,34,272,91,3227
99146,73,49,0,0,0,0,0,0,24
95835,40101,19351,172,1716,368,191,1822,571,20750
5846,1123,552,6,25,9,0,52,22,571
6608,13856,7017,103,627,74,145,495,139,6839
31551,963,605,13,62,11,0,37,13,358
38923,1215,624,0,0,0,0,71,48,591
29805,5924,2931,58,291,96,0,236,166,2993
30710,7154,3672,40,264,69,45,181,129,3482
35958,3832,2080,0,121,22,0,149,75,1752
36005,1640,865,34,30,27,0,30,15,775
37306,2322,1200,0,59,113,17,53,60,1122
37332,2547,1402,24,121,0,12,0,14,1145
19547,4478,2317,49,108,13,0,50,95,2161
21625,2720,1243,0,38,10,10,76,80,1477
25248,2956,1329,0,218,16,0,116,16,1627
41601,712,346,4,8,8,5,92,8,366
42355,1898,957,0,42,21,0,48,25,941
42378,2903,1522,0,84,82,15,105,36,1381
45156,73,39,0,0,0,4,0,0,34
45336,161,77,0,9,0,1,2,5,84
47465,480,190,0,0,0,0,5,0,290
67521,126,73,1,5,4,0,0,0,53
69130,5107,2528,10,149,80,61,238,22,2579
65080,1167,662,0,83,0,0,71,13,505
47711,32357,16000,182,1053,443,202,1006,528,16357
48079,12143,6194,70,441,142,30,292,207,5949
48894,1893,957,0,44,6,6,73,6,936
55803,18042,8963,119,573,218,187,377,288,9079
72160,9956,4665,46,240,73,26,362,125,5291
72833,4216,2206,15,137,14,8,119,18,2010
32619,5326,2645,169,192,25,68,105,9,2681
13733,4861,2506,9,113,80,47,173,80,2355
1569,13939,7056,100,463,116,42,314,123,6883
30277,22247,11285,66,585,220,110,650,239,10962
31032,15113,7349,97,598,167,111,742,265,7764
36071,457,235,2,16,0,0,5,2,222
37804,25746,12476,244,881,388,168,738,385,13270
98105,48861,24768,1950,1094,184,2000,1000,184,24093
98262,847,372,0,5,57,5,23,9,475
98371,21305,10281,85,810,263,125,715,317,11024
58579,1519,803,6,41,8,7,49,20,716
79259,61,26,0,7,0,1,0,0,35
90210,19909,9599,27,483,250,28,502,177,10310
99768,207,94,0,8,4,3,8,1,113
65570,637,324,0,3,11,25,10,14,313
67061,198,126,0,2,22,0,3,0,72
68719,140,71,0,6,0,2,9,11,69
68729,1909,906,5,25,5,36,57,47,1003
59713,205,141,1,4,0,0,3,0,64
59823,2066,1096,0,50,20,34,51,55,970
62340,1894,923,42,51,6,18,30,19,971
62341,3454,1596,12,73,72,100,65,28,1858
50652,95,55,0,1,0,0,6,0,40
51360,8174,4143,7,248,186,6,148,149,4031
53965,10338,5193,46,326,136,30,217,160,5145
54725,2769,1399,25,98,41,9,102,46,1370
57236,138,75,3,0,5,0,0,0,63
57330,468,229,6,25,10,0,4,10,239
59058,29,14,0,0,0,0,0,0,15
62685,2416,1309,12,55,11,0,73,30,1107
91030,25794,12655,76,898,343,52,983,360,13139
92338,0,0,0,0,0,0,0,0,0
57312,620,330,12,16,5,0,22,0,290
59453,285,153,0,11,3,0,4,8,132
73026,10338,5162,3,447,85,62,379,129,5176
73064,23526,11434,170,849,268,166,761,261,12092
63451,233,108,5,18,0,0,16,5,125
65702,304,148,0,13,17,4,18,0,156
61730,301,162,0,27,4,0,9,2,139
81091,523,254,0,12,21,0,14,17,269
79329,3092,1689,17,107,47,44,106,31,1403
95939,673,358,11,38,0,0,5,7,315
97452,1650,816,10,72,19,4,86,23,834
97632,1614,792,5,33,15,21,21,23,822
98591,3113,1607,0,85,64,14,86,59,1506
99207,29708,14357,262,1230,266,390,837,287,15351
99349,9129,4641,96,262,0,72,332,13,4488
86503,11143,5344,88,247,111,60,344,131,5799
87117,361,334,102,0,0,0,0,0,27
88103,312,249,60,0,0,0,0,0,63
93646,10873,5333,193,438,72,45,368,121,5540
91001,37711,18762,248,1053,401,179,1078,615,18949
29418,22832,10657,204,503,250,47,935,201,12175
30114,53210,25947,330,2016,460,384,1990,565,27263
31316,13243,6372,66,704,113,5,685,286,6871
35036,367,153,0,0,0,0,11,3,214
94592,1087,535,0,31,0,0,41,9,552
95328,4518,2141,9,97,63,77,125,32,2377
90013,11937,7379,52,766,54,0,447,136,4558
98671,23273,11702,88,727,340,70,913,307,11571
56073,16572,8092,99,379,207,248,379,257,8480
56308,25080,12475,180,767,266,133,718,363,12605
57258,124,50,0,0,0,0,4,3,74
41640,1053,561,0,13,18,0,49,44,492
34609,41250,19387,200,1222,453,214,1217,529,21863
35091,3072,1420,32,94,10,0,83,5,1652
51240,2273,1239,52,85,4,18,47,13,1034
51559,1702,847,21,67,29,9,47,9,855
53811,3263,1484,14,88,51,12,90,30,1779
49676,3543,1826,9,64,52,7,89,67,1717
37924,12000,6146,115,332,184,23,542,81,5854
39439,4245,2039,151,123,38,0,156,36,2206
39767,650,354,0,22,0,0,21,10,296
80420,962,477,0,29,9,0,85,3,485
62459,341,155,2,14,0,0,2,7,186
72550,508,272,0,24,13,15,9,17,236
72947,3937,2210,3,77,48,17,79,76,1727
68316,500,242,0,6,3,0,4,14,258
70062,16888,8063,263,494,203,188,570,231,8825
18058,10099,5037,22,416,131,51,329,152,5062
18076,2806,1324,7,69,36,20,57,17,1482
20686,1471,790,113,0,0,135,0,0,681
2359,18304,9315,175,508,103,29,461,213,8989
2663,94,50,0,0,0,0,0,0,44
5463,443,218,0,5,13,0,20,10,225
8808,142,89,0,0,0,0,0,0,53
44401,2903,1611,21,71,90,0,13,65,1292
40447,8331,4179,47,140,70,41,238,205,4152
52746,1053,580,5,22,3,1,34,17,473
53208,29669,14510,236,832,234,226,1016,423,15159
67515,33,21,0,0,0,0,0,0,12
69148,161,97,0,1,0,0,4,0,64
63042,19443,9351,241,656,182,262,683,136,10092
63663,678,314,0,24,6,23,20,0,364
57477,166,89,2,5,4,0,3,0,77
58775,148,64,0,1,3,0,5,4,84
48041,4489,2367,25,216,49,51,149,68,2122
48857,2817,1359,28,124,23,6,81,21,1458
75839,5330,2404,25,78,32,47,172,99,2926
43914,194,130,0,0,0,0,0,0,64
44139,24212,11727,34,540,214,70,796,301,12485
45332,825,451,1,10,19,0,6,17,374
56003,14603,7236,25,446,173,72,457,144,7367
52533,1367,712,5,62,23,0,52,5,655
55956,2047,1069,13,39,24,3,45,30,978
30312,22275,10565,24,915,111,235,1528,181,11710
32807,34306,17561,271,1370,258,114,1147,364,16745
46913,1193,666,9,37,14,0,30,47,527
33950,22017,10537,141,208,792,63,346,418,11480
35046,4641,2171,0,97,21,20,142,75,2470
43460,6498,3349,175,222,54,23,225,74,3149
47975,650,307,0,4,3,5,13,10,343
28762,6958,3588,40,290,136,9,125,117,3370
15043,2008,990,0,68,12,21,62,23,1018
15148,2683,1261,5,91,21,12,72,51,1422
17058,1832,889,31,73,18,15,67,40,943
3820,31367,14822,175,985,193,285,885,349,16545
4097,3766,1842,11,123,14,0,110,84,1924
5070,526,213,0,0,9,0,3,33,313
25268,900,459,0,5,34,0,36,0,441
26205,3606,1870,34,101,36,0,99,146,1736
26224,264,115,0,0,12,0,0,16,149
19966,27819,12978,56,576,657,33,798,598,14841
18470,2016,1071,2,60,13,10,57,26,945
19350,11730,6022,92,240,170,13,367,172,5708
1529,3242,1527,16,66,38,22,60,49,1715
2136,34223,16132,295,1254,347,243,1318,415,18091
27582,447,191,0,0,0,24,21,0,256
61880,3831,1887,0,188,67,0,180,68,1944
32908,13001,6349,69,254,146,150,310,67,6652
35806,21888,10779,166,615,176,109,445,198,11109
40826,640,272,8,38,11,0,21,5,368
12737,1782,846,10,38,28,45,52,27,936
51637,224,106,0,10,3,0,3,8,118
52572,964,526,8,13,8,0,16,12,438
30141,23326,11170,138,960,102,173,923,264,12156
27812,2762,1166,20,76,95,42,34,65,1596
30814,8538,4203,17,259,98,62,106,146,4335
31057,2238,976,0,53,5,0,52,45,1262
31795,1781,835,29,98,0,14,30,33,946
32177,26377,12548,139,736,228,263,836,276,13829
23126,295,99,0,0,0,0,20,0,196
11756,43099,20795,223,1126,650,197,1452,648,22304
11792,8688,4247,76,372,295,0,208,316,4441
91340,36227,18102,232,1395,282,247,1466,364,18125
91377,13730,6768,26,297,225,45,364,200,6962
92801,67053,32839,391,2250,645,552,2513,784,34214
83404,23151,11404,49,837,293,205,778,178,11747
97352,6556,3404,13,223,63,44,241,61,3152
7847,1731,920,18,167,13,0,133,27,811
3062,27938,13700,158,886,275,120,954,559,14238
5828,2041,944,12,53,24,7,59,63,1097
27565,25375,12299,68,698,421,184,467,387,13076
33168,29072,14423,208,934,210,385,968,474,14649
36738,745,326,0,0,15,0,0,71,419
30458,43597,21341,1426,909,180,1056,1111,303,22256
32179,8075,3866,15,186,151,36,176,47,4209
21658,3840,1883,35,110,61,0,91,37,1957
24361,6227,2941,83,133,70,84,46,77,3286
79093,97,43,0,0,0,0,0,18,54
80831,25048,12740,56,1042,142,140,1358,408,12308
81071,299,156,0,5,8,0,4,2,143
71701,18496,8687,249,526,163,122,542,262,9809
98282,16427,8338,69,262,426,59,410,440,8089
76137,60061,28901,321,1983,336,373,2176,505,31160
40353,22548,11056,119,879,192,165,664,301,11492
41833,521,319,0,23,55,0,21,0,202
41844,1598,733,45,8,12,37,82,40,865
61428,1022,542,0,37,23,4,30,24,480
62348,166,62,0,0,0,2,2,7,104
63124,10827,5221,30,199,146,27,318,262,5606
47038,1699,806,0,36,4,22,58,71,893
47881,361,188,2,21,5,0,15,0,173
61077,36,18,0,0,0,0,0,0,18
61109,27224,13382,132,934,297,205,742,469,13842
61760,2519,1213,10,56,21,4,50,41,1306
56724,148,76,0,2,6,0,2,0,72
58249,2372,1209,29,41,45,0,47,16,1163
59012,190,100,0,0,0,1,12,6,90
73160,59401,28905,553,2157,482,390,2371,653,30496
73526,2385,1167,6,50,27,5,90,53,1218
70550,55,0,0,0,0,0,0,0,55
78594,1815,740,19,9,0,0,102,7,1075
79906,5139,3004,213,179,0,21,148,0,2135
2651,0,0,0,0,0,0,0,0,0
95492,29920,15101,238,913,468,105,867,419,14819
95540,14305,6883,135,381,175,84,451,192,7422
52638,603,296,0,20,2,0,30,12,307
56452,1845,954,15,28,63,6,42,40,891
44107,50666,24882,228,1874,518,291,1972,676,25784
45069,51117,25081,264,1801,479,236,1458,772,26036
47167,14659,7340,102,490,253,156,396,219,7319
48051,18531,9984,46,776,150,56,557,148,8547
37830,29454,14150,36,802,420,147,801,399,15304
15690,8458,4284,58,220,60,34,227,85,4174
5482,7799,3708,0,168,78,26,132,64,4091
29584,2365,1162,0,62,26,0,81,4,1203
12967,1186,641,9,32,6,3,37,23,545
13026,1734,848,37,43,30,67,47,28,886
20886,34100,16701,273,1409,294,131,1212,472,17399
26823,218,51,0,0,0,0,0,0,167
14168,32,18,0,4,0,0,0,0,14
15017,16440,7715,33,411,69,117,467,156,8725
95954,13495,6423,89,322,271,87,176,181,7072
92249,7898,3872,122,146,36,96,243,83,4026
93445,7383,3785,22,420,159,104,248,18,3598
2898,1643,814,49,16,78,57,37,24,829
960,2221,2187,41,342,9,0,3,0,34
61616,5910,2746,87,241,42,11,127,51,3164
63133,7336,3042,77,80,58,24,265,105,4294
78147,2151,1090,19,47,39,34,109,36,1061
79763,38955,18882,578,1320,362,214,1279,338,20073
71070,1770,817,0,97,10,3,20,69,953
71266,1241,563,0,87,12,0,15,30,678
59484,95,44,0,15,4,0,7,6,51
67733,333,173,0,0,4,0,0,0,160
68349,1064,536,3,25,9,3,25,16,528
68742,184,82,0,2,0,0,1,7,102
73726,495,258,0,16,6,0,13,4,237
76573,23,9,0,0,4,0,0,0,14
54985,415,328,7,25,0,4,8,0,87
38451,4204,2201,38,162,79,71,143,87,2003
40360,6875,3343,58,213,40,17,152,20,3532
60045,21131,10472,170,328,234,111,403,372,10659
61462,11521,5439,125,414,194,162,202,145,6082
62017,897,465,11,21,4,0,40,13,432
57315,1118,536,13,32,11,8,37,14,582
58222,304,159,0,28,3,0,5,2,145
49947,1670,1406,24,186,12,0,5,15,264
50274,252,118,0,1,2,0,0,5,134
50543,1363,634,8,42,13,4,48,20,729
41017,40051,19607,313,1361,590,113,1218,760,20444
41093,2950,1347,3,66,28,8,137,8,1603
42069,504,256,0,13,0,0,0,0,248
43001,2810,1389,0,147,8,12,167,33,1421
44490,970,516,11,30,22,11,31,21,454
44890,11245,5493,87,221,188,56,180,234,5752
45727,401,218,6,1,57,0,1,1,183
45891,14905,7151,94,386,181,125,511,270,7754
50647,2037,1008,4,68,69,8,62,9,1029
39352,346,160,0,0,20,0,0,35,186
15380,538,294,3,7,0,0,5,5,244
33544,27606,13908,66,920,252,139,1193,277,13698
26136,635,373,6,0,26,0,0,11,262
8346,695,404,0,0,0,0,0,35,291
10910,0,0,0,0,0,0,0,0,0
28577,388,213,14,23,3,0,13,0,175
26582,4560,2161,31,109,65,0,103,53,2399
27350,6021,2961,13,114,93,0,252,94,3060
35089,2034,925,0,20,17,0,40,23,1109
7650,20536,10631,171,967,215,79,836,217,9905
1242,471,203,0,21,0,0,38,0,268
16259,1839,949,11,33,30,4,47,50,890
25676,1302,551,41,21,0,0,43,30,751
8734,8624,3961,56,138,69,134,192,186,4663
20688,1739,801,0,0,26,32,0,0,938
92585,21732,10798,174,736,91,117,874,238,10934
87070,189,141,0,0,26,0,0,0,48
89027,17904,8793,49,274,389,125,334,322,9111
99709,30428,16125,309,891,414,282,940,475,14303
44822,2749,1373,41,75,24,19,85,41,1376
46394,12358,6192,135,361,127,76,357,150,6166
46825,29331,14621,438,1043,389,295,903,295,14710
31555,2793,1338,25,11,13,3,83,25,1455
32810,39384,18792,190,1234,287,425,1413,381,20592
18848,8489,4219,70,202,80,17,234,146,4270
72110,11472,5415,59,399,146,32,364,175,6057
73080,9436,4467,40,256,136,8,320,111,4969
73626,1032,522,6,33,8,0,34,9,510
73858,1554,750,10,42,23,0,56,20,804
50594,189,109,0,1,3,0,1,2,80
44064,1724,921,11,21,8,0,68,49,803
44855,1337,721,1,50,42,2,51,11,616
45658,2989,1581,10,89,13,34,92,15,1408
45897,36,11,0,0,0,0,0,11,25
46725,23361,11646,106,735,281,147,673,382,11715
54140,9461,4543,89,218,80,125,336,71,4918
35242,55122,26512,445,1421,484,304,1910,922,28610
36039,240,126,8,0,0,0,7,7,114
36473,21,8,0,0,0,0,0,0,13
58461,429,206,0,10,2,0,2,5,223
59223,339,162,0,2,8,0,3,0,177
59241,486,207,0,6,6,0,11,2,279
39631,3204,1420,0,191,27,0,69,41,1784
55114,2931,1328,55,88,24,82,103,53,1603
28617,2323,1184,0,67,28,0,70,12,1139
14006,9949,5013,75,285,84,37,240,137,4936
15104,8556,4154,39,341,120,59,245,119,4402
16630,4747,2119,50,144,53,90,147,66,2628
32506,36923,17679,161,1191,272,138,1138,447,19244
22901,35108,16240,312,1039,339,38,1243,581,18868
7109,36019,17785,212,1272,327,328,1228,472,18234
55065,1184,591,12,49,11,9,48,15,593
55327,3402,1758,0,115,47,10,89,93,1644
45353,142,63,0,16,0,0,0,4,79
13812,2482,1255,14,67,29,17,85,42,1227
16334,344,176,0,5,0,9,19,6,168
16428,12628,6367,66,261,193,47,315,142,6261
31072,1357,762,45,70,11,2,19,26,595
32091,15311,7524,97,576,226,27,437,300,7787
21705,0,0,0,0,0,0,0,0,0
23120,10025,5129,102,475,71,23,563,78,4896
23250,0,0,0,0,0,0,0,0,0
25517,1640,827,0,38,74,0,56,22,813
29360,20651,10087,102,648,192,153,729,228,10564
17518,1643,857,30,41,21,23,29,9,786
18032,9391,4404,114,267,111,38,346,98,4987
27615,43461,21175,66,1225,493,114,1418,806,22286
28174,9284,4305,194,164,101,264,253,82,4979
8010,11115,4971,52,358,151,10,345,156,6144
47471,2717,1287,2,151,0,14,77,58,1430
48176,23757,12002,209,595,208,73,627,360,11755
41465,11551,5740,96,228,138,37,314,126,5811
41567,179,93,0,0,0,0,0,0,86
42633,19911,9744,103,748,170,134,603,176,10167
43724,9319,5812,48,461,246,13,207,104,3507
45155,371,186,0,12,4,0,16,0,185
36456,1393,747,46,28,6,0,39,16,646
37765,516,245,0,0,15,0,19,23,271
92066,572,268,0,45,12,0,24,6,304
92571,56446,29308,679,1631,275,679,1710,216,27138
61441,1001,504,6,15,7,22,24,14,497
62242,1445,667,4,48,3,0,40,40,778
66072,1108,641,6,13,19,0,8,2,467
66757,3201,1556,13,59,32,12,96,37,1645
68823,2237,1090,0,41,50,8,51,31,1147
76258,6876,3198,21,227,9,31,116,84,3678
76639,1471,791,19,33,10,7,56,4,680
77034,40532,19570,259,1910,120,514,1225,209,20962
77872,1819,850,0,34,16,25,69,15,969
56465,1976,1054,2,48,34,17,38,41,922
56541,37,24,0,0,0,0,0,0,13
71822,8543,4260,3,323,109,48,232,145,4283
99576,2494,1242,6,116,18,11,80,26,1252
97306,32255,15876,70,1013,388,266,1082,477,16379
80520,1517,829,0,77,0,32,85,0,688
28642,5890,2937,25,108,69,58,138,113,2953
39213,20958,10047,204,556,246,159,714,313,10911
39520,18016,8605,63,344,238,64,449,121,9411
45232,6849,2768,43,122,11,84,236,60,4081
46055,11934,5877,0,404,153,0,512,94,6057
46714,14852,7331,169,414,99,86,464,144,7521
32536,23426,11813,84,917,507,287,1038,174,11613
34797,1084,507,0,29,17,0,70,16,577
34945,5019,3115,76,243,51,6,109,90,1904
81332,174,89,4,2,5,0,9,4,85
97390,978,549,10,55,0,23,25,41,429
1841,48827,24309,458,1591,410,409,1774,447,24518
2062,29201,14222,43,1153,224,101,912,415,14979
2364,13381,6266,97,299,93,43,364,192,7115
40873,2245,1047,0,63,7,37,38,23,1198
56751,5536,2733,27,178,50,22,178,126,2803
58763,4166,2176,15,104,50,18,147,37,1990
59006,967,450,0,17,11,0,10,0,517
59424,73,33,0,0,0,0,2,0,40
53097,6249,2881,72,107,41,115,89,89,3368
44413,7371,3561,0,213,35,18,274,178,3810
44842,5392,2446,63,165,54,13,175,118,2946
47030,2175,1057,0,133,17,0,48,28,1118
51636,393,202,0,4,2,0,4,12,191
43084,766,378,0,14,23,3,33,4,388
61279,870,460,7,48,6,9,40,7,410
63030,340,180,0,0,0,0,18,0,160
63703,8383,3781,156,137,27,239,179,72,4602
64443,1395,694,2,35,17,14,21,39,701
30439,10823,5369,12,312,55,78,430,194,5454
32181,2268,1091,0,24,26,22,94,43,1177
21117,58673,27543,487,2198,488,303,2641,807,31130
24015,15209,7340,157,614,217,91,551,242,7869
14572,4910,2346,8,89,94,23,126,101,2564
16666,3223,1711,108,120,93,0,80,42,1512
17018,4475,2328,37,148,44,0,81,32,2147
17249,432,205,6,5,6,0,0,3,227
12734,903,403,19,0,24,0,0,19,500
13143,2706,1421,18,176,60,0,88,41,1285
24827,1271,626,0,31,18,0,16,11,645
26070,8324,4007,7,119,164,78,238,158,4317
35176,902,552,0,20,26,0,17,7,350
35206,17350,7869,131,456,171,109,657,216,9481
36108,18299,8093,31,206,189,178,493,374,10206
18656,2112,1048,30,77,51,16,72,60,1064
27870,25792,12070,130,561,516,155,709,408,13722
29210,40305,20076,403,1314,244,429,1185,465,20229
95950,394,183,0,0,15,0,0,0,211
16820,1030,511,4,17,11,0,21,8,519
18701,3526,1662,220,41,15,154,20,28,1864
25093,278,143,0,16,0,0,19,0,135
28344,4199,1942,43,72,51,34,152,96,2257
6443,18183,8665,66,324,363,30,323,245,9518
12883,4885,2229,40,128,47,70,115,147,2656
13354,3944,2191,27,102,44,14,67,74,1753
1913,17378,8582,46,486,160,34,318,214,8796
70647,9353,4498,18,285,67,20,208,141,4855
71350,4038,1809,20,102,71,4,94,36,2229
48044,57582,28177,415,1965,445,285,2390,688,29405
48227,41777,19464,233,956,558,259,1220,640,22313
49822,260,119,0,5,11,0,7,4,141
78620,16882,8541,96,797,210,38,602,211,8341
79078,249,125,0,5,9,0,1,3,124
88426,981,508,0,0,8,0,4,2,473
94303,48039,24161,373,1561,298,321,1810,612,23878
97041,2825,1539,26,61,37,45,93,33,1286
78021,318,237,0,0,0,0,0,0,81
68350,199,101,0,3,3,0,5,3,98
45845,2871,1487,16,66,29,8,64,27,1384
12863,729,416,0,20,9,0,43,0,313
31836,849,384,7,19,42,0,5,7,465
27043,7094,3466,31,253,71,39,220,154,3628
32502,3185,1662,6,103,55,10,101,59,1523
81630,900,480,0,39,15,2,19,10,420
84701,8860,4389,56,396,35,34,341,95,4471
64108,7799,4011,46,377,89,25,248,117,3788
74845,500,260,7,16,5,3,16,5,240
78002,7329,3866,117,377,74,0,297,57,3463
66901,6133,2973,71,128,42,76,137,43,3160
67101,4899,2202,35,23,25,93,179,26,2697
70748,7114,5128,58,448,46,5,122,96,1986
71079,194,61,0,9,0,0,0,0,133
98383,21301,11048,100,701,232,45,647,209,10253
95982,3229,1717,0,114,17,0,50,61,1512
93710,32625,15087,392,880,229,468,859,328,17538
61241,6827,3532,5,237,98,18,151,144,3295
61270,7007,3488,51,124,185,34,233,128,3519
61354,10589,4801,40,239,104,64,303,69,5788
68722,625,306,0,14,6,7,18,6,319
79567,3352,1635,0,84,57,7,132,21,1717
65764,1540,847,0,31,24,39,24,12,693
67840,82,48,0,0,1,0,1,1,34
56174,345,156,0,6,1,0,4,2,189
56260,900,457,2,26,16,4,23,12,443
62846,2704,2420,15,244,72,3,35,4,284
62870,2090,1034,10,71,28,7,67,12,1056
63047,69,69,27,0,0,0,0,0,0
73639,588,302,16,25,2,0,24,4,286
75149,54979,26926,242,1491,407,578,1933,412,28053
83848,148,51,0,0,17,0,0,11,97
90011,109414,54875,865,3954,428,874,3415,793,54539
92841,34061,16915,333,967,371,325,1006,450,17146
93711,38349,18408,297,1240,431,114,1013,529,19941
95922,454,256,0,7,4,0,12,33,198
4217,3279,1681,0,104,75,44,36,66,1598
4613,78,31,0,0,0,0,0,0,47
6750,1147,566,2,32,34,15,17,23,581
1081,1941,928,4,38,33,0,63,20,1013
52573,204,95,0,0,0,0,17,0,109
47011,839,533,0,0,9,0,64,0,306
2830,5935,2880,17,140,34,18,265,191,3055
4353,2363,1154,15,89,59,13,83,80,1209
5158,1041,560,0,8,43,13,35,26,481
5651,1420,706,0,37,5,0,47,48,714
14781,2089,1058,30,54,54,9,71,31,1031
15467,125,50,0,0,6,0,0,2,75
15666,15964,7849,83,439,290,66,399,281,8115
89440,902,556,0,28,52,0,31,0,346
92604,28819,14107,334,886,304,136,925,418,14712
73028,3651,1656,38,119,36,29,123,68,1995
95405,21448,9924,104,516,245,32,665,472,11524
97215,18676,9031,41,685,186,14,647,334,9645
65468,153,96,0,0,0,0,0,0,57
28672,16,16,0,0,0,0,0,0,0
29568,15066,6820,57,488,298,36,689,335,8246
30448,76,39,0,0,6,0,0,0,37
30833,3065,1521,10,75,36,6,64,103,1544
12748,2160,1129,59,62,23,0,45,37,1031
63674,76,0,0,0,0,37,0,0,76
49852,107,62,0,2,1,0,4,0,45
50131,20920,9795,79,619,191,19,796,352,11125
50268,1054,475,0,58,7,7,36,13,579
56142,949,458,10,19,4,15,16,6,491
51463,526,256,0,12,10,0,18,7,270
52332,2064,973,0,35,40,2,68,61,1091
52651,803,521,0,13,5,6,6,3,282
48866,5026,2406,32,145,43,42,156,54,2620
49233,2439,1228,15,36,78,16,23,25,1211
57479,549,331,5,14,19,0,15,3,218
58380,433,204,0,7,11,21,11,0,229
72851,630,393,0,0,0,0,0,0,237
49774,1660,894,6,55,29,0,12,19,766
50237,3347,1800,1,101,20,0,135,60,1547
51239,2982,1598,23,114,68,0,87,41,1384
71601,14696,6844,195,280,82,260,340,206,7852
31020,1688,923,44,25,16,30,29,19,765
38555,19858,9611,11,537,178,46,545,175,10247
47345,1475,693,0,45,24,0,20,35,782
34689,27496,13026,253,684,417,137,718,450,14470
35406,17190,8341,84,516,167,9,506,210,8849
35621,2951,1703,81,102,19,0,8,37,1248
41234,609,273,0,26,0,18,5,0,336
41421,372,109,0,7,0,2,0,0,263
24280,958,522,29,31,9,0,40,35,436
25916,253,110,0,24,9,0,0,0,143
25011,631,288,0,16,11,32,19,2,343
50143,686,346,0,12,5,0,9,49,340
52140,666,316,0,34,7,0,2,27,350
52534,368,198,0,11,2,0,6,3,170
72153,2371,1224,28,59,35,0,83,36,1147
72429,339,190,0,32,0,0,23,4,149
74963,474,258,0,16,10,7,8,3,216
75119,28319,14050,150,1011,241,152,884,603,14269
11743,41938,20452,153,907,504,112,1082,697,21486
12801,14381,6845,87,728,188,71,375,208,7536
20106,5276,2764,12,49,91,0,131,70,2512
22307,9962,4438,12,152,102,71,268,118,5524
23692,18201,8461,57,354,248,65,482,342,9740
4961,827,430,0,9,31,8,27,29,397
6061,104,72,0,0,0,0,0,0,32
6840,20273,9709,45,625,119,78,562,255,10564
7605,9111,4420,78,379,87,53,293,194,4691
16133,1571,740,1,63,12,4,40,31,831
11944,4121,1704,0,130,39,0,130,157,2417
12701,11626,6020,23,273,258,25,390,141,5606
10992,8951,4426,104,109,53,18,139,78,4525
81058,1051,529,9,30,12,6,30,17,522
81210,224,131,0,8,37,0,10,0,93
84774,2011,1027,10,35,25,11,59,25,984
86337,1305,615,0,87,14,9,29,14,690
87121,78900,38816,486,3381,531,412,3126,809,40084
87820,106,67,0,0,0,0,0,0,39
93930,17142,9013,64,613,79,114,623,118,8129
94597,22734,11470,23,1013,124,56,872,243,11264
95585,483,244,6,22,7,0,5,21,239
53919,2729,1382,9,71,24,10,97,30,1347
14113,523,253,3,25,0,0,2,10,270
14788,73,41,0,0,0,0,0,0,32
6282,1258,638,0,80,0,0,0,50,620
6519,15997,7795,104,514,63,36,570,114,8202
19043,2331,1056,0,76,12,0,79,64,1275
20816,16367,7956,25,271,177,24,433,203,8411
2341,10668,5430,27,302,190,141,316,195,5238
17263,380,203,0,0,32,0,0,0,177
10964,1283,636,0,22,48,0,26,20,647
23308,1921,1005,31,52,9,4,54,23,916
12740,1958,1067,0,39,60,0,79,34,891
12779,1959,1017,0,141,47,0,94,0,942
26542,2526,1293,0,119,25,13,50,59,1233
28081,27557,13084,155,635,292,152,938,368,14473
43344,5996,2921,47,174,60,27,203,49,3075
38583,24089,11832,126,615,248,118,699,315,12257
57340,327,164,0,21,2,0,25,0,163
44118,38833,18535,307,1230,392,608,1002,482,20298
44901,2627,2627,62,426,0,0,0,0,0
45330,846,473,17,25,0,0,10,11,373
34481,19147,9218,52,159,394,0,315,341,9929
50271,631,322,2,18,7,6,39,9,309
39335,3067,1462,0,45,0,0,34,28,1605
45111,324,152,0,4,9,0,0,26,172
45326,1066,523,8,41,28,1,19,5,543
54842,146,72,0,7,0,0,0,0,74
54979,1394,775,3,10,18,0,7,11,619
66048,36172,19264,158,1668,534,281,1156,470,16908
59724,67,38,0,0,0,0,0,2,29
47868,3080,1657,21,194,84,0,129,26,1423
48529,9936,4706,14,283,185,35,338,128,5230
48808,5930,2867,0,233,114,31,114,58,3063
56377,18743,9439,95,802,129,34,797,208,9304
43008,2614,1311,0,61,0,16,92,50,1303
49796,337,183,0,0,2,0,1,3,154
50160,498,253,10,14,5,2,20,0,245
50528,268,163,0,5,11,0,7,4,105
68368,581,288,0,8,2,0,9,8,293
64748,1383,681,18,33,13,25,23,10,702
64620,450,260,1,30,6,3,60,0,190
65742,13295,6664,57,525,131,42,381,115,6631
76842,266,133,0,0,10,0,32,0,133
80305,17502,9160,117,487,165,111,583,199,8342
83442,21981,11227,81,865,139,82,800,283,10754
83672,8287,4164,48,170,144,28,188,156,4123
60088,12662,9275,751,155,0,214,118,12,3387
62079,244,94,0,10,0,0,9,0,150
62233,9680,6639,10,727,57,31,144,88,3041
56637,178,85,6,6,3,2,10,1,93
57218,358,180,0,23,0,0,9,4,178
58270,1835,905,10,55,22,0,40,28,930
78628,32946,16134,234,1022,481,133,1225,365,16812
62468,2514,1293,9,91,35,0,38,50,1221
62975,325,202,0,41,0,0,0,0,123
73541,2714,1442,43,103,65,5,75,49,1272
24313,789,353,0,34,0,0,32,0,436
24884,284,96,0,30,0,0,9,0,188
13813,609,357,0,3,27,0,27,41,252
16434,3167,1654,15,81,26,28,66,12,1513
17094,2564,1293,17,78,20,9,93,29,1271
22728,3182,1696,25,59,52,0,74,56,1486
11210,67040,30595,251,1937,619,431,2436,968,36445
27343,1579,758,18,54,45,0,62,14,821
28016,13046,6065,62,245,110,149,403,184,6981
17844,10151,5005,36,222,86,42,226,164,5146
17923,536,282,8,1,9,15,0,0,254
18829,765,392,0,15,6,0,15,11,373
56055,3974,2016,23,169,65,9,130,63,1958
38235,346,150,0,2,4,7,11,0,196
7878,803,339,0,0,0,0,59,16,464
7881,6,2,0,0,2,0,0,0,4
10012,23411,11579,289,998,194,214,943,235,11832
12008,609,290,0,20,10,0,0,0,319
12747,1992,885,14,38,43,0,138,53,1107
15476,55,15,0,0,0,0,0,0,40
16852,340,194,0,2,1,3,7,11,146
2747,23512,11681,465,575,163,581,510,213,11831
77003,9876,5108,28,568,28,40,491,74,4768
77419,1452,684,16,11,24,49,30,31,768
66946,97,43,0,0,1,0,0,1,54
68025,30488,14987,210,814,372,118,976,330,15501
68073,1751,929,5,64,28,0,56,15,822
72444,1809,803,10,34,31,21,16,9,1006
43456,291,161,5,9,1,0,18,5,130
65674,2950,1451,42,56,10,5,64,24,1499
46760,1363,669,0,68,26,0,31,22,694
47017,439,213,0,0,0,0,0,0,226
47359,2941,1542,20,50,46,13,57,51,1399
50140,2831,1380,104,32,31,62,87,19,1451
53153,2434,1232,8,55,22,14,58,31,1202
54136,6293,3108,0,245,53,5,279,86,3185
83634,27380,16152,224,1222,99,149,945,452,11228
84119,53910,28723,434,2457,291,412,2016,355,25187
85263,2600,1311,0,32,38,0,21,41,1289
85306,25206,12278,312,717,290,267,877,298,12928
85374,47709,21988,114,924,590,146,1149,742,25721
94803,26165,12722,204,865,420,219,936,476,13443
95935,602,204,0,42,0,14,51,0,398
78541,44680,21407,477,1107,345,489,1910,461,23273
79053,152,68,0,12,0,4,14,0,84
79240,72,29,0,0,0,8,0,0,43
61883,4284,2042,17,79,46,22,97,33,2242
62411,4136,2118,7,170,46,44,123,94,2018
15067,2228,1192,11,38,36,13,45,36,1036
20658,875,417,0,59,3,0,30,12,458
4743,4527,2225,51,195,117,9,156,75,2302
19136,34470,17838,300,1186,304,309,1317,392,16632
2176,28116,13525,109,1171,310,142,1448,248,14591
38603,2901,1423,4,110,10,0,37,56,1478
40843,281,143,0,0,0,0,8,4,138
32097,18518,9464,48,815,203,102,699,270,9054
33786,1632,791,5,27,31,0,35,41,841
44101,610,3,0,0,0,0,121,0,607
45145,19,9,0,0,0,0,0,0,10
36525,1928,965,30,39,30,4,58,15,963
37166,14358,7020,96,536,143,94,584,193,7338
28383,8854,4091,56,206,120,44,260,195,4763
25507,811,371,8,22,7,14,0,14,440
41086,2877,1314,23,51,72,8,76,31,1563
42516,437,232,0,6,10,0,9,0,205
43408,270,129,0,6,4,0,9,0,141
30139,4143,2240,108,158,5,7,192,41,1903
95631,6800,3632,21,229,111,32,170,118,3168
98034,43119,20994,70,1646,432,100,1729,688,22125
98315,6336,4248,516,153,0,92,107,0,2088
84085,463,216,0,0,6,0,6,5,247
67035,915,465,0,15,24,2,20,7,450
67556,288,138,6,1,0,0,0,11,150
56271,1167,613,3,31,10,3,27,9,554
57040,343,169,0,9,2,2,10,11,174
58495,1367,691,0,18,7,0,24,26,676
49452,1959,1021,19,49,14,39,49,34,938
70615,14230,7097,132,360,62,99,425,185,7133
72039,2499,1267,2,109,2,2,36,23,1232
72058,16878,8351,55,510,155,78,396,181,8527
54628,867,458,0,27,10,0,35,10,409
60927,2106,1045,8,49,6,0,43,55,1061
62231,7436,3713,19,371,88,9,257,77,3723
29061,14605,7235,138,336,220,37,457,206,7370
43446,88,41,0,0,3,0,0,0,47
35986,8130,3854,55,203,23,43,243,70,4276
22508,14147,6896,146,517,240,42,439,234,7251
26845,725,355,20,33,0,0,26,0,370
28262,43046,21863,935,1554,99,902,1321,325,21183
31318,432,274,0,0,0,0,0,0,158
25813,8038,4692,68,523,60,17,358,42,3346
33612,49312,24145,603,1349,442,455,1651,666,25167
80238,19901,10108,0,1165,66,28,1402,130,9793
82434,125,81,0,0,10,0,0,0,44
83012,226,75,0,0,0,0,0,0,151
84067,39085,19753,180,1518,296,297,1376,473,19332
96133,234,149,0,0,0,0,22,0,85
16347,2321,1321,27,50,11,8,39,31,1000
16440,943,465,0,22,8,2,18,13,478
5740,22,0,0,0,0,0,0,0,22
8648,31725,15103,299,880,340,378,1017,596,16622
12458,2804,1669,0,213,0,0,88,37,1135
21213,31701,13403,68,922,257,202,1148,652,18298
24724,130,92,0,5,3,0,2,0,38
24826,80,41,0,0,0,0,0,0,39
25832,4026,1983,0,150,59,0,224,92,2043
24093,137,76,0,2,3,0,1,17,61
14048,14177,6663,71,392,151,65,374,208,7514
4459,889,443,3,34,0,0,9,11,446
1258,489,285,0,32,9,0,6,7,204
81081,78,39,0,0,0,0,0,0,39
81633,0,0,0,0,0,0,0,0,0
85031,32737,16534,375,1227,128,359,1104,236,16203
85307,11212,5478,111,329,92,72,459,153,5734
78538,11524,5842,42,363,147,62,320,50,5682
78933,1294,683,0,0,17,0,0,0,611
79846,105,50,0,0,0,16,0,0,55
98672,6703,3350,25,279,174,85,158,77,3353
89433,21404,10907,139,711,141,73,796,219,10497
30453,10775,7310,164,855,92,36,347,128,3465
43324,2963,1500,35,107,17,4,113,49,1463
3245,2180,1057,0,33,29,11,59,27,1123
3862,4465,2054,8,105,93,7,165,121,2411
985,31845,14464,131,1048,197,145,1069,392,17381
22715,1204,554,0,35,0,0,43,13,650
24323,981,398,0,23,9,13,68,0,583
15361,232,146,0,71,0,0,0,10,86
15660,344,190,0,9,0,0,0,16,154
93644,8981,4481,16,182,120,0,242,118,4500
21029,10595,5107,49,104,73,55,259,121,5488
36688,216,56,14,0,0,16,0,0,160
60644,47712,22043,440,1553,326,379,1531,785,25669
61311,204,113,0,12,0,0,0,0,91
78250,60967,29802,330,1890,433,488,2079,605,31165
70559,2981,1535,0,105,38,7,133,30,1446
40376,48,17,0,0,0,0,0,0,31
3581,3080,1605,0,81,56,12,70,33,1475
3905,1866,875,0,0,42,20,88,83,991
5765,1696,871,14,53,15,16,40,33,825
7420,5100,2656,35,250,31,6,145,39,2444
2633,4175,1969,30,72,87,0,97,95,2206
99550,190,90,0,8,6,0,0,6,100
99663,390,211,0,2,8,0,6,16,179
85536,375,172,12,0,0,0,0,19,203
85931,203,111,3,0,0,0,8,0,92
76450,13020,6506,9,172,181,66,407,306,6514
94925,9866,4287,18,344,94,9,241,206,5579
96073,3939,1967,2,85,91,7,62,32,1972
78383,3958,2009,45,66,138,51,136,78,1949
78860,23,0,0,0,0,0,0,0,23
13740,547,275,0,11,10,0,10,1,272
14814,1833,917,14,66,16,15,67,18,916
15316,109,40,0,4,0,0,0,0,69
5142,741,413,0,23,16,12,31,6,328
6336,106,64,0,13,0,0,0,0,42
6853,3875,1805,0,79,51,0,147,42,2070
1032,533,233,0,12,16,0,17,20,300
44093,1210,641,33,17,8,35,0,7,569
27705,49019,23389,698,1161,473,765,1514,693,25630
32686,4764,2539,50,86,37,101,70,111,2225
48003,6240,3189,23,169,125,44,178,88,3051
16661,861,451,0,27,14,7,22,7,410
18415,1163,586,31,40,29,0,19,52,577
10308,30186,14569,248,1020,351,272,900,363,15617
4254,3143,1489,29,89,98,0,127,71,1654
13694,1441,690,4,27,10,0,51,30,751
14030,1775,959,4,58,25,8,40,26,816
14129,1470,689,0,42,24,4,46,32,781
14726,1829,886,24,35,14,22,52,15,943
21216,31409,14714,223,857,453,177,972,616,16695
716,28089,13142,247,981,419,233,799,596,14947
1568,7762,3916,22,320,65,0,316,156,3846
84023,218,128,0,2,0,0,6,0,90
84065,42161,20910,203,1817,188,181,1533,452,21251
76432,1166,589,3,25,39,0,17,19,577
66515,403,208,4,14,2,0,19,8,195
67025,3780,1827,7,100,41,6,114,72,1953
15484,68,42,0,13,0,0,12,14,26
25204,126,32,0,6,0,0,0,0,94
11030,18578,8791,56,388,111,61,441,369,9787
12023,2134,1144,9,65,32,0,58,26,990
12222,6153,3002,363,9,0,334,0,0,3151
28511,566,291,0,9,14,0,11,18,275
28629,0,0,0,0,0,0,0,0,0
30072,727,265,0,27,18,0,17,27,462
25047,127,37,0,16,0,0,18,0,90
25125,898,480,0,49,13,0,28,15,418
25801,32315,15261,185,1030,426,89,1009,521,17054
26208,890,474,18,35,6,5,16,0,416
42076,1065,515,0,6,27,0,66,17,550
38504,883,423,34,0,0,16,0,76,460
47634,2293,1145,17,70,11,10,75,9,1148
27006,14555,6886,25,283,206,39,247,302,7669
32692,274,148,0,0,29,0,0,22,126
95559,72,16,0,0,0,0,0,19,56
95821,35430,16526,148,1184,346,269,1444,552,18904
95945,25519,11712,55,756,488,22,729,643,13807
96120,1044,540,7,33,27,0,40,8,504
99135,311,160,3,5,16,0,7,16,151
99138,1094,515,6,22,12,4,33,19,579
85716,30313,14949,490,944,359,368,907,484,15364
76239,1214,670,0,58,10,3,33,10,544
87026,4112,1933,29,169,17,45,192,79,2179
87301,24123,11630,134,525,286,91,523,321,12493
99656,21,8,0,0,1,0,2,0,13
63549,2459,1193,8,67,52,12,54,42,1266
64429,13168,8260,153,927,169,21,292,80,4908
65109,39417,18773,35,1412,374,78,1390,663,20644
65360,5246,2523,26,200,38,79,134,33,2723
56114,283,167,0,4,2,0,7,3,116
57475,94,51,0,0,3,0,0,4,43
58229,112,42,0,0,1,1,1,1,70
58620,104,59,0,9,1,0,8,1,45
66070,2474,1388,0,67,29,0,54,36,1086
67106,272,167,0,0,13,0,0,0,105
67120,1011,631,0,32,17,0,21,0,380
62050,354,160,1,10,3,0,13,8,194
54651,1474,729,8,39,17,17,38,21,745
54664,1641,805,3,60,31,2,51,29,836
78150,27,27,0,0,0,0,0,0,0
74103,2134,1598,33,200,0,7,58,0,536
77479,92146,45045,495,2978,796,109,3463,1425,47101
78019,1470,852,0,53,34,0,58,26,618
58734,386,206,0,11,4,0,0,0,180
76384,12289,5999,64,404,141,50,421,222,6290
65565,5060,2538,39,85,59,68,147,128,2522
80532,223,106,0,0,0,0,11,32,117
66938,1106,581,19,28,11,0,48,17,525
82332,188,90,0,28,0,0,38,0,98
55435,13744,6065,41,371,110,35,320,234,7679
57541,208,112,0,6,0,0,0,0,96
49858,11792,5850,72,382,191,30,284,149,5942
90008,31739,14018,167,967,312,245,961,703,17721
50556,189,91,0,0,4,0,1,5,98
40037,2674,1271,11,80,12,35,102,37,1403
40442,1403,757,0,33,0,0,44,7,646
95070,31308,15521,123,461,352,103,678,573,15787
98597,23972,11680,267,696,171,132,901,149,12292
44046,2473,1199,57,81,34,1,51,72,1274
95624,65742,32407,482,1979,499,554,2084,856,33335
50225,2797,1449,52,59,21,17,111,23,1348
51442,9793,4817,26,197,126,27,424,157,4976
67836,207,101,0,14,2,0,4,15,106
71410,104,47,0,0,1,3,4,5,57
68752,722,398,5,20,14,5,4,17,324
73021,241,120,0,16,10,0,0,0,121
15710,236,140,0,13,5,0,14,11,96
75763,6463,3100,25,152,131,62,176,67,3363
76366,1841,893,34,45,24,4,45,38,948
18330,8379,4228,12,355,121,52,207,62,4151
76501,16801,8791,193,422,236,35,648,130,8010
10502,5567,2903,1,118,66,0,129,94,2664
65324,1337,673,0,0,46,13,9,10,664
12777,850,436,3,27,16,15,18,29,414
58341,2589,1243,1,68,54,1,40,58,1346
5455,1021,521,4,33,4,7,37,14,500
58623,2275,1071,0,45,29,19,67,33,1204
70719,4356,2076,59,72,28,4,150,32,2280
61940,238,121,0,6,0,2,7,10,117
17086,2409,1137,13,89,24,4,79,34,1272
58379,354,184,3,13,5,6,10,7,170
14753,1148,578,1,18,36,4,53,17,570
60044,10003,4642,54,204,136,15,264,241,5361
16316,5189,2411,41,93,83,0,60,101,2778
83622,2257,1175,0,34,40,7,62,62,1082
26808,785,353,0,29,51,0,0,20,432
84064,865,478,47,17,10,0,6,23,387
30527,4377,2198,3,89,49,13,144,81,2179
97752,0,0,0,0,0,0,0,0,0
35456,3461,1582,22,31,32,0,29,0,1879
37137,2872,1406,14,41,36,0,85,26,1466
46201,29807,14519,164,1056,187,140,1233,336,15288
97385,3546,1628,7,135,36,0,105,36,1918
48418,3984,2137,43,101,20,14,92,42,1847
4547,987,450,0,42,14,0,18,10,537
641,27571,13419,143,622,351,131,804,411,14152
49451,5933,2953,27,166,59,4,239,101,2980
49814,1411,693,7,38,25,6,35,33,718
4674,475,240,15,12,3,0,30,10,235
31510,9914,5043,35,258,103,53,426,180,4871
10039,27726,11816,272,719,102,199,1170,324,15910
32605,24684,11477,161,762,240,307,1011,440,13207
25661,6301,2899,0,277,99,74,267,144,3402
32962,26469,12841,208,699,297,169,931,449,13628
12456,851,443,0,23,10,0,24,8,408
14425,11848,5447,44,460,76,53,455,180,6401
15006,471,229,0,8,19,0,0,0,242
77042,42515,19631,318,1347,187,104,1397,575,22884
15061,12622,5990,50,514,133,64,347,125,6632
15315,595,318,7,13,6,0,47,0,277
16371,3150,1496,13,89,57,4,96,35,1654
5679,3388,1679,0,159,92,9,178,33,1709
6615,18694,8436,145,597,239,278,643,248,10258
26143,4808,2415,16,172,61,38,117,94,2393
76686,205,105,0,4,3,0,3,4,100
74427,1206,641,29,18,34,0,8,22,565
77091,27078,13702,64,1110,255,84,1080,271,13376
80470,3186,1518,0,112,73,0,86,89,1668
95450,298,167,3,0,9,0,27,0,131
62896,12167,5850,83,201,228,78,259,177,6317
95947,2005,1019,0,36,0,0,0,36,986
68642,1893,961,3,71,12,3,70,24,932
69040,588,283,0,16,7,0,15,31,305
87108,37248,18410,284,1503,369,267,1194,381,18838
66518,144,61,0,0,5,0,6,1,83
84080,369,206,0,7,1,0,17,7,163
91402,70686,34815,543,2716,607,434,2783,865,35871
87024,2453,1100,6,76,19,13,61,11,1353
92625,12148,5784,33,315,253,0,331,289,6364
74940,2885,1478,30,70,13,16,105,27,1407
11372,61844,30769,188,3219,533,291,2666,766,31075
14590,5412,2822,51,200,27,39,151,117,2590
12183,2591,1314,67,81,22,0,99,56,1277
31017,1913,895,9,46,40,8,67,19,1018
13319,811,356,0,28,14,0,27,25,455
28573,2053,1012,0,67,24,0,28,50,1041
23504,23058,10252,291,650,158,258,691,265,12806
65606,3171,1652,6,40,72,0,80,95,1519
21542,676,349,6,27,5,3,5,7,327
68042,86,45,3,3,0,0,2,1,41
21665,263,133,0,8,0,0,25,5,130
68419,261,122,0,14,6,0,4,3,139
19004,9719,4445,0,169,114,0,320,164,5274
68726,664,345,0,20,13,2,7,3,319
68755,292,141,0,4,0,0,3,4,151
28423,2359,1161,0,59,56,5,32,43,1198
98836,1233,489,107,0,0,0,0,8,744
97447,373,204,0,0,0,0,0,9,169
5201,14197,6867,89,267,113,190,345,156,7330
95961,27728,14141,248,1030,254,150,1028,213,13587
68410,8772,4262,92,310,142,52,192,121,4510
76549,51767,25335,322,1898,222,335,1643,351,26432
99591,78,44,0,2,1,0,1,2,34
72346,564,285,0,0,13,13,19,26,279
84715,278,138,0,0,9,0,4,2,140
73757,233,122,0,7,8,1,0,0,111
63056,1751,935,94,39,26,5,60,7,816
46967,101,52,0,1,5,0,1,0,49
78871,56,4,0,0,0,0,0,0,52
60118,15836,7943,44,447,142,143,306,207,7893
62918,10155,4727,152,378,91,88,360,135,5428
56156,5809,2747,3,175,79,21,190,69,3062
28127,7860,4226,104,124,114,43,129,118,3634
23227,25491,11396,183,642,329,139,723,456,14095
22302,17776,8300,84,820,107,21,1026,238,9476
24270,603,355,0,0,0,0,0,13,248
22840,4363,2177,10,81,28,0,108,66,2186
3583,941,443,0,10,12,9,9,13,498
28341,4843,2243,0,124,50,62,205,56,2600
16113,489,226,6,31,9,0,8,6,263
13625,1863,916,0,31,37,0,27,19,947
25305,0,0,0,0,0,0,0,0,0
76801,25319,12755,126,738,262,204,476,392,12564
17520,4696,2425,23,129,58,12,103,52,2271
53147,16655,8239,73,351,197,109,390,312,8416
83427,1911,990,18,66,11,0,22,22,921
60553,701,392,2,16,15,3,12,8,309
79258,47,27,0,0,0,0,0,0,20
79607,3268,2156,229,137,0,34,104,0,1112
56481,1945,1017,18,63,21,8,70,29,928
92823,4721,2296,0,233,40,23,286,57,2425
62894,1061,533,2,43,18,0,61,15,528
8052,18729,8966,144,532,190,95,620,301,9763
31213,0,0,0,0,0,0,0,0,0
58440,105,59,0,3,3,0,2,4,46
31636,10640,4968,72,251,160,98,500,132,5672
59433,527,248,0,3,6,0,10,14,279
33328,28782,13632,188,713,353,161,918,320,15150
28540,48775,24991,569,1515,393,215,1439,507,23784
17576,271,138,0,0,0,0,0,0,133
25848,290,117,19,14,0,0,0,21,173
26152,109,68,0,0,0,5,0,0,41
42025,19582,9702,27,696,289,95,628,209,9880
28110,53520,26125,535,1762,443,252,1607,438,27395
97884,158,70,0,2,0,0,4,3,88
13437,423,222,0,6,16,2,10,6,201
55063,9609,4896,86,313,151,52,220,107,4713
27050,3995,2052,12,18,64,9,61,39,1943
56219,1011,477,0,12,23,0,14,22,534
90033,47583,22853,435,1387,158,413,1482,531,24730
32420,1983,1023,17,75,54,0,63,52,960
91780,35351,16632,217,932,297,170,1114,460,18719
27927,932,497,0,24,10,0,43,12,435
79330,142,78,0,0,0,0,0,0,64
72460,761,439,1,0,0,0,42,16,322
73734,817,396,0,3,19,10,20,19,421
58007,103,56,0,10,5,0,0,3,47
93453,2953,1489,99,32,169,20,31,72,1464
43934,466,205,0,42,0,0,39,0,261
46738,8544,4103,45,407,144,62,312,108,4441
65762,412,200,0,9,0,14,14,8,212
67862,387,192,0,7,0,0,3,11,195
28575,484,217,0,5,39,0,20,0,267
8050,24930,12351,163,512,347,91,843,378,12579
11367,41824,20114,345,1032,508,199,1104,909,21710
12434,754,420,0,9,25,0,16,28,334
55939,1984,951,13,26,11,11,30,28,1033
62842,721,349,3,23,5,7,38,15,372
62208,16516,8252,90,473,145,36,616,277,8264
51052,829,461,1,17,24,0,11,10,368
74945,447,220,2,20,6,0,21,8,227
98136,16607,7906,59,699,228,128,828,275,8701
22935,876,467,0,24,54,0,39,13,409
15147,17270,8634,139,552,226,122,390,234,8636
3465,2015,975,6,110,42,3,98,113,1040
35963,1139,532,0,26,14,0,37,22,607
5440,1707,833,11,31,20,9,60,56,874
6794,1044,537,16,21,0,0,15,12,507
56319,1299,637,2,42,16,2,26,21,662
59037,1706,917,0,31,62,0,56,24,789
60115,45325,22102,1321,1055,225,1235,1078,378,23223
13425,2113,1163,5,83,25,5,75,35,950
79261,357,173,16,13,8,4,9,1,184
7936,11116,5094,22,263,89,161,171,244,6022
67417,177,115,0,38,0,0,0,0,62
68048,12726,6469,136,315,114,63,309,218,6257
80216,13118,7507,217,261,63,97,449,111,5611
60143,10996,5274,30,424,143,3,295,351,5722
84338,417,198,0,17,0,3,10,6,219
49454,4613,2318,19,115,35,23,172,56,2295
50680,1185,606,0,45,8,10,30,7,579
98361,836,464,0,98,26,0,0,25,372
56075,136,63,2,3,0,0,2,1,73
56484,3500,1719,18,75,81,28,38,109,1781
97362,4393,2143,50,237,31,37,161,70,2250
59256,57,37,0,7,0,0,0,0,20
77865,2273,1095,0,13,49,7,74,2,1178
63456,4317,2155,35,118,43,29,156,29,2162
53573,3179,1630,19,87,43,0,104,58,1549
63833,170,77,0,0,2,5,0,2,93
69131,618,307,0,2,0,0,10,2,311
72640,293,149,0,0,0,0,0,0,144
63107,9490,4343,80,250,119,40,274,124,5147
48239,35888,16723,302,909,364,250,833,474,19165
80924,8652,4176,25,398,24,38,456,91,4476
18915,645,335,15,28,7,0,7,0,310
92084,51419,25666,488,1676,515,417,1737,689,25753
24087,4323,2381,65,77,30,0,157,20,1942
37701,7714,3764,0,254,75,35,169,139,3950
29843,1195,584,0,15,13,1,11,11,611
38953,360,161,0,0,0,0,0,16,199
30058,57658,25717,381,1682,598,689,1987,977,31941
44813,9312,4375,71,279,92,37,249,86,4937
13309,5823,2852,3,200,77,53,127,112,2971
47567,6117,3060,64,142,90,67,170,95,3057
95459,618,316,0,37,11,0,11,15,302
41749,3399,1713,0,134,95,26,116,80,1686
979,15897,7784,87,575,184,72,522,231,8113
54830,2716,1375,1,30,74,0,42,64,1341
56164,5325,2499,43,138,73,30,142,107,2826
56284,2205,1119,28,39,45,2,93,27,1086
57365,575,287,15,0,10,0,18,0,288
57716,507,205,0,4,20,12,17,6,302
50666,1106,579,2,42,12,2,38,14,527
47993,3683,1798,4,72,36,43,104,38,1885
30669,3429,1690,2,135,56,39,124,76,1739
39045,1647,820,0,28,51,0,0,0,827
47120,725,246,0,0,0,20,0,0,479
37369,906,435,0,41,43,0,24,22,471
43902,116,27,0,0,0,0,0,0,89
38376,164,64,0,0,0,0,0,12,100
45372,319,152,1,6,6,0,8,2,167
40810,1172,661,0,55,31,4,37,49,511
46737,7502,3689,23,150,120,4,225,138,3813
79839,2057,899,28,2,30,33,0,34,1158
72073,1085,587,27,40,13,0,39,12,498
43155,2669,1291,30,62,16,17,93,38,1378
67581,369,180,0,13,3,0,10,2,189
51041,7149,3441,125,231,64,70,204,50,3708
74452,386,185,6,3,3,18,10,3,201
5473,1414,725,9,41,20,7,35,23,689
1240,4441,2111,7,96,0,0,86,81,2330
5442,379,188,0,15,4,0,11,12,191
5867,885,397,0,8,11,0,34,18,488
92108,22565,11426,87,834,167,116,1073,213,11139
95608,61860,28874,318,2251,911,500,2023,1035,32986
12767,136,62,0,4,0,0,0,11,74
83122,963,429,0,74,0,0,96,0,534
44410,16702,8398,79,524,228,89,499,205,8304
78027,409,183,0,0,0,0,0,0,226
33510,28176,13649,159,865,296,109,1010,456,14527
78414,39642,19076,238,1623,209,332,1888,464,20566
50585,1324,703,0,39,15,2,53,5,621
92203,30744,15223,227,1221,327,168,1003,424,15521
92266,108,80,0,0,0,0,0,0,28
53910,3123,1587,41,98,52,22,52,62,1536
64679,800,357,9,1,7,4,15,3,443
68739,2983,1596,31,83,39,41,73,46,1387
63448,1405,638,21,9,16,23,39,39,767
63533,698,377,0,7,2,0,13,6,321
64461,641,326,5,20,8,6,26,9,315
60134,29401,14287,186,740,280,94,1088,580,15114
55603,529,285,0,9,4,0,10,44,244
32976,9001,4522,0,136,258,0,102,115,4479
49021,6265,3194,87,155,82,33,181,84,3071
55107,15171,7553,112,373,136,127,523,167,7618
52403,22968,11280,71,806,414,73,632,270,11688
30157,49342,23338,315,1765,332,660,1522,546,26004
32822,60781,29253,388,2127,300,293,2848,536,31528
33947,8901,4159,60,93,269,36,37,207,4742
34482,25244,11270,45,970,364,155,1092,412,13974
41062,0,0,0,0,0,0,0,0,0
42050,2885,1606,9,119,24,4,69,32,1279
42134,17543,8700,150,528,197,49,463,210,8843
42451,937,374,0,0,0,73,81,17,563
29003,6510,3085,76,52,71,90,128,162,3425
49639,2305,1178,14,60,17,5,37,31,1127
13477,1437,735,0,49,0,39,83,28,702
15239,20631,10060,62,555,235,69,558,400,10571
16745,555,273,0,13,6,0,17,0,282
17051,4906,2354,3,139,74,6,102,46,2552
17120,0,0,0,0,0,0,0,0,0
24816,148,74,0,0,12,0,0,0,74
24849,172,92,0,0,0,0,0,0,80
17749,337,168,15,12,2,5,0,6,169
968,3554,1460,0,54,51,8,159,79,2094
28340,9657,4654,99,275,195,68,270,117,5003
59729,2220,1121,0,82,44,0,42,27,1099
60012,10958,5366,71,188,81,63,241,229,5592
61330,1437,730,6,23,18,11,38,26,707
61470,537,253,3,17,10,0,8,16,284
35053,2519,1194,20,59,45,5,51,55,1325
35620,9026,4665,53,157,110,68,225,170,4361
41098,1821,900,0,25,13,0,52,50,921
49769,1630,832,17,45,19,3,43,35,798
50542,921,492,0,17,12,0,30,10,429
55722,1056,455,0,31,4,6,84,7,601
53078,1693,900,8,62,24,7,45,35,793
48865,2151,1227,16,66,15,5,45,8,924
44095,33340,16294,287,1125,343,114,1054,565,17046
44707,8802,4248,155,290,105,122,279,153,4554
3243,931,477,0,48,17,0,35,9,454
4464,528,274,0,14,13,0,6,11,254
6716,16652,8413,68,285,209,150,405,359,8239
15401,31482,15280,150,929,477,274,784,472,16202
25637,774,401,0,71,24,0,59,13,373
25646,948,389,0,55,16,0,94,53,559
28208,39700,18568,191,1479,222,263,1431,450,21132
17529,4370,2203,15,121,51,19,104,52,2167
29114,1763,855,39,67,17,6,90,32,908
29525,2242,1059,45,45,52,0,66,37,1183
77037,20463,10743,64,907,143,31,738,238,9720
78015,15119,7418,39,310,263,284,284,182,7701
78570,34608,17367,287,1228,286,208,1028,288,17241
78652,5504,2726,0,434,143,13,219,148,2778
54302,31137,15932,180,783,210,358,945,336,15205
60478,17112,7738,92,331,157,92,565,185,9374
61529,2699,1319,28,67,37,5,54,19,1380
68813,459,247,5,18,0,6,13,18,212
56227,178,87,0,4,8,0,6,13,91
56353,9313,4799,25,303,79,26,341,116,4514
57769,3976,1968,0,87,60,0,121,20,2008
63701,38417,18809,547,1176,445,549,1025,459,19608
63937,2532,1220,23,33,18,10,69,52,1312
64401,1568,861,0,23,18,10,14,26,707
72440,311,162,1,1,10,2,19,9,149
73742,4384,2137,0,89,32,30,113,96,2247
32309,31610,14912,161,753,257,47,1127,504,16698
49967,469,251,8,5,17,0,10,11,218
51046,1796,946,0,29,28,2,35,54,850
53006,1745,919,6,52,30,1,38,48,826
56143,4199,2070,6,118,62,31,76,91,2129
41512,854,492,23,34,7,0,26,5,362
44094,35755,17241,136,937,400,137,631,647,18514
30322,2847,1280,172,0,0,190,0,0,1567
45856,5211,2670,67,71,57,13,122,37,2541
47281,1199,686,0,20,17,14,42,27,513
48626,5875,2896,55,249,61,31,198,97,2979
37308,2888,1405,0,48,47,10,164,69,1483
38316,3000,1460,28,77,22,32,81,18,1540
15848,1273,602,0,22,12,18,47,19,671
18322,2265,1113,0,54,39,0,71,28,1152
6390,183,110,0,12,0,0,0,4,73
7204,13568,6684,131,443,194,0,701,263,6884
27712,21100,9728,48,588,325,0,785,387,11372
21890,2799,2799,47,342,21,0,0,0,0
23091,109,31,0,0,0,0,0,0,78
27288,23689,11088,147,650,259,187,777,317,12601
95615,999,598,0,5,0,20,46,10,401
95981,32,22,0,12,0,0,10,0,10
96769,294,140,0,11,3,0,10,0,154
97365,11289,5394,69,307,160,1,195,136,5895
97405,46270,22190,281,1584,702,325,1337,897,24080
92277,23517,11950,286,755,121,359,529,225,11567
99546,203,106,1,8,0,0,2,3,97
3440,3015,1593,0,140,35,7,119,43,1422
4234,63,12,0,0,0,0,0,0,51
4662,446,207,0,0,0,8,0,0,239
653,11140,5247,60,388,145,82,394,131,5893
62514,181,65,0,0,0,7,0,16,116
64097,1324,660,0,58,22,11,49,21,664
64167,446,260,0,0,16,0,0,19,186
78224,20795,10798,158,683,241,244,625,76,9997
78504,56000,27634,370,1778,344,319,1739,593,28366
80232,22553,11231,250,624,182,254,606,276,11322
80425,179,64,0,0,0,0,0,0,115
80514,5278,2789,0,165,24,4,214,81,2489
70471,21221,10700,118,546,276,24,517,268,10521
72019,25948,12432,53,505,269,184,768,231,13516
84101,4761,2799,73,236,90,3,236,10,1962
85730,38219,18411,469,1086,364,384,1153,709,19808
57062,2334,1834,26,204,40,0,18,32,500
58436,1703,841,14,27,25,3,44,28,862
59055,85,50,0,4,6,0,7,0,35
59261,506,253,5,12,16,0,3,7,253
65613,17757,8762,206,668,165,246,611,156,8995
95237,3531,1954,20,79,22,26,68,55,1577
53804,1378,688,4,58,15,15,32,23,690
54819,2370,1246,11,35,40,16,30,32,1124
37810,1573,840,0,45,16,0,59,19,733
46371,3354,1651,14,155,52,12,125,75,1703
59874,1401,705,0,8,9,0,18,17,696
62060,4586,2150,20,223,53,12,78,81,2436
58201,39928,20528,711,1124,342,439,1057,452,19400
49679,1335,720,0,52,18,3,41,31,615
50228,2930,1368,6,140,26,6,94,17,1562
50628,1202,597,0,49,6,28,50,25,605
1073,6140,3111,21,131,124,0,133,30,3029
1532,14985,7179,81,266,104,79,513,226,7806
14712,3178,1584,38,62,45,17,43,65,1594
15334,135,67,0,4,4,0,3,3,68
17042,38072,18423,261,1021,371,234,938,764,19649
30426,782,410,1,10,5,0,9,7,372
30739,6460,3434,11,251,26,15,138,54,3026
10925,3878,2153,0,107,105,0,134,113,1725
22125,888,384,0,22,2,0,21,11,504
17584,10085,5035,97,233,136,96,214,159,5050
18064,25907,12766,205,858,223,69,836,439,13141
19044,16350,7977,91,749,183,175,553,417,8373
19067,51590,26058,203,1331,722,158,1644,886,25532
19536,567,273,9,24,0,10,17,15,294
41034,932,432,0,68,5,0,82,4,500
12083,3760,1926,34,67,30,0,56,75,1834
41301,6511,3217,75,196,133,14,258,105,3294
46052,22255,10857,286,423,264,78,651,462,11398
50025,3107,1476,19,71,42,10,77,44,1631
80534,16527,8809,35,613,191,47,577,260,7718
13845,138,71,0,0,0,0,0,0,67
14080,4158,2180,37,118,36,27,111,57,1978
76065,35643,17703,124,1228,314,113,1344,436,17940
76177,9361,4804,110,600,48,38,343,35,4557
25161,475,235,26,0,0,0,37,0,240
25208,897,522,0,11,23,0,52,0,375
68849,1020,363,28,0,0,41,0,0,657
21817,4777,2115,27,103,108,30,188,56,2662
89001,1441,711,0,112,32,17,47,35,730
17862,483,264,13,6,0,9,16,0,219
93527,1618,677,60,0,30,0,27,142,941
71203,39100,17904,319,1009,221,618,1278,551,21196
61852,221,118,0,1,2,0,17,2,103
43402,32259,16001,1296,796,322,1715,728,478,16258
62878,443,182,0,29,0,0,22,0,261
64147,581,196,10,0,0,16,23,0,385
68404,926,471,0,45,0,0,34,23,455
71243,194,103,14,0,0,0,0,0,91
66951,752,347,2,10,18,0,35,0,405
85614,23617,10761,12,89,465,49,261,514,12856
72863,1821,890,0,69,15,0,63,21,931
16105,15289,7165,153,415,226,113,434,145,8124
4683,104,42,0,0,5,0,0,0,62
18471,663,340,3,7,0,0,11,8,323
50038,86,50,0,0,0,0,7,0,36
63775,16966,8449,65,551,160,77,505,233,8517
63535,92,36,0,0,0,0,0,0,56
72572,119,80,0,0,0,0,0,0,39
62366,1589,793,0,43,35,0,89,44,796
86520,1689,807,21,28,6,15,39,16,882
96044,931,491,10,21,10,0,17,31,440
15325,471,173,0,9,0,0,0,0,298
97373,223,223,0,22,11,0,0,0,0
81212,30743,17503,113,1229,400,0,694,341,13240
20714,4622,2190,12,173,31,0,233,64,2432
35988,2192,1101,6,84,18,14,83,7,1091
39402,41151,19217,341,1527,399,628,1710,409,21934
4024,563,267,3,24,2,18,35,10,296
5141,141,46,0,0,3,0,0,0,95
5354,2303,1083,17,50,38,0,78,15,1220
32566,38112,18769,111,1073,423,86,1211,540,19343
12167,2737,1327,7,29,36,2,52,35,1410
12751,926,523,0,75,0,9,40,5,403
27581,4832,3024,5,281,27,1,154,34,1808
22830,1769,938,0,77,22,8,52,11,831
11971,6235,3288,65,152,50,20,194,16,2947
29676,5305,2498,16,126,76,0,129,164,2807
29853,6408,3187,0,139,20,2,204,103,3221
21061,54059,25586,349,2172,329,413,2141,718,28473
92870,53582,26514,263,1590,422,436,1519,498,27068
99174,50,25,0,2,0,0,2,0,25
97342,153,68,0,26,2,0,0,0,85
33415,51582,24261,257,1692,444,406,1839,642,27321
36010,4856,2294,33,118,62,52,103,80,2562
23092,690,319,0,0,4,33,0,0,371
32025,22374,13028,458,939,165,122,632,209,9346
29614,2128,889,197,0,0,231,0,0,1239
24368,5420,2752,14,114,47,2,79,172,2668
80007,12026,5816,23,636,90,3,629,130,6210
70820,19507,9929,1223,337,182,1262,240,124,9578
71291,31795,14655,168,829,282,290,1293,453,17140
72135,2459,1285,0,69,52,0,13,77,1174
97137,1380,703,5,79,14,6,53,29,677
97417,2416,1207,24,51,23,2,73,30,1209
98506,17372,7990,41,558,260,42,723,424,9382
92009,45827,22070,145,1635,572,289,1338,819,23757
74540,214,79,0,8,5,0,9,0,135
75645,10158,5180,82,224,153,30,248,170,4978
39762,3015,900,61,0,0,235,19,0,2115
40515,36637,17808,141,1277,429,373,1350,541,18829
41554,817,448,0,0,18,0,27,14,369
56169,656,331,2,32,15,0,35,11,325
56267,6913,3417,293,163,74,84,163,35,3496
48207,21230,9175,79,460,271,117,462,434,12055
48237,29849,13334,119,1077,238,261,1153,465,16515
66871,1298,612,2,62,16,0,27,21,686
68662,1357,633,38,52,43,0,35,11,724
59464,424,218,0,12,13,3,13,6,206
63853,203,105,9,3,0,1,0,14,98
71407,617,239,0,0,17,0,80,12,378
71949,2121,1046,0,75,27,47,69,32,1075
79378,276,117,8,4,0,0,0,15,159
79546,1700,696,9,50,39,6,41,44,1004
2142,3294,1636,41,172,52,64,105,18,1658
97756,37540,18216,166,1196,472,198,1138,674,19324
92268,597,344,0,20,24,0,19,23,253
87730,23,20,0,0,0,0,0,2,3
99729,202,111,0,9,6,0,11,0,91
39573,7913,4471,13,202,67,45,191,210,3442
43761,49,23,0,0,0,0,0,0,26
45123,8736,4231,31,277,150,43,238,115,4505
46619,21775,10577,33,610,163,118,682,238,11198
63781,1373,766,0,68,6,3,10,5,607
63829,1276,598,31,22,15,6,49,29,678
63967,1686,898,15,28,44,17,36,9,788
19090,18492,8773,145,544,163,139,687,241,9719
57638,1817,874,3,63,18,0,48,48,943
73096,13684,6773,370,290,72,327,254,138,6911
74133,46067,21094,207,1397,466,357,1522,504,24973
49893,1477,860,0,29,25,7,24,37,617
50609,511,247,4,9,4,0,13,8,264
52168,244,126,7,6,0,0,7,3,118
53531,4605,2427,57,229,59,6,175,60,2178
44147,19361,9175,157,669,273,71,474,283,10186
46065,3499,1721,9,84,5,11,86,51,1778
49621,3485,1785,0,40,65,13,61,79,1700
53121,18706,9207,188,729,182,73,609,234,9499
34229,7824,3752,0,34,191,19,264,90,4072
35178,3814,1789,34,45,16,0,82,53,2025
37680,461,218,40,25,11,0,26,0,243
38362,1331,722,0,25,13,0,33,7,609
39356,508,268,0,0,0,0,41,0,240
42404,2649,1246,15,116,41,5,59,39,1403
54430,166,76,2,0,2,0,3,2,90
55331,18475,9225,75,461,255,50,434,287,9250
55947,7496,3831,30,220,57,6,262,147,3665
28790,3308,1708,0,26,67,15,116,55,1600
17764,2183,1075,13,57,47,22,43,17,1108
19555,3447,1759,15,70,49,12,108,58,1688
32447,161,157,0,0,0,0,0,0,4
32948,7908,4162,45,408,58,155,261,89,3746
33431,20967,10353,332,794,249,227,532,159,10614
33434,20006,9092,63,255,343,67,415,316,10914
27976,3985,2010,0,121,163,0,124,80,1975
28001,26601,12797,150,647,353,105,928,427,13804
28102,68,30,0,0,10,0,0,0,38
22911,17732,8239,25,421,163,47,640,312,9493
22940,1418,633,0,20,17,16,16,0,785
2110,2449,1008,0,14,18,0,47,0,1441
5253,481,224,0,7,0,0,22,11,257
12092,706,271,0,19,29,0,34,15,435
1590,9385,4760,35,127,172,60,244,90,4625
52531,5982,3012,10,154,45,33,163,51,2970
53038,4242,2132,31,187,42,24,155,38,2110
54724,7324,3622,48,325,98,63,231,95,3702
59057,753,392,0,3,2,0,0,20,361
59446,612,305,0,9,18,0,12,8,307
61563,519,264,0,17,8,0,10,13,255
68667,98,44,0,0,4,0,0,0,54
75402,17516,9341,154,614,143,185,537,183,8175
79027,5013,2462,77,143,80,94,70,67,2551
63474,417,216,0,1,1,0,9,4,201
70782,203,80,0,0,0,0,0,0,123
85331,29905,14378,72,656,492,122,884,338,15527
87031,44451,21963,226,1422,421,276,1605,590,22488
99019,11604,5674,82,254,62,14,421,99,5930
99638,26,15,0,0,0,0,2,0,11
99762,4307,2213,23,194,27,40,121,43,2094
95638,2121,1068,40,29,47,10,34,57,1053
80547,2221,1034,0,53,22,33,50,3,1187
82227,272,179,0,0,2,0,0,0,93
20779,985,381,0,0,19,0,0,38,604
28666,125,25,0,0,0,0,0,0,100
25653,388,224,0,20,9,0,17,0,164
28725,55,45,0,0,0,0,0,0,10
29715,32066,15283,227,1262,328,91,1218,263,16783
18623,2731,1269,7,98,23,34,81,25,1462
29729,2375,1314,18,75,33,56,67,54,1061
36258,1337,696,13,48,35,23,47,0,641
44838,261,125,0,3,2,0,12,3,136
7652,26613,12989,139,845,400,95,683,329,13624
31557,3229,1737,48,117,32,17,126,67,1492
48120,7351,3700,32,253,26,39,213,24,3651
48847,5988,2810,12,189,42,15,280,129,3178
41056,13947,6838,42,241,148,85,467,168,7109
44843,2126,966,2,68,21,0,52,21,1160
45352,242,113,2,11,0,0,8,2,129
45644,4679,2487,16,194,50,0,85,76,2192
38751,10653,4909,59,196,157,66,365,141,5744
38778,1535,660,0,29,10,0,62,60,875
49911,2750,1420,11,59,62,42,44,28,1330
51350,701,426,0,40,1,20,15,3,275
88081,16974,9268,104,583,102,273,390,82,7706
91381,20371,9621,93,449,130,106,573,126,10750
92385,202,109,0,7,0,0,0,0,93
92831,37353,18756,844,1085,165,797,1011,395,18597
97830,734,372,7,6,19,0,0,11,362
85213,36902,17954,112,1108,312,333,1122,407,18948
85925,4938,2594,0,145,18,0,99,61,2344
37920,40920,19748,746,1111,295,529,1213,517,21172
54738,3349,1688,14,115,32,17,75,38,1661
55355,9469,4785,32,302,83,40,294,163,4684
45323,4973,2465,58,119,109,6,160,51,2508
46803,9378,5050,74,393,58,24,348,87,4328
49833,255,139,0,0,0,0,0,0,116
51060,598,282,0,4,3,12,2,3,316
41180,841,456,7,18,13,15,8,12,385
42565,514,254,0,27,0,7,10,17,260
61848,230,110,0,4,0,1,11,4,120
62370,234,135,6,0,3,0,7,0,99
63377,2381,1161,0,53,29,11,51,67,1220
49341,36711,18025,143,1326,409,129,1304,470,18686
32324,4726,2578,29,219,54,16,132,25,2148
33109,475,235,0,0,0,0,0,0,240
21224,50433,24956,212,2425,259,170,2056,510,25477
14511,551,262,0,0,0,15,0,0,289
24986,5282,2366,23,65,42,6,153,66,2916
25106,566,305,10,32,0,0,53,17,261
27529,48833,23433,243,1310,288,115,1547,558,25400
27892,14161,6501,90,404,230,61,400,191,7660
97476,404,233,0,0,0,0,10,25,171
93523,3700,1966,28,196,14,6,210,0,1734
15736,913,422,0,35,16,5,22,5,491
32766,17252,8433,181,582,167,215,473,275,8819
35186,5092,2542,44,114,175,35,168,78,2550
27885,1066,500,0,58,29,0,97,25,566
30470,338,225,13,0,3,0,2,2,113
31535,11865,5681,75,303,39,103,344,195,6184
5761,844,432,0,37,18,0,26,17,412
6026,5256,2384,0,97,96,19,246,30,2872
7046,4288,2102,32,43,18,9,92,64,2186
12435,308,197,0,10,0,0,4,30,111
12847,413,193,3,4,2,0,5,4,220
13111,1616,882,6,11,55,12,27,38,734
1949,9779,5069,91,204,135,68,250,89,4710
3060,29586,14140,138,1223,163,189,1009,383,15446
4650,264,126,0,0,5,9,5,50,138
70040,1062,504,0,35,5,0,92,36,558
47990,1836,864,3,49,11,30,64,5,972
48458,18586,8519,135,446,173,95,655,329,10067
80825,434,209,0,37,1,2,9,1,225
81523,1074,593,0,92,29,0,44,10,481
81623,16461,8888,1,880,239,0,541,169,7573
91010,26601,12631,180,837,299,275,788,427,13970
94510,28262,13931,203,575,486,29,896,477,14331
95537,325,216,0,158,0,0,0,53,109
77093,46875,23464,239,1828,529,354,1347,528,23411
77447,15219,7384,155,394,126,49,462,213,7835
67869,1476,749,0,43,31,0,49,4,727
68301,1418,683,7,44,12,0,64,47,735
68352,4909,2298,43,175,56,1,114,122,2611
40862,460,217,0,0,0,0,28,44,243
46250,19001,9032,165,692,96,110,871,181,9969
47513,2527,1189,8,110,46,0,32,46,1338
65348,1408,660,10,31,20,18,66,13,748
75074,51147,25705,364,1823,361,416,1722,650,25442
81224,3374,1936,26,176,13,5,132,135,1438
81410,1483,657,0,30,16,0,99,56,826
78660,89830,43311,712,3546,503,288,3975,925,46519
78745,62771,31630,191,3457,507,483,2334,729,31141
79323,7432,3822,13,323,9,0,215,44,3610
79749,363,158,0,10,5,0,0,10,205
74135,20849,9704,90,672,239,145,723,357,11145
70725,1719,783,0,84,0,0,40,0,936
71752,845,422,3,1,8,13,15,31,423
25573,930,449,0,0,48,0,0,23,481
14839,782,383,0,31,7,0,27,10,399
15759,2934,1537,13,88,36,19,73,60,1397
20736,9491,4842,71,379,151,38,281,256,4649
10918,12287,5932,170,295,62,104,321,166,6355
28270,35059,17565,217,1342,386,65,1148,578,17494
28513,10321,4898,75,177,125,50,263,134,5423
52530,1132,531,0,25,19,0,23,2,601
53191,2860,1304,9,74,27,14,96,42,1556
7932,9899,4985,84,340,33,57,239,221,4914
11211,102624,51067,555,5231,722,561,4751,963,51557
12482,369,161,0,6,0,0,0,0,208
15633,624,299,0,0,15,0,0,0,325
16442,2978,1486,13,96,33,3,79,71,1492
16929,2515,1309,30,85,24,28,113,54,1206
2558,1146,561,0,77,89,0,0,0,585
75440,6506,3324,36,279,70,10,158,93,3182
76710,24685,11768,336,747,302,239,629,322,12917
67337,12587,6132,151,319,114,89,274,131,6455
67851,2781,1376,17,101,14,24,71,10,1405
43968,6212,3240,52,139,66,38,149,121,2972
64113,11988,5937,27,472,118,10,378,214,6051
71660,884,473,0,35,0,0,25,0,411
38646,2871,1410,0,47,24,15,139,51,1461
15714,4783,2359,49,137,135,5,150,79,2424
6247,2705,1426,16,58,18,9,56,38,1279
23879,674,344,0,0,17,0,0,20,330
19015,16665,7850,38,494,175,87,592,251,8815
21679,257,136,0,0,27,0,0,8,121
690,5352,2369,145,148,70,85,61,139,2983
25247,614,314,0,10,2,9,48,13,300
76373,187,118,0,0,0,0,0,0,69
64661,949,491,0,12,19,8,12,16,458
65550,2887,1440,5,84,18,4,87,26,1447
66095,879,526,0,25,55,0,25,1,353
59802,19437,10468,240,804,266,342,423,243,8969
59826,419,182,0,5,36,0,0,15,237
59859,2997,1444,14,40,125,11,38,71,1553
15737,64,45,0,0,0,0,4,0,19
18016,0,0,0,0,0,0,0,0,0
24924,482,280,0,14,23,0,0,20,202
25907,93,72,0,14,0,0,0,8,21
6266,538,257,35,43,0,3,25,15,281
13115,185,115,0,5,11,10,6,1,70
13417,3317,1457,0,103,0,0,62,21,1860
27880,3242,1717,12,100,62,5,123,48,1525
29464,51379,24486,40,1579,601,253,1971,869,26893
30019,49262,22779,290,1741,353,373,1447,557,26483
14770,2777,1378,11,97,17,0,103,39,1399
2911,15864,7215,65,516,159,123,576,204,8649
3279,852,457,0,11,24,0,28,10,395
35952,7482,3912,25,177,41,34,244,89,3570
36619,15422,7922,97,415,220,52,519,280,7500
25031,644,277,16,56,0,0,35,0,367
41159,538,287,0,6,4,11,41,5,251
41739,117,81,0,0,8,0,0,0,36
42265,802,506,0,12,0,0,18,9,296
42333,1401,734,18,28,14,0,93,131,667
43158,345,170,0,0,0,0,0,7,175
40175,13932,7248,56,631,159,30,482,288,6684
40913,391,207,0,0,0,29,23,0,184
45821,1186,606,11,49,3,6,73,10,580
46381,92,52,0,0,0,0,16,0,40
28715,26318,12913,136,708,313,149,783,589,13405
28779,18141,8873,248,623,270,201,492,230,9268
26377,449,238,0,0,4,3,6,4,211
27282,17835,8462,89,490,150,75,460,296,9373
95664,1589,899,0,138,0,0,133,48,690
96770,597,270,0,26,9,0,8,0,327
97045,55968,27230,314,2210,721,225,1727,585,28738
80435,7561,4448,8,390,26,41,333,109,3113
81024,190,100,0,0,8,0,0,0,90
84634,3388,2770,28,333,15,0,39,24,618
85041,62491,30838,270,1849,499,366,2469,604,31653
85255,41625,20558,163,1031,574,186,815,726,21067
88354,0,0,0,0,0,0,0,0,0
89316,1272,671,0,49,42,0,52,40,601
89825,1582,882,0,35,0,0,0,42,700
91746,30708,14968,270,951,301,214,960,365,15740
63944,1571,821,5,61,16,0,83,25,750
64428,846,419,19,13,11,17,11,1,427
56209,2168,1146,16,90,30,2,84,20,1022
57227,309,176,0,6,8,0,3,2,133
57577,1635,826,11,48,17,15,13,23,809
77974,355,157,0,8,3,0,8,24,198
64854,4094,2127,28,169,3,14,159,88,1967
69168,221,116,0,4,4,0,4,1,105
77068,10991,5732,90,466,68,101,517,144,5259
70466,9339,4448,10,208,83,34,193,185,4891
71292,20463,10018,196,658,184,164,611,250,10445
62691,1978,943,2,88,19,11,30,40,1035
62811,227,127,0,10,3,0,10,2,100
62974,1626,880,52,29,19,0,58,9,746
82933,435,255,0,20,16,0,0,20,180
56742,947,488,8,30,21,7,38,24,459
58035,238,124,1,7,4,0,0,2,114
94577,48088,22726,363,1450,496,462,1494,637,25362
98028,22516,11402,19,1097,338,53,1011,250,11114
98422,21012,10496,119,652,287,73,698,327,10516
98934,1312,692,0,61,13,16,20,14,620
95486,73,56,16,23,17,0,0,0,17
95553,913,589,0,57,0,0,41,0,324
50655,766,388,17,42,16,2,18,8,378
66204,19683,10093,143,735,162,165,738,223,9590
52745,471,268,0,16,0,0,4,16,203
16340,1740,912,16,52,20,11,52,12,828
68503,15558,8132,463,510,78,459,473,97,7426
70775,11176,6229,28,369,103,203,217,94,4947
28372,14022,6781,281,336,68,167,310,143,7241
28539,15623,7904,181,607,174,133,361,91,7719
54479,3981,2116,23,180,40,5,129,46,1865
55089,1843,991,2,31,17,12,24,26,852
45831,3269,1624,23,111,13,15,117,74,1645
47166,1540,794,0,62,26,85,41,0,746
20202,0,0,0,0,0,0,0,0,0
20626,335,129,0,0,0,0,0,0,206
51546,2787,1353,0,93,46,0,83,43,1434
53015,2689,1444,12,97,39,9,73,50,1245
80221,42046,21741,279,1174,236,384,1458,449,20305
82945,349,170,0,9,0,0,23,3,179
85361,5743,2869,46,229,154,0,226,132,2874
61275,4750,2396,0,164,125,28,86,79,2354
61276,110,31,0,7,0,0,39,0,79
62033,4515,2123,29,139,12,14,66,84,2392
17071,118,67,0,2,8,0,0,0,51
17243,1369,720,0,37,16,11,21,31,649
20685,6731,3428,0,87,100,26,185,40,3303
21240,0,0,0,0,0,0,0,0,0
5045,1889,897,2,35,27,3,25,62,992
6254,1842,952,18,33,25,1,32,33,890
12759,2000,982,10,51,16,5,25,76,1018
13360,163,83,0,0,0,0,30,2,80
10570,12893,6304,112,307,116,116,318,193,6589
38746,472,181,9,31,1,0,5,6,291
38917,3260,1773,0,47,64,43,117,21,1487
32083,3563,2947,0,258,72,0,117,10,616
35580,3708,1814,0,46,18,28,49,51,1894
37013,97819,47812,582,4199,794,399,4900,1503,50007
24366,647,334,27,0,0,0,27,22,313
47720,17589,8837,78,320,123,170,389,240,8752
48185,47865,21634,311,1449,476,416,1549,608,26231
96140,1019,525,0,55,24,15,28,27,494
83128,940,483,1,29,1,2,6,3,457
68137,25984,13188,149,992,354,72,830,399,12796
68320,356,170,0,21,3,0,9,8,186
56623,2635,1396,0,84,70,0,37,30,1239
49425,3841,1931,17,163,49,30,135,103,1910
49879,936,452,5,9,17,6,13,17,484
53726,5334,2696,118,41,51,296,95,28,2638
63146,30178,14482,151,909,308,186,846,639,15696
45865,4905,2357,12,113,61,41,85,132,2548
46049,898,451,0,18,4,2,19,20,447
46391,10053,7359,198,1172,104,55,245,85,2694
70644,225,149,0,0,0,0,0,0,76
71268,2433,1168,0,120,32,2,48,30,1265
55026,382,207,3,0,16,0,3,7,175
49011,2246,1038,0,72,15,33,90,19,1208
61554,42059,20686,310,1380,458,148,1288,692,21373
28442,1584,797,0,0,16,43,12,26,787
29733,1852,452,48,0,0,125,0,0,1400
31008,18381,9002,111,565,205,106,580,253,9379
40958,291,137,0,0,20,0,7,0,154
43832,7349,3602,24,311,119,22,292,32,3747
26386,2289,1152,41,112,13,22,90,21,1137
27608,11054,5586,34,516,102,23,584,142,5468
27610,78475,36390,572,2866,390,457,3336,959,42085
28215,62533,29416,320,2099,324,434,2659,705,33117
73946,56,30,0,0,9,0,0,0,26
81640,101,69,0,0,6,0,0,5,32
84329,88,50,0,0,0,0,0,0,38
94571,9784,4788,0,132,316,63,160,219,4996
97380,2904,1339,24,98,46,13,138,59,1565
18610,5062,2483,12,35,111,74,38,34,2579
12758,3908,1960,0,68,42,5,54,38,1948
19109,0,0,0,0,0,0,0,0,0
21636,1147,684,2,0,52,2,17,14,463
25437,320,167,21,0,21,0,0,0,153
26101,30158,14354,101,897,276,212,669,355,15804
15101,25077,12364,104,739,306,114,695,433,12713
5037,533,273,6,27,4,0,11,7,260
1463,12083,5966,67,204,168,50,334,237,6117
75252,26511,13305,187,573,251,94,656,399,13206
84720,21533,10969,557,673,304,553,627,174,10564
79602,24672,11685,212,911,171,257,737,308,12987
94107,29689,15618,138,1652,393,83,1517,158,14071
92139,37040,17684,241,702,328,291,1280,503,19356
29628,2505,1145,0,23,14,24,103,51,1360
32068,57226,29246,347,1939,739,132,2012,708,27980
35973,2856,1519,105,62,56,12,59,59,1337
29659,89,34,0,0,2,0,0,2,55
33837,27428,13562,165,782,332,126,1016,394,13866
81040,298,184,0,0,0,0,0,0,114
72143,35997,17284,598,974,231,327,936,532,18713
16664,2067,1010,7,59,37,18,83,30,1057
32073,41863,20405,456,1038,654,202,1220,807,21458
77663,1431,845,0,94,0,0,0,66,586
66012,11561,5613,33,324,140,44,399,116,5948
66849,444,232,3,19,4,0,22,20,212
88210,18420,9163,100,477,156,68,635,227,9257
13157,552,259,0,6,0,0,0,16,293
97846,1784,870,10,89,51,0,47,47,914
48858,50488,24157,2039,1271,296,1700,1116,592,26331
24830,141,58,0,6,0,0,0,2,83
25989,338,190,0,56,0,0,36,0,148
42220,7131,3471,54,209,48,33,275,60,3660
2451,18699,9072,106,758,272,106,563,254,9627
44143,24241,11496,163,475,171,171,687,363,12745
44231,8777,4543,106,202,91,46,196,146,4234
45887,4298,1948,4,108,38,33,191,26,2350
46228,15586,7244,132,439,147,114,614,164,8342
32189,5611,2885,70,99,60,0,51,57,2726
33027,60191,27390,140,1952,426,329,2078,840,32801
33484,26146,11887,34,592,350,0,344,474,14259
58561,1070,564,14,38,16,0,24,12,506
60137,38279,18432,313,1242,400,103,1264,492,19847
60646,27987,13222,78,739,313,116,905,337,14765
60654,19135,9754,0,962,87,102,873,44,9381
61802,19349,9288,85,514,212,280,463,284,10061
68371,1513,822,1,36,44,0,49,30,691
68718,1616,839,0,30,34,1,55,27,777
71909,15787,7675,13,203,365,42,186,192,8112
78850,1305,695,0,9,0,0,10,10,610
79052,1210,621,37,47,7,19,38,11,589
79538,238,121,0,16,8,0,10,6,117
79930,28178,14255,404,1055,151,508,753,345,13923
66544,398,204,0,10,8,0,2,4,194
68107,31282,15975,272,1306,216,166,1255,353,15307
56468,4483,2331,82,112,88,4,117,101,2152
57429,82,37,0,0,0,4,0,0,45
57430,2455,1204,16,62,15,29,79,55,1251
58015,255,142,6,7,0,0,10,1,113
74073,5459,2741,17,191,27,37,158,114,2718
82730,1531,824,0,28,15,7,29,67,707
98550,10959,5557,53,311,191,0,288,225,5402
96791,7715,3817,68,310,52,31,336,69,3898
6451,25086,11387,143,759,420,135,1043,347,13699
1074,548,236,0,39,0,0,0,0,312
55808,6039,3104,19,203,118,22,212,84,2935
42411,1783,844,8,39,70,7,25,31,939
46982,2413,1113,12,63,21,39,29,30,1300
47449,315,153,0,6,2,0,3,5,162
20896,929,465,8,34,19,0,43,12,464
21209,28015,12945,77,1037,289,247,908,355,15070
48815,2504,1255,5,28,29,24,76,63,1249
57529,384,226,1,6,5,0,10,2,158
58012,2746,1316,3,89,60,22,92,55,1430
49627,173,90,0,5,0,0,13,0,83
50606,751,391,7,17,13,2,16,9,360
50635,1684,900,6,59,17,10,48,12,784
70031,1366,662,16,44,0,8,50,8,704
70037,16104,8204,110,491,179,145,402,219,7900
70075,5823,2766,94,172,37,107,235,37,3057
71417,5646,2761,0,205,73,82,229,201,2885
33541,19900,9634,96,407,435,134,378,216,10266
36742,1606,876,8,142,65,32,0,104,730
44730,5847,2855,7,120,113,20,195,82,2992
46814,12438,6177,17,457,158,37,451,124,6261
34772,30746,14416,122,1287,231,131,951,364,16330
26764,4052,1949,28,129,42,19,197,81,2103
27878,2050,994,12,23,14,0,22,16,1056
25103,227,126,0,0,12,0,0,0,101
50005,1073,585,0,23,13,1,16,6,488
54137,1083,551,3,25,11,10,37,10,532
72715,15919,7531,68,478,376,81,407,196,8388
73730,753,349,7,37,5,6,41,10,404
74855,4720,2397,0,193,42,4,98,51,2323
70585,287,139,0,18,0,7,11,4,148
71007,773,335,0,0,0,0,0,20,438
3057,2533,1262,4,37,36,24,28,19,1271
7833,149,95,0,0,5,0,14,18,54
15906,11159,5378,13,204,148,30,310,121,5781
16925,3495,1861,23,110,37,19,92,25,1634
84654,2653,1470,26,141,43,4,53,36,1183
88033,0,0,0,0,0,0,0,0,0
81335,24,13,0,0,13,0,0,0,11
6373,325,81,0,0,0,0,0,0,244
71662,202,76,0,0,0,0,0,0,126
71730,30995,15281,293,1049,451,272,903,587,15714
62031,749,404,11,18,6,0,11,31,345
63443,320,193,0,39,2,0,3,0,127
78536,275,161,8,19,0,0,22,3,114
79925,39711,19111,525,953,286,615,1016,359,20600
59832,729,393,0,10,20,0,7,12,336
72179,370,211,0,0,35,0,25,12,159
84024,71,30,0,0,0,0,12,0,41
86001,46041,23869,1482,1410,299,1339,1218,509,22172
82070,20336,10583,527,587,258,286,546,214,9753
83424,397,292,0,0,0,0,0,0,105
65350,2271,1153,2,110,9,2,62,21,1118
65466,1824,920,2,48,19,34,28,19,904
65564,160,83,0,0,0,0,0,0,77
96703,2087,995,18,70,10,31,51,29,1092
97102,313,166,0,0,0,0,0,0,147
3561,5931,2800,22,136,113,0,279,27,3131
4680,1182,588,0,31,31,21,24,16,594
6704,25576,11951,89,687,169,221,971,236,13625
786,348,177,0,0,37,0,0,0,171
30678,1242,722,29,11,28,0,3,11,520
32222,9772,4654,67,431,134,36,396,64,5118
32738,45881,22811,429,1522,363,253,1411,515,23070
32809,28258,14739,170,1337,317,166,761,396,13519
23828,287,154,5,8,1,2,0,22,133
20186,15049,7030,48,456,115,31,594,206,8019
20617,787,388,0,14,0,10,15,9,399
21401,37081,18418,165,1281,515,97,1249,695,18663
17865,140,92,0,19,0,2,5,0,48
1969,6298,2946,38,203,0,0,270,86,3352
14134,115,57,6,0,0,0,0,0,58
4848,734,358,3,10,18,0,8,0,376
95511,290,128,0,12,0,0,0,0,162
97030,37386,18177,223,1596,286,346,1428,452,19209
98562,0,0,0,0,0,0,0,0,0
96016,375,166,0,0,0,0,0,0,209
96032,2510,1362,0,49,24,13,101,39,1148
74840,2003,1022,20,34,23,5,52,20,981
67030,2861,1308,38,52,5,48,69,36,1553
68816,205,128,0,8,0,0,8,0,77
62987,1424,757,36,36,27,24,18,7,667
86016,41,20,0,0,3,0,0,0,21
61488,1040,501,0,22,13,19,23,17,539
70364,31221,14925,194,1173,240,328,1046,547,16296
49546,34517,16829,422,1240,322,416,865,232,17688
50421,3066,1475,9,82,25,0,93,39,1591
27104,27892,12907,110,794,351,65,867,428,14985
81303,8367,4180,39,240,86,81,245,202,4187
24060,55747,29232,2223,1178,258,1813,1042,319,26515
32970,204,16,0,0,0,0,0,0,188
4090,10235,5011,12,185,167,5,179,195,5224
24957,255,144,18,0,0,0,24,0,111
7035,10552,5052,58,330,114,75,314,205,5500
7438,11527,5717,87,230,183,43,375,186,5810
19001,17273,8157,88,534,244,119,650,207,9116
15054,405,190,0,16,0,0,40,0,215
29902,15826,7898,78,334,199,49,379,190,7928
12427,392,205,0,9,13,0,0,0,187
26361,250,106,0,17,0,0,18,0,144
55389,2549,1269,9,71,31,11,69,28,1280
55931,340,172,3,1,1,0,9,2,168
36910,21,21,0,0,0,0,0,0,0
37339,2532,1354,5,34,11,5,123,14,1178
16443,1253,598,20,29,21,5,41,34,655
17345,7829,4007,0,267,58,33,213,110,3822
26283,1580,856,0,57,6,0,31,0,724
2121,29919,13592,198,710,160,99,1167,395,16327
2791,331,165,0,0,41,0,0,0,166
99705,22944,12385,171,811,169,120,814,205,10559
74964,2709,1322,19,100,64,24,68,58,1387
76832,687,377,0,7,5,0,11,21,310
77004,36959,18732,958,1223,242,811,1031,318,18227
77517,5429,2722,117,244,29,44,137,104,2707
84050,11272,5757,85,410,67,146,433,148,5515
85203,39069,19688,144,1456,304,199,1095,272,19381
68434,8508,4312,146,264,92,60,258,137,4196
78759,42524,21737,67,1710,538,25,1837,555,20787
71001,4436,2146,51,107,39,26,91,105,2290
73624,2335,1199,8,95,6,33,81,21,1136
3281,9011,4327,108,182,105,104,249,129,4684
3780,536,237,0,29,0,6,15,2,299
4401,44572,21515,334,1275,500,344,1053,486,23057
6825,21999,10357,182,533,177,93,547,288,11642
8014,548,312,0,0,11,0,0,0,236
8348,188,74,0,8,7,0,0,8,114
674,39859,18862,373,997,612,285,1206,704,20997
52310,6359,3119,54,213,94,11,231,97,3240
36553,3246,1702,0,138,30,10,7,31,1544
30121,23373,11415,195,512,204,79,683,245,11958
43130,61259,30971,506,1948,843,382,1850,797,30288
43338,10164,5043,35,405,94,24,269,155,5121
98593,1418,702,24,57,16,38,86,39,716
54458,76,37,0,4,0,0,10,1,39
54933,353,213,6,6,2,0,4,1,140
56041,1101,573,5,37,23,4,32,9,528
61949,145,68,0,9,4,0,0,0,77
45112,84,34,0,2,2,0,1,2,50
49619,1015,539,0,11,8,8,25,13,476
49629,2036,886,0,40,74,0,42,61,1150
49665,4078,2069,43,146,48,30,90,50,2009
43321,256,124,0,0,2,0,9,5,132
33928,24682,12056,92,555,435,67,505,610,12626
35594,7208,3702,91,145,73,47,186,75,3506
36053,1790,910,0,18,4,25,61,10,880
40946,236,95,0,0,0,0,31,0,141
87421,1584,784,13,55,8,16,85,24,800
46120,5090,2535,23,172,82,78,120,34,2555
46224,37464,18591,177,1300,250,400,1317,239,18873
46710,4225,2004,16,116,23,28,142,23,2221
47446,10569,5390,65,366,76,21,312,158,5179
41146,421,199,36,24,0,0,37,0,222
42040,806,433,0,7,12,6,12,51,373
3810,1720,829,0,27,120,1,0,36,891
4354,1462,759,15,32,29,0,32,37,703
4414,1273,690,0,48,27,0,30,23,583
678,26091,12511,185,882,244,213,995,315,13580
2535,1463,637,1,19,20,18,31,49,826
23920,3096,1465,2,121,27,0,82,8,1631
26142,2387,1350,17,141,41,0,101,58,1037
30316,33172,16359,284,1836,433,117,1283,264,16813
16323,15530,7285,87,371,171,60,423,308,8245
6906,9131,4460,58,410,57,39,337,165,4671
92102,44500,22992,338,1667,331,307,1570,439,21508
93261,2715,1504,26,109,36,23,100,43,1211
93528,138,72,0,25,0,0,0,0,66
94305,15730,8605,644,128,115,623,79,43,7125
95123,67186,32907,392,2723,521,252,2684,767,34279
96815,25268,12835,52,1158,398,113,1105,349,12433
86404,16525,8340,33,384,339,0,249,288,8185
86442,33551,16596,299,670,583,185,443,477,16955
88025,255,151,0,0,0,15,0,23,104
62354,1592,853,19,95,27,0,64,22,739
62961,51,20,0,0,0,0,0,3,31
78201,46775,22854,433,1317,346,433,1405,539,23921
78665,48362,24389,323,2307,224,364,2538,393,23973
79741,202,127,0,2,6,0,8,5,75
67882,350,227,0,0,0,0,5,2,123
72679,31,15,0,0,0,0,0,0,16
72744,5917,2855,97,110,42,47,215,72,3062
73568,1060,538,8,27,16,0,47,17,522
76306,15201,7303,95,466,113,56,502,170,7898
76936,3061,1542,3,155,37,29,60,29,1519
58801,30367,16729,160,1256,210,226,648,313,13638
60004,50915,24193,205,1689,621,47,1707,919,26722
64670,1098,604,21,65,11,18,27,7,494
66093,727,376,0,13,12,3,11,10,351
55964,4406,2133,0,163,31,25,130,35,2273
50470,231,116,0,17,9,8,11,19,115
50654,440,229,0,2,25,21,13,2,211
43779,855,456,0,17,26,0,11,12,399
44017,18903,9210,291,521,172,346,570,288,9693
52035,1006,528,0,44,18,0,26,14,478
52151,1709,881,0,50,26,3,31,30,828
60538,28451,13971,236,1086,114,224,1153,282,14480
61336,569,317,12,23,26,0,11,7,252
63557,235,109,15,8,0,0,6,0,126
71351,10891,5372,90,405,183,49,206,222,5519
71940,1794,1010,0,74,31,0,37,36,784
72029,1908,877,24,40,10,0,52,60,1031
72132,3650,1809,12,106,29,25,205,22,1841
72946,3702,2012,49,115,10,0,114,41,1690
75202,2059,1130,12,108,0,0,53,27,929
75641,133,50,0,8,0,0,4,6,83
66112,13229,6217,89,438,145,65,553,135,7012
67526,3101,1602,0,74,48,10,69,87,1499
67846,33735,17318,197,1369,327,198,1031,358,16417
68069,2834,1424,11,117,30,21,122,27,1410
15486,2299,1028,35,49,19,4,55,38,1271
15618,2308,1088,15,95,33,14,71,13,1220
15738,204,96,0,7,7,0,5,3,108
15775,782,430,0,46,0,0,26,5,352
26726,13174,6551,241,395,261,87,327,167,6623
31634,5622,2881,68,183,27,32,69,109,2741
32266,7080,3477,6,136,50,62,302,50,3603
35131,4332,2204,40,73,56,5,36,37,2128
37714,4827,2567,11,309,76,26,114,31,2260
44441,1757,797,0,37,19,0,25,14,960
45052,3667,1806,4,56,48,2,78,87,1861
45623,3075,1307,10,59,23,15,72,12,1768
45779,753,397,20,7,20,0,42,6,356
53806,1655,784,0,40,38,5,28,26,871
54449,25893,12713,174,772,320,80,715,341,13180
48614,1510,776,10,42,12,6,39,17,734
50842,94,49,3,0,0,0,1,0,45
43511,1075,591,32,24,14,0,65,7,484
30573,219,149,0,0,1,0,0,0,70
23230,6505,3001,20,254,28,40,218,264,3504
23702,11057,5294,65,317,45,67,291,108,5763
3032,5385,2690,29,186,62,0,172,93,2695
4424,785,346,0,18,29,0,4,17,439
5673,2525,1286,9,105,59,0,86,46,1239
11238,54540,25481,159,2625,513,179,2786,505,29059
24382,13420,6383,113,327,199,0,317,162,7037
24589,3135,1718,0,93,8,15,75,38,1417
24726,562,268,0,23,0,0,26,17,294
25113,754,340,22,0,17,0,3,9,414
28630,20007,10378,18,632,244,64,485,271,9629
11727,29823,14303,92,588,305,161,919,308,15520
75163,2851,1371,0,29,18,10,68,13,1480
75550,790,413,0,23,9,5,20,20,377
76862,189,123,0,12,4,0,0,3,66
80105,1123,577,7,25,16,10,25,22,546
85324,3172,1642,0,55,119,1,25,75,1530
85627,1243,637,13,45,23,6,23,22,606
65276,1541,754,44,30,19,15,54,13,787
13621,469,231,7,10,3,0,0,12,238
7826,5771,2910,33,201,104,27,147,89,2861
24066,5074,2502,0,80,103,0,109,75,2572
74652,798,402,4,36,6,6,30,10,396
74902,4102,1972,18,93,34,35,125,34,2130
82721,3077,1543,23,97,41,11,59,25,1534
83617,15522,7683,77,293,159,65,246,186,7839
83626,1494,748,11,30,8,36,42,8,746
97009,8470,4406,25,252,96,33,229,85,4064
85251,41575,21037,227,1724,413,176,1234,403,20538
87047,4402,2315,0,163,55,0,134,185,2087
89424,275,164,0,20,0,0,0,4,111
98817,111,54,0,0,0,0,0,0,57
99781,141,67,1,0,2,2,3,2,74
93230,66800,33951,527,2010,573,380,2037,970,32849
93673,740,344,0,36,7,0,23,12,396
91325,34635,17188,490,987,297,468,1196,355,17447
92328,354,205,2,30,0,2,15,10,149
78561,688,345,14,16,9,14,22,0,343
79106,27015,13297,128,909,272,149,727,331,13718
48166,11416,5737,66,375,196,143,296,132,5679
48532,20126,9218,102,549,264,159,242,332,10908
49089,1770,900,5,24,31,15,49,45,870
49203,38659,18362,217,1104,448,212,1036,655,20297
49287,2127,1108,8,69,25,0,94,8,1019
10538,16545,8456,0,550,215,25,618,192,8089
13061,1073,612,0,31,29,0,23,0,461
1027,17848,8507,28,566,270,48,759,431,9341
42409,2722,1437,11,172,14,0,103,38,1285
65661,2755,1287,11,72,51,9,127,65,1468
65804,37766,18265,410,1175,364,365,1038,561,19501
67428,1718,867,6,89,14,9,76,14,851
59344,420,199,0,21,11,0,20,11,221
60443,21554,9874,111,571,226,139,928,400,11680
99670,41,26,3,0,0,0,1,2,15
96037,335,139,0,0,21,19,0,6,196
68954,14,0,0,0,0,0,0,0,14
72021,3803,1717,27,55,47,8,14,24,2086
77482,1886,992,3,60,24,0,0,20,894
79734,2142,1060,0,92,27,0,60,31,1082
81416,14273,7771,145,553,325,27,441,282,6502
74534,159,69,0,5,1,0,5,4,90
84066,12191,6209,64,442,111,107,499,104,5982
73448,6295,3113,60,124,59,55,149,67,3182
47405,3821,1924,84,0,0,105,7,0,1897
42371,397,193,0,5,0,0,22,12,204
43548,587,263,6,1,12,0,13,8,324
36859,18,8,0,0,0,0,0,0,10
38731,225,94,0,10,0,0,10,0,131
58630,744,362,7,35,17,0,28,11,382
59072,4396,2171,25,90,57,0,89,52,2225
62305,19357,9562,62,533,268,30,608,208,9795
62378,955,411,0,31,24,0,22,20,544
63361,4193,2105,11,116,98,11,188,56,2088
63951,144,93,0,0,0,0,0,0,51
97838,26057,13259,143,853,190,115,1049,431,12798
99020,0,0,0,0,0,0,0,0,0
99683,447,260,0,30,5,0,5,9,187
95225,470,198,0,28,27,0,0,0,272
95556,627,352,0,18,0,0,1,31,275
5084,266,139,0,14,0,0,0,11,127
29911,1690,880,15,81,17,21,53,54,810
48139,105,33,0,0,0,0,0,0,72
48642,32096,15756,114,1188,427,114,1069,406,16340
49028,6435,3237,45,194,89,21,178,107,3198
24613,605,290,0,90,0,0,0,20,315
25142,319,163,0,27,0,0,0,0,156
25696,185,73,0,0,0,0,0,11,112
26206,3116,1509,11,88,19,80,95,51,1607
38568,2144,1169,31,25,19,0,74,24,975
32455,4514,2311,64,90,123,50,102,87,2203
30464,83,37,0,3,0,0,10,0,46
34695,18096,8524,14,400,263,73,551,345,9572
35052,275,138,0,0,10,0,10,0,137
36451,4330,2130,18,148,69,8,145,39,2200
22741,147,60,0,0,0,0,26,14,87
23418,1100,454,0,23,0,23,28,62,646
25555,1788,965,21,87,47,0,48,20,823
42049,1605,873,0,47,54,9,45,5,732
43557,3324,1898,40,230,36,40,92,25,1426
33413,17473,8493,158,527,139,100,718,152,8980
78578,11677,5407,36,312,125,61,299,79,6270
49762,660,329,1,17,28,4,9,22,331
50230,1050,511,6,25,1,11,21,22,539
93311,45763,22869,486,1960,291,220,1854,530,22894
59732,321,155,0,8,6,0,11,24,166
44276,1795,951,30,50,33,14,56,10,844
95663,2602,1128,0,37,64,7,76,48,1474
47467,117,90,0,0,0,0,0,0,27
67156,14693,7650,152,387,151,111,326,201,7043
8740,1733,793,11,96,19,17,43,4,940
54552,4160,2080,16,65,57,40,115,99,2080
54865,446,232,0,2,11,4,4,6,214
62665,1359,639,0,81,18,0,24,21,720
61854,1197,585,0,14,23,10,37,24,612
50626,1721,835,16,75,21,6,37,17,886
74536,1557,820,10,35,20,3,42,21,737
56276,216,120,0,4,6,0,2,4,96
57257,655,338,0,17,12,2,20,6,317
20695,7924,3596,39,181,90,19,64,84,4328
99102,539,272,2,9,12,15,14,8,267
32583,28585,16936,267,1566,367,147,760,372,11649
30290,8677,4229,35,246,43,0,213,280,4448
30537,1534,767,0,34,9,0,13,33,767
4673,225,114,0,0,0,0,0,0,111
97504,47645,23264,252,1337,561,258,1568,677,24381
98513,34793,17415,136,1142,383,58,1458,509,17378
14741,1809,925,19,34,15,7,61,29,884
15924,1077,530,0,40,5,0,40,9,547
59848,148,88,0,0,4,0,0,0,60
12724,256,135,0,0,0,0,0,0,121
78963,1247,634,0,40,13,0,51,18,613
13493,1792,927,15,54,23,11,74,40,865
93725,26980,13285,150,629,121,230,664,183,13695
8312,8261,4122,60,186,69,49,209,122,4139
68072,69,35,0,0,0,0,5,2,34
60016,59637,28865,161,1985,701,175,1804,1019,30772
83804,1826,863,0,41,37,0,60,40,963
84747,1287,763,21,62,9,8,47,12,524
50258,975,470,0,38,13,0,25,27,505
85334,939,569,97,15,17,0,14,0,370
52032,1614,877,9,102,30,11,44,15,737
97845,2857,1452,29,68,30,15,91,102,1405
52537,7265,3609,29,290,88,14,224,118,3656
95222,5090,2405,0,129,77,0,0,110,2685
56533,315,174,0,4,0,0,3,6,141
77074,41386,21360,486,1841,141,271,1676,454,20026
79705,41242,20486,293,1285,322,418,1359,521,20756
54204,1611,765,7,25,25,9,30,19,846
55317,21739,10693,94,856,162,78,737,323,11046
65061,774,395,6,20,5,0,17,13,379
66040,3124,1558,11,66,86,41,67,26,1566
54981,15254,7710,18,410,251,52,463,254,7544
60545,13259,6773,29,647,62,102,407,102,6486
13617,11034,5407,364,169,124,452,230,97,5627
83624,1257,663,0,25,24,7,18,0,594
98605,1099,537,21,83,3,3,21,24,562
4660,1084,521,0,9,26,0,11,19,563
91711,36854,17688,508,1114,314,399,1011,419,19166
77612,9513,5007,97,195,82,17,220,76,4506
31779,9998,5706,113,469,150,94,237,184,4292
29709,7081,3423,6,187,114,0,386,107,3658
37732,167,115,0,0,0,0,0,0,52
29922,803,432,45,17,27,0,61,5,371
39451,6296,4719,62,529,38,30,133,13,1577
46181,4788,2511,4,134,132,50,128,101,2277
45894,635,299,0,22,1,0,14,27,336
48756,4551,2312,54,90,99,32,90,69,2239
40071,15541,7836,22,511,118,46,486,149,7705
87825,2057,1047,13,73,85,6,75,46,1010
51501,35356,17411,108,1361,334,273,1169,409,17945
1128,2672,1326,0,108,7,0,85,59,1346
38680,6292,3089,51,245,15,52,209,28,3203
55055,3506,1735,23,162,46,0,123,23,1771
56676,1564,805,8,41,26,3,22,36,759
57004,3722,1925,28,66,44,7,109,46,1797
57380,3905,1930,12,94,32,56,120,32,1975
34238,19364,9156,51,195,352,49,516,433,10208
52049,1470,748,18,31,16,41,42,27,722
53956,3318,1652,25,87,49,3,62,45,1666
38562,6661,3172,38,209,141,24,171,169,3489
31050,861,562,20,0,0,42,0,10,299
32065,37160,17886,336,1174,306,210,1696,351,19274
37755,3697,1687,33,115,75,36,140,5,2010
44133,30225,14685,138,882,433,111,669,419,15540
39564,39909,19041,127,1025,349,304,1511,475,20868
46580,21701,10753,238,753,216,94,771,189,10948
47381,193,80,5,3,2,0,5,3,113
57013,5046,2498,24,112,30,0,160,84,2548
61075,992,500,0,10,40,2,7,20,492
67546,2340,1141,9,56,29,0,35,58,1199
67732,489,238,9,5,8,3,14,10,251
4936,186,112,0,7,0,0,5,7,74
74632,599,324,1,16,32,4,13,39,275
5483,1512,758,6,36,14,0,66,22,754
19435,143,67,0,8,0,9,0,0,76
89138,16498,8046,41,778,88,56,716,94,8452
5462,1864,966,0,85,28,6,40,23,898
7064,4139,1952,0,105,26,0,139,21,2187
7201,27790,14588,254,1320,151,161,921,293,13202
97907,462,230,0,15,2,0,5,7,232
10040,44571,20779,413,1610,355,239,1669,426,23792
77030,10963,5497,107,539,12,16,633,97,5466
32431,3975,1994,19,92,40,4,53,41,1981
52240,34689,16751,958,966,271,1325,909,459,17938
70543,4517,2096,33,201,48,0,160,122,2421
71430,2549,1192,4,84,55,0,55,4,1357
67530,18925,9440,146,412,128,87,519,339,9485
71740,1391,775,3,65,40,10,18,0,616
10017,15801,7134,0,707,209,20,802,256,8667
63630,3966,1903,0,212,92,20,114,83,2063
11960,696,315,0,21,13,0,16,6,381
59720,123,66,0,0,10,0,0,11,57
6340,30764,16656,592,889,281,209,971,345,14108
16319,1343,679,24,10,43,0,21,25,664
71028,1205,502,0,21,13,2,18,5,703
16948,1591,837,13,42,28,28,53,10,754
43845,4607,2098,0,152,18,17,187,47,2509
28023,15623,8111,54,578,205,95,647,205,7512
73944,531,295,5,19,7,4,15,15,236
32751,22073,10663,181,552,179,237,492,329,11410
75978,143,64,0,0,0,0,0,0,79
33704,16503,7914,24,502,212,86,543,321,8589
44067,20470,10428,87,490,260,102,439,254,10042
48834,2060,999,8,52,37,5,49,7,1061
55304,48981,24536,251,1476,457,251,1447,581,24445
55422,29243,13903,26,1043,276,38,1386,405,15340
29079,10,0,0,0,0,0,0,0,10
29446,915,502,0,8,11,0,11,41,413
30093,55107,28779,342,2426,227,390,2633,420,26328
30417,10777,5316,19,310,139,11,390,65,5461
30627,2393,1261,15,126,18,19,72,25,1132
19061,19868,8908,72,518,331,257,475,349,10960
13650,1687,886,0,51,41,0,28,23,801
14219,12092,5916,107,312,95,42,318,209,6176
14872,645,382,0,34,8,0,17,0,263
16406,3128,1589,9,65,66,21,46,53,1539
33762,8093,4760,56,345,129,44,248,52,3333
23887,387,199,0,0,11,0,0,11,188
24246,366,199,0,0,0,0,0,41,167
24962,77,34,0,0,0,16,0,0,43
4343,16,16,0,0,0,0,0,0,0
8345,566,291,4,27,5,0,25,22,275
8802,4035,1937,4,85,33,0,77,71,2098
5907,142,68,2,2,7,0,2,6,74
7834,17852,8614,19,440,312,60,595,569,9238
93604,629,266,4,0,26,0,0,68,363
55328,9400,4794,31,400,57,6,347,62,4606
45238,45614,21977,242,1567,379,453,1824,740,23637
45242,22625,10860,176,633,274,82,890,386,11765
13697,1896,986,0,50,34,0,52,16,910
14063,14676,7148,336,218,176,294,341,168,7528
30218,1628,851,24,68,15,0,4,19,777
31814,234,74,0,0,0,0,0,0,160
21227,33822,16490,55,1231,288,248,1307,298,17332
29048,4825,2672,0,20,129,0,220,127,2153
33960,719,362,0,7,22,0,10,0,357
28213,40724,19503,877,1537,215,394,1712,325,21221
3242,4950,2401,96,141,108,68,113,94,2549
8562,4460,2425,39,135,6,13,124,59,2035
2601,15215,7210,64,287,257,119,421,166,8005
45743,1864,899,0,57,22,8,49,52,965
46214,24202,11167,194,704,142,98,870,352,13035
35761,12568,6217,17,413,104,102,407,111,6351
35951,12911,6292,87,322,70,105,524,149,6619
35959,4843,2406,72,101,54,43,105,150,2437
90265,18389,9103,78,296,419,159,388,311,9286
92555,43957,21133,262,1626,296,469,1759,351,22824
54645,61,32,0,0,0,0,5,4,29
64761,1324,636,9,42,20,9,29,22,688
65024,1167,583,8,55,1,13,17,5,584
74842,128,60,0,0,7,0,0,0,68
75087,33638,16291,120,1095,217,253,1077,411,17347
57534,302,162,20,18,0,0,17,0,140
70776,6104,3699,56,318,66,30,142,77,2405
71465,3142,1559,7,87,35,60,47,60,1583
84511,4439,2257,82,110,55,0,138,79,2182
97758,99,49,0,9,0,0,3,0,50
98359,5002,2680,18,207,57,0,175,75,2322
99217,17616,8551,130,487,185,91,408,334,9065
80807,5112,2854,63,308,48,26,197,38,2258
83101,3123,1655,0,141,63,14,91,29,1468
30336,234,121,0,19,0,0,46,0,113
30821,765,355,8,7,17,0,2,1,410
37037,8046,3781,0,304,38,0,475,92,4265
37727,2390,1136,12,17,31,9,61,58,1254
39425,2318,1110,10,114,15,0,97,60,1208
40508,26372,12752,801,615,308,1138,594,232,13620
45879,5805,2755,53,75,91,48,72,73,3050
32935,41550,20224,288,1297,492,157,1427,663,21326
95321,3337,1494,17,38,41,0,122,8,1843
98589,7585,3606,22,200,129,10,224,96,3979
85922,37,12,0,0,1,0,0,1,25
85939,4248,2171,17,146,41,0,233,104,2077
81076,705,305,5,11,4,16,36,4,400
37745,17434,8232,206,497,232,218,495,326,9202
38241,998,495,11,53,33,6,25,5,503
40202,7176,4193,123,456,103,108,262,141,2983
54861,128,56,0,4,0,0,4,3,72
55311,37703,18023,55,1259,324,191,1444,725,19680
43727,1163,566,0,31,11,16,41,58,597
44695,1578,774,7,19,40,0,41,34,804
44817,1506,738,26,14,13,22,51,22,768
50226,6289,3502,0,362,71,16,388,123,2787
42061,26,12,0,0,0,0,0,0,14
60031,37172,18049,325,1099,334,308,1109,508,19123
63560,172,126,0,0,0,0,0,2,46
48141,24615,12204,177,640,144,279,620,276,12411
48377,16549,7934,56,631,59,32,663,185,8615
32168,27186,13453,97,690,313,39,711,458,13733
33138,29867,15149,165,1175,462,223,987,432,14718
21561,2606,1341,0,58,27,29,90,81,1265
22553,14945,7271,99,343,78,18,444,193,7674
15065,11558,5493,36,370,120,138,287,218,6065
17347,6697,3413,20,248,87,70,226,28,3284
13090,29758,14858,262,971,415,66,917,416,14900
13757,1318,652,24,18,7,0,57,0,666
25024,352,156,0,0,0,0,0,12,196
25160,112,66,0,0,20,0,0,0,46
18327,524,297,0,9,3,0,11,3,227
19473,16428,8134,110,532,129,32,615,230,8294
27605,5490,2653,23,275,73,97,122,107,2837
27866,1028,564,35,0,0,0,36,11,464
28684,2370,1187,8,86,16,0,41,18,1183
29665,140,64,0,36,0,0,32,0,76
95978,163,95,0,0,0,0,29,0,68
98052,67779,34484,281,3604,598,74,3008,594,33295
17959,1354,667,8,30,21,7,50,32,687
24556,3104,1361,10,123,48,10,94,32,1743
27053,2973,1553,9,87,106,42,73,33,1420
28021,13991,7004,46,463,197,84,440,163,6987
28164,15099,7390,51,551,182,31,441,151,7709
28338,4663,2130,0,143,76,31,78,73,2533
30284,96,43,0,6,0,0,7,0,53
30328,37111,17487,137,1540,308,108,1548,543,19624
30452,1372,657,5,37,18,8,13,22,715
11360,19621,9073,36,667,219,124,693,308,10548
2762,9088,4396,0,412,62,18,137,152,4692
2915,16646,8165,34,500,193,119,709,355,8481
3833,22096,10617,73,551,249,57,423,339,11479
72662,2843,1305,0,18,64,40,67,30,1538
72739,645,273,0,8,13,0,12,6,372
48464,2172,1080,4,104,39,5,62,50,1092
48634,4546,2098,36,47,39,20,118,88,2448
48745,1249,630,10,14,22,3,32,14,619
50864,2026,966,13,78,25,13,95,50,1060
78879,137,33,0,0,6,0,0,0,104
79789,783,387,0,19,3,0,14,5,396
79836,5796,2708,152,122,42,37,130,44,3088
80525,54286,27329,609,1989,627,492,1618,814,26957
80610,3232,1657,18,109,8,12,114,25,1575
89835,1732,942,10,38,4,1,27,24,790
90293,12694,6171,31,434,196,40,571,186,6523
95431,196,122,0,6,0,0,2,5,74
96756,6206,3085,12,199,130,45,240,117,3121
68061,2403,1176,0,30,30,45,59,37,1227
84745,4312,2165,0,289,74,13,225,57,2147
38856,1671,850,0,65,4,0,52,31,821
66018,6156,3096,30,236,89,0,113,50,3060
67491,386,174,0,17,2,0,9,7,212
68925,528,272,0,13,5,4,27,5,256
78108,37359,18186,94,1447,275,143,1661,236,19173
85501,13020,6748,4,273,176,0,250,234,6272
61625,370,202,16,0,0,15,0,0,168
62358,884,474,5,6,4,6,5,8,410
57451,2117,1109,14,65,31,16,50,38,1008
57650,30,15,0,0,0,0,0,0,15
79257,939,494,0,53,0,4,11,17,445
63447,1234,678,0,22,24,0,39,4,556
73053,757,392,4,34,10,0,27,14,365
23651,476,231,7,9,6,0,0,5,245
14215,39962,17677,532,976,377,389,1282,488,22285
15329,1387,743,27,48,31,20,35,9,644
15909,5184,2459,30,181,77,15,114,61,2725
17048,3987,1975,19,107,43,3,117,53,2012
32612,7606,3249,157,0,0,195,0,0,4357
32801,12174,6126,0,903,101,57,320,70,6048
22853,4010,1980,16,131,84,5,145,67,2030
8242,3241,1404,22,107,12,20,60,77,1837
11042,522,232,0,0,22,0,0,0,290
27849,1742,877,33,53,40,0,75,0,865
28269,76811,37072,318,2759,576,384,3474,833,39739
18603,19168,9579,111,569,300,215,600,252,9589
29047,3263,1467,33,46,80,13,50,129,1796
29369,13567,6266,11,391,169,34,503,288,7301
36748,2707,1317,43,104,37,0,53,41,1390
37074,8667,4787,29,346,167,92,170,86,3880
37874,15203,7251,182,434,209,103,426,154,7952
8344,4818,2075,4,210,99,27,163,92,2743
11542,27773,13822,182,979,199,316,731,367,13951
17880,133,74,0,19,0,0,3,3,59
18218,2162,1059,5,82,34,0,67,54,1103
2188,15287,7497,52,535,200,15,417,303,7790
77373,59093,28170,389,2438,408,284,2263,864,30923
66549,1639,814,11,25,42,11,44,4,825
67545,137,71,0,5,0,0,6,0,66
74361,16590,8261,132,468,109,89,371,208,8329
75157,240,119,0,9,0,3,2,3,121
42413,3175,1639,2,125,90,2,53,92,1536
62865,1977,1010,0,46,16,0,81,27,967
26684,182,79,10,12,0,0,10,0,103
28581,285,127,0,15,7,0,0,0,158
54550,659,313,3,4,11,7,15,18,346
55704,997,557,4,41,11,0,54,14,440
45648,12886,7205,64,447,234,88,410,176,5681
46402,6436,2782,16,114,50,27,218,53,3654
19104,54311,26268,1858,855,238,2313,1386,334,28043
49412,11333,5472,31,372,73,85,288,156,5861
53170,2305,1216,18,71,23,6,78,18,1089
80121,19414,9739,65,448,151,85,453,323,9675
80915,21325,10783,138,950,187,212,768,207,10542
84335,12885,6087,93,406,49,77,449,75,6798
85613,5480,3491,78,313,3,13,193,0,1989
85707,665,567,69,0,0,12,0,0,98
95914,815,387,0,0,75,0,24,0,428
88203,30746,15019,411,791,270,283,838,368,15727
21647,217,89,0,7,10,0,0,0,128
13156,1896,1026,23,70,18,6,79,25,870
18015,33559,16908,748,1016,381,817,724,350,16651
1378,773,386,0,19,13,8,5,21,387
37847,2535,1290,0,97,72,0,125,29,1245
32643,11207,6014,131,460,245,89,465,192,5193
32940,39396,18356,339,677,409,138,1023,628,21040
33012,75666,35512,345,2281,804,438,2321,1104,40154
33024,75306,36611,472,2781,832,490,2831,832,38695
33128,7585,3786,55,370,149,33,293,29,3799
45741,662,315,9,10,7,0,0,24,347
26629,380,181,0,0,0,0,0,0,199
26711,2696,1373,0,38,81,0,131,27,1323
27855,6454,3129,45,160,40,162,151,175,3325
27959,2908,1277,29,114,23,56,97,45,1631
28088,2746,1052,0,38,17,0,50,60,1694
28385,2562,1090,0,21,26,28,56,10,1472
25270,921,474,0,11,25,13,15,18,447
25650,302,143,0,0,0,0,0,13,159
43217,2440,1179,29,41,4,5,36,41,1261
28448,887,384,0,0,16,0,44,0,503
30025,9308,4646,43,221,114,52,303,201,4662
97828,3112,1522,0,69,38,0,43,59,1590
80293,0,0,0,0,0,0,0,0,0
83822,1837,892,0,57,39,0,60,28,945
84404,62937,32125,682,2740,563,581,2178,527,30812
84765,6689,3330,104,256,80,30,284,107,3359
84781,245,165,0,0,0,0,0,11,80
85541,21812,10436,84,545,553,16,308,410,11376
75420,981,553,0,6,6,0,10,36,428
77005,28552,14133,269,824,332,295,925,548,14419
78164,3287,1623,0,71,70,0,95,59,1664
78616,8285,4486,34,164,91,50,284,137,3799
67017,2408,1168,11,93,12,0,21,45,1240
68945,306,135,0,21,14,0,3,0,171
68977,269,95,0,7,0,0,23,1,174
59910,617,308,0,0,27,0,0,26,309
49839,364,184,0,2,11,0,0,37,180
51106,26707,13055,226,1036,261,229,968,307,13652
53177,8250,4994,55,477,88,24,127,73,3256
53511,49191,24010,411,1490,501,332,1244,794,25181
54217,7368,3757,36,229,111,26,266,78,3611
45249,13156,6682,70,493,226,0,629,219,6474
55436,13181,6121,39,325,172,0,421,213,7060
48062,9597,4724,49,395,85,38,308,134,4873
30011,15428,7556,77,429,34,79,479,135,7872
41519,1107,580,10,33,22,0,38,0,527
44116,20338,9212,49,539,267,94,460,293,11126
44509,11911,5868,4,276,181,26,446,177,6043
36752,1162,561,15,13,21,0,27,0,601
38571,13905,7183,108,433,153,44,316,187,6722
23417,3075,1349,4,56,48,0,82,56,1726
23876,277,139,0,0,0,0,0,12,138
24095,4600,2389,21,108,76,0,146,95,2211
27332,31629,15653,213,940,311,210,973,332,15976
32059,2465,1178,11,95,66,0,68,2,1287
32904,31206,15321,227,992,477,97,930,496,15885
33141,40005,20375,116,1727,329,256,1637,387,19630
33764,26282,13228,90,845,364,36,489,475,13054
72364,15784,7761,135,568,127,42,672,249,8023
73129,19764,10205,197,766,137,95,515,191,9559
73549,212,101,0,2,0,0,4,0,111
82336,160,100,0,0,0,0,0,0,60
93633,0,0,0,0,0,0,0,0,0
94020,1334,727,0,36,51,0,12,11,607
95119,10472,5155,46,289,68,27,378,124,5317
95404,40474,20288,316,1288,590,70,1630,576,20186
95426,1404,844,0,106,35,0,58,0,560
95452,970,455,0,0,18,0,0,32,515
95525,1433,834,7,63,6,0,28,29,599
95735,10,6,0,0,0,0,0,0,4
96796,1952,884,33,12,54,0,53,32,1068
15661,600,337,34,41,12,0,33,0,263
17049,3404,1695,21,131,34,15,93,44,1709
6095,28948,13499,260,631,365,159,639,482,15449
12309,30397,14976,128,923,455,144,1055,432,15421
19087,32934,15860,305,932,367,305,1052,385,17074
20660,26,0,0,0,0,0,0,0,26
24381,3694,1759,0,53,99,0,43,68,1935
22727,5594,2654,31,162,98,34,147,95,2940
23106,1044,551,11,13,13,0,8,0,493
23821,1914,899,8,10,20,0,113,11,1015
3773,7658,3772,91,207,105,29,256,183,3886
773,18547,8705,135,587,226,139,670,255,9842
936,812,312,0,0,7,0,37,19,500
78008,220,88,0,0,0,0,0,23,132
81154,1112,515,0,8,6,25,36,15,597
82715,0,0,0,0,0,0,0,0,0
95570,2274,1106,5,108,51,11,115,42,1168
98021,30753,15518,177,1344,288,197,1328,512,15235
91307,26595,12786,111,773,265,105,777,508,13809
92132,0,0,0,0,0,0,0,0,0
98848,12541,6484,78,438,118,26,365,155,6057
30251,2316,1191,4,154,36,0,155,33,1125
32095,10006,5134,1,240,179,48,450,174,4872
44693,41,19,0,0,0,0,0,0,22
47327,4626,2299,44,37,58,7,97,77,2327
47390,4966,2338,12,180,36,23,116,107,2628
42741,385,193,0,10,23,5,22,5,192
43551,38839,18877,92,1207,551,139,1278,426,19962
4351,2547,1161,9,59,35,34,74,88,1386
1503,3144,1637,38,95,68,15,83,77,1507
23690,3806,1964,107,99,28,55,183,21,1842
17084,4423,2185,0,76,69,0,165,109,2238
32174,50869,24344,243,1017,924,114,1335,841,26525
32193,718,292,0,11,0,0,10,13,426
16143,2678,1393,55,35,28,62,87,43,1285
10162,1584,679,0,159,0,0,31,0,905
95726,8170,3818,49,131,62,22,181,204,4352
97450,296,125,0,0,0,0,0,0,171
99403,20487,9831,105,589,231,135,473,254,10656
87063,240,124,0,12,6,0,16,1,116
21540,109,66,0,0,2,2,4,1,43
37373,3029,1555,31,106,118,0,92,24,1474
67330,1485,772,9,28,18,4,51,17,713
70605,36307,17656,84,1545,318,219,1176,426,18651
71933,892,486,0,0,22,0,0,0,406
72394,495,231,3,17,11,0,6,4,264
72680,936,488,19,19,11,0,27,12,448
72923,4857,2427,0,174,29,0,84,40,2430
73857,681,411,0,31,12,4,53,12,270
76856,3650,1897,0,248,61,41,83,34,1753
76908,2534,1915,236,0,0,15,0,0,619
77476,187,103,0,10,0,0,9,0,84
84757,1111,568,15,1,0,0,6,0,543
85724,0,0,0,0,0,0,0,0,0
60187,29708,14787,394,793,261,268,751,423,14921
66834,836,400,0,18,15,1,25,6,436
55029,84,33,0,0,0,0,0,0,51
55441,18594,9461,71,719,170,32,559,314,9133
56131,2281,1126,9,68,41,0,51,27,1155
56270,1085,570,11,35,9,8,31,3,515
49038,9411,4680,60,282,123,11,276,128,4731
49952,115,67,0,0,2,0,0,0,48
41216,1283,744,34,0,10,0,28,13,539
41777,904,406,0,31,14,38,44,6,498
33873,13762,7058,67,472,70,65,399,108,6704
33946,2325,1173,0,8,104,36,25,76,1152
35755,686,354,0,0,15,0,0,1,332
42722,466,250,0,0,22,0,10,22,216
43812,18640,9152,67,557,227,112,668,378,9488
45429,25740,12213,118,664,401,124,817,522,13527
46327,11631,5954,117,475,105,65,397,53,5677
47529,1057,511,6,43,13,8,37,12,546
61543,152,69,0,3,9,0,5,4,83
61728,1311,594,5,18,11,0,57,16,717
62887,459,260,0,2,0,0,2,2,199
72554,2409,1147,0,58,55,51,74,24,1262
73739,316,165,0,3,0,0,5,4,151
79109,44352,21117,201,1576,423,127,1404,549,23235
80449,778,442,0,36,0,0,21,8,336
81077,719,334,14,9,11,6,20,10,385
75452,4312,2002,56,197,36,33,194,55,2310
75765,7292,3504,46,109,183,89,105,199,3788
64756,684,364,0,20,0,4,16,4,320
65609,817,429,0,15,33,18,16,4,388
66104,26404,12657,91,776,219,177,793,362,13747
68135,29020,14206,156,1138,168,114,1216,269,14814
17077,93,18,0,0,0,0,0,0,75
18035,68,37,0,0,0,0,0,9,31
18618,3757,1816,8,102,33,9,105,61,1941
19146,38873,18649,154,1478,366,408,1313,364,20224
14740,1079,541,0,29,31,7,9,36,538
30173,5799,2610,0,238,44,21,260,155,3189
30473,2445,1280,0,89,21,6,43,27,1165
33407,30928,15409,319,1211,105,188,1040,355,15519
33908,36071,16677,114,342,858,233,697,717,19394
34420,18107,8711,119,459,277,145,310,150,9396
35072,4901,2547,0,84,18,13,89,110,2354
36031,175,78,0,0,0,0,12,0,97
36582,24628,11739,78,605,179,63,648,324,12889
38372,17492,8676,119,415,157,4,486,236,8816
45042,26638,13187,190,604,429,93,610,465,13451
55432,30323,15294,139,995,327,193,1033,375,15029
48393,16760,8078,27,578,96,22,545,204,8682
48851,2146,1104,41,56,46,1,86,79,1042
49022,31170,14957,73,809,226,114,745,462,16213
52728,1055,539,0,34,11,16,28,24,516
13850,22186,11075,587,445,281,199,494,282,11111
15112,2863,1273,30,40,27,0,76,41,1590
15201,12237,6097,79,522,150,54,551,226,6140
15937,697,290,0,16,0,0,28,12,407
20860,2805,1356,0,74,34,44,83,9,1449
21133,32489,14203,164,795,418,198,1228,389,18286
21821,924,419,0,22,32,0,7,19,505
4668,1640,780,19,32,11,8,38,27,860
7627,4959,2419,0,70,59,21,146,19,2540
11218,74508,37538,310,3248,647,339,2987,772,36970
24872,506,267,0,25,0,0,37,9,239
12776,2214,1177,0,35,20,0,40,5,1037
75228,73606,36044,629,2482,427,608,2352,787,37562
77484,11059,5792,114,195,109,108,352,156,5267
82835,253,117,0,15,0,2,13,2,136
66032,4968,2450,36,115,55,25,153,122,2518
16673,5587,2761,31,191,74,44,171,44,2826
4543,2028,936,0,53,25,25,44,40,1092
5146,680,332,0,14,7,0,24,13,348
3220,7453,3557,24,154,1,14,146,24,3896
4412,9123,4655,97,174,102,53,313,240,4468
4455,788,394,4,23,31,0,29,10,394
23045,129,72,0,0,0,0,0,0,57
23666,51930,24505,423,1760,395,476,1998,598,27425
29150,39616,18248,433,1022,245,281,1048,494,21368
12406,922,493,36,15,3,0,10,27,429
12460,373,148,0,0,0,11,64,0,225
27568,596,280,8,28,0,12,16,24,316
46158,22925,11255,166,547,208,86,422,357,11670
48089,31538,15066,106,862,377,343,891,356,16472
49078,9236,4337,94,259,78,95,291,139,4899
49094,4088,1981,29,114,30,22,139,49,2107
55119,42792,21534,291,1573,413,217,1459,382,21258
55606,208,114,0,0,0,0,0,9,94
56375,916,483,10,27,3,3,49,14,433
34769,25018,12210,151,825,205,213,595,425,12808
35143,3183,1632,21,75,38,8,145,45,1551
35808,1445,949,27,13,0,21,45,6,496
38963,4713,3813,98,415,33,17,28,65,900
48118,12823,6356,30,431,169,31,407,210,6467
46508,158,81,0,0,0,0,8,0,77
49683,2114,1145,11,63,40,14,46,30,969
35754,5259,2582,33,373,91,45,154,43,2677
3278,2948,1392,29,61,42,8,46,18,1556
5363,1644,823,6,33,16,0,49,63,821
1040,40376,19780,376,1133,344,189,1294,410,20596
1534,6311,2960,0,101,89,0,176,107,3351
1778,13970,6915,77,440,173,47,384,222,7055
96063,292,184,0,18,2,0,0,0,108
96759,360,204,0,0,0,0,0,0,156
83535,1222,690,3,39,27,7,20,29,532
85260,38934,18571,89,1020,451,144,1299,540,20363
85281,65283,36112,2375,1661,285,2483,1060,297,29171
75901,31134,15375,80,1036,363,205,914,321,15759
95305,37,20,0,0,0,0,0,17,17
78374,17885,8957,10,537,168,103,736,100,8928
91733,44968,23028,443,1420,412,309,1333,556,21940
14809,2279,1185,0,80,36,7,55,29,1094
8322,10859,5558,52,354,121,71,308,145,5301
12494,628,330,0,0,0,0,0,0,298
16743,3889,1956,37,88,45,28,79,59,1933
17214,934,473,28,54,0,0,58,27,461
99743,1041,512,3,18,21,26,31,17,529
43771,1895,1041,3,68,34,3,106,4,854
33924,200,91,0,13,13,0,37,0,109
34705,2649,1327,7,94,26,8,66,71,1322
24715,439,240,3,10,14,17,7,11,199
24818,849,452,0,56,32,0,12,0,397
43035,27011,12906,54,1202,155,166,1268,166,14105
43951,64,42,0,0,0,0,0,0,22
28453,3737,1776,0,146,90,5,24,46,1961
29102,17170,8175,119,376,317,140,510,400,8995
29912,0,0,0,0,0,0,0,0,0
27968,125,77,0,0,10,0,0,12,48
33441,27050,13102,238,820,336,118,853,455,13948
33594,35465,17575,142,1270,253,106,1355,651,17890
98933,1128,563,11,21,6,13,15,14,565
77088,57003,27697,389,2234,495,498,1836,678,29306
95128,37665,19374,178,1367,377,237,1660,582,18291
78256,11464,5767,221,404,154,479,437,94,5697
78543,9118,4032,0,93,88,74,258,0,5086
78729,29315,15125,128,1446,274,154,1104,430,14190
99736,154,87,1,0,2,2,0,2,67
62970,819,427,0,36,7,5,40,8,392
63113,11371,5557,162,205,172,42,343,216,5814
63134,13525,6477,95,435,48,39,575,218,7048
65541,231,138,0,0,5,0,4,0,93
56543,225,118,0,6,0,3,8,0,107
57420,68,44,0,1,1,0,1,2,24
58480,331,154,0,10,6,0,20,15,177
68781,1687,953,11,88,14,0,50,21,734
54634,4425,2242,36,111,101,20,91,87,2183
55308,10045,5130,24,398,83,61,335,22,4915
32725,48008,22782,323,1366,705,229,1853,943,25226
48757,3681,1812,34,99,32,44,78,54,1869
49256,3921,1996,2,137,48,13,107,39,1925
17547,7381,3698,48,360,109,66,363,96,3683
5660,1716,869,0,29,21,3,46,50,847
5901,14,9,0,0,0,0,0,0,5
6110,12658,6010,78,495,90,48,376,312,6648
12432,431,216,0,17,0,0,9,0,215
22723,109,30,0,0,9,0,10,0,79
23076,831,409,1,17,22,7,19,0,422
23103,5197,2468,26,95,108,13,44,162,2729
13450,42,28,0,0,0,0,0,0,14
1930,30049,14563,160,836,568,48,718,470,15486
2152,18535,8498,28,603,154,77,672,334,10037
2790,15694,7935,144,395,292,45,327,190,7759
76623,190,79,0,14,3,0,6,3,111
17536,2725,1417,28,59,22,5,39,44,1308
17980,3096,1593,0,81,35,10,107,31,1503
25239,2226,1088,19,66,25,41,100,29,1138
6239,11406,5152,77,301,66,54,393,272,6254
7830,6888,3122,27,195,50,68,190,167,3766
8205,27630,13114,184,583,326,250,660,464,14516
10528,13128,6316,46,348,123,126,448,255,6812
12196,3371,1700,50,111,72,0,109,79,1671
13123,511,182,0,0,0,0,0,20,329
14476,2274,1114,10,56,26,17,44,48,1160
15290,0,0,0,0,0,0,0,0,0
3102,32564,16162,260,1160,227,325,881,400,16402
4330,25687,12832,141,556,438,157,618,310,12855
67039,3255,1688,23,127,10,22,97,72,1567
67205,19444,9464,53,532,167,89,713,147,9980
67855,1695,870,0,65,20,0,72,6,825
75928,1212,748,20,18,0,0,0,86,464
77066,36703,18910,460,1190,292,142,1287,373,17793
71263,8095,3932,26,248,119,77,241,121,4163
71277,1530,824,0,115,47,0,19,19,706
71901,30003,14240,119,671,268,73,1198,376,15763
81328,4700,2321,24,133,65,70,105,127,2379
72111,1514,704,25,16,12,12,59,35,810
92365,2792,1565,0,52,44,0,36,7,1227
84035,394,205,0,0,34,0,21,0,189
87540,963,478,0,28,11,0,10,0,485
98240,3132,1571,0,116,12,35,89,103,1561
98527,299,170,0,0,6,0,13,7,129
50611,333,147,2,3,12,3,3,5,186
68342,569,301,3,27,5,0,13,13,268
68715,1639,847,6,27,19,0,32,15,792
68846,232,133,0,1,7,0,3,0,99
70747,163,51,0,0,0,0,0,0,112
65274,1836,863,13,57,23,0,39,25,973
44236,25518,12268,49,670,339,10,656,589,13250
71286,456,226,0,0,0,7,8,5,230
45229,13090,6006,89,264,53,143,260,174,7084
52757,211,107,0,5,4,0,7,4,104
64439,1852,858,7,71,7,24,113,17,994
53702,147,53,0,0,0,0,0,0,94
59231,489,253,0,65,0,0,47,9,236
99640,151,75,9,4,2,8,5,1,76
92324,59409,28236,373,2059,364,604,1908,554,31173
12463,1594,793,0,14,30,56,46,178,801
12958,2362,1176,0,22,18,0,105,48,1186
95120,37774,18706,113,1057,431,32,1195,291,19068
98042,47927,24084,308,1700,418,216,1567,675,23843
98619,493,233,0,13,12,2,11,11,260
90005,39479,19602,172,1598,360,143,1383,445,19877
95605,14960,7763,187,473,57,135,476,219,7197
96742,75,38,0,4,0,0,2,0,37
3076,13596,6564,31,265,192,67,295,218,7032
4066,687,327,0,0,10,0,11,8,360
2673,8484,3995,0,235,68,30,213,163,4489
33010,47231,22780,250,1490,452,239,1171,726,24451
13615,1162,571,0,32,0,27,45,27,591
14141,7497,3620,16,271,84,25,180,164,3877
14167,1621,912,20,60,24,4,13,25,709
14623,25917,13245,584,580,67,582,667,311,12672
15640,618,303,0,25,0,0,21,0,315
15922,227,109,0,8,7,0,8,0,118
15931,8819,4396,33,212,84,24,161,238,4423
26222,489,219,0,0,16,0,0,0,270
21223,23560,11511,155,798,231,105,656,351,12049
22650,621,277,0,12,10,0,0,8,344
8801,8990,5645,239,120,55,0,250,150,3345
13864,1011,533,0,114,0,0,20,0,478
5067,191,100,0,3,0,0,7,3,91
95130,14863,7328,96,537,96,76,615,180,7535
95355,59028,29196,506,2015,851,131,1986,1025,29832
89148,52967,26419,164,2526,256,106,2500,524,26548
96753,27649,13546,120,1003,299,67,1030,532,14103
97035,26014,12620,15,763,276,116,821,550,13394
92867,44628,21540,530,1325,329,593,1501,428,23088
99923,15,0,0,0,0,0,0,0,15
73442,413,203,10,21,5,0,12,9,210
66850,246,126,0,3,9,0,0,18,120
68883,2535,1309,29,132,14,29,47,28,1226
63763,145,77,0,11,0,0,0,0,68
64771,460,260,0,4,0,0,9,9,200
77566,29602,14621,247,948,390,35,958,478,14981
60921,1517,757,3,19,30,11,30,20,760
61254,11004,5261,39,257,152,0,323,103,5743
61528,3127,1647,0,114,46,0,129,16,1480
80457,372,152,0,30,0,0,46,0,220
35147,6094,2989,23,271,59,9,150,91,3105
49509,27786,13805,142,809,190,264,898,332,13981
27864,4911,2331,90,164,10,0,121,87,2580
42202,2295,1092,0,46,30,0,68,28,1203
42354,281,163,4,3,4,6,13,4,118
19808,40419,19719,263,1299,479,229,1221,551,20700
21795,9236,4190,67,254,109,6,118,150,5046
76310,18362,9150,88,688,257,92,693,198,9212
76565,104,70,0,0,0,0,0,0,34
60162,8165,3855,194,337,95,68,327,142,4310
61525,9188,4553,45,365,32,8,522,136,4635
62292,885,416,7,41,3,11,43,7,469
63068,4695,2290,6,126,74,4,116,76,2405
68828,297,172,0,12,1,0,19,0,125
70535,18448,8765,220,457,189,140,454,179,9683
65065,6915,3551,41,38,87,0,237,124,3364
65066,6232,3148,22,185,52,88,205,133,3084
85027,36539,18473,232,1524,278,288,1032,316,18066
86017,868,440,24,0,26,14,0,0,428
88041,1117,639,0,0,21,0,24,0,478
74367,407,198,1,13,9,0,4,26,209
74467,15147,7375,107,522,224,93,501,215,7772
83346,2032,1103,35,35,17,0,72,29,929
16433,5053,2541,33,70,33,56,129,71,2512
17365,2427,1317,9,20,59,8,40,37,1110
30258,3047,1488,17,126,17,12,38,66,1559
30642,11949,5746,8,309,182,10,343,185,6203
31790,1788,900,26,91,29,7,93,2,888
23337,482,209,0,59,13,0,12,34,273
23707,15253,7045,78,341,128,58,614,233,8208
5439,1484,701,80,0,0,106,3,0,783
6027,1405,676,4,22,18,0,20,15,729
6518,19488,8786,320,244,143,375,373,216,10702
7470,54190,25829,300,1533,672,321,1493,672,28361
20861,1665,872,0,31,39,16,21,32,793
23432,1473,714,7,44,31,7,38,25,759
76234,16187,7910,131,498,214,63,423,168,8277
76882,233,138,0,14,8,0,0,3,95
77406,46841,24325,88,2045,577,167,1846,473,22516
81044,228,111,0,7,2,0,25,0,117
82643,358,166,0,7,0,0,4,6,192
96046,165,86,0,0,0,0,0,0,79
88232,2408,1473,27,103,25,0,28,52,935
98336,786,400,10,21,10,0,14,28,386
93265,3271,1690,77,197,32,0,84,48,1581
93433,13538,6682,73,510,171,90,628,71,6856
78748,50997,25505,210,2399,565,117,2924,689,25492
78959,1894,1052,0,64,55,7,18,12,842
79065,20873,11024,80,1033,209,143,513,128,9849
79731,4792,2484,35,174,14,28,127,40,2308
11233,76819,35096,720,2249,635,445,2953,1092,41723
25259,684,373,0,22,9,0,40,22,311
25853,13,13,0,0,0,0,0,0,0
29322,8281,4277,13,212,140,8,197,160,4004
29527,25916,12367,124,741,350,132,881,441,13549
67669,1875,984,22,76,28,0,39,42,891
58645,282,160,0,17,6,0,5,7,122
58792,335,159,0,23,0,0,16,30,176
60048,29058,14196,104,548,256,218,828,406,14862
61012,2432,1319,20,134,8,3,78,56,1113
61060,1425,804,0,68,8,7,58,6,621
61722,478,230,6,19,2,7,19,8,248
61928,665,397,0,17,64,2,6,3,268
98346,10106,5208,120,168,128,99,251,125,4898
99206,37989,19204,297,1272,342,203,1124,548,18785
68521,34950,17377,593,1241,290,501,986,302,17573
68749,62,32,0,0,2,0,0,0,30
76681,675,378,15,15,5,0,12,15,297
77461,11352,5901,42,392,172,57,416,77,5451
79034,585,331,0,18,4,0,17,8,254
93219,10167,5452,140,255,56,96,419,108,4715
94703,21937,11170,215,937,184,146,983,275,10767
95148,48854,23814,287,1608,587,460,1533,680,25040
80515,1069,614,0,10,0,13,34,34,455
82442,710,364,0,23,15,4,10,3,346
83436,488,269,0,17,19,3,23,5,219
74446,462,226,13,2,6,5,2,8,236
72865,1562,846,2,68,22,2,2,29,716
45786,3617,1767,39,34,47,14,103,47,1850
40178,686,343,0,10,7,0,35,0,343
41274,603,315,20,24,35,9,0,0,288
42320,8969,4358,10,363,106,29,235,101,4611
43082,33636,16774,134,835,370,105,1236,634,16862
39114,9626,4274,2,325,70,0,241,61,5352
60062,40459,19008,154,1032,536,65,1066,596,21451
56585,1090,578,2,23,20,7,35,24,512
56659,88,41,2,1,1,0,2,4,47
56722,341,167,6,3,6,0,12,10,174
54169,2807,1412,0,111,53,7,75,59,1395
3217,2142,948,46,46,30,7,56,29,1194
4257,2617,1337,0,53,49,7,64,73,1280
16035,92,41,0,3,0,10,3,0,51
24162,2086,953,0,0,0,0,79,16,1133
22980,31846,15423,110,713,564,119,1165,439,16423
26410,1057,530,23,9,18,17,28,11,527
17949,322,178,0,5,6,7,5,5,144
76308,19092,8526,231,432,156,649,558,286,10566
79331,12561,7029,112,550,100,49,270,105,5532
52352,1538,811,7,61,25,0,40,14,727
53206,22766,10605,158,476,276,160,730,248,12161
54460,2612,1320,16,96,30,4,58,63,1292
61914,1833,858,8,63,29,0,36,46,975
65058,843,422,0,36,11,23,18,0,421
65067,370,181,0,18,14,0,0,22,189
66049,30809,15146,493,1204,191,249,1158,363,15663
68376,1509,721,0,65,11,0,25,39,788
70611,20699,10302,107,805,384,198,596,348,10397
70631,432,226,0,15,8,0,0,25,206
63555,3165,1524,0,74,26,21,74,41,1641
64476,290,118,14,10,0,0,9,8,172
73013,52254,24641,395,1475,434,256,1808,579,27613
74350,748,374,3,27,12,8,14,12,374
31409,701,603,104,0,0,63,0,0,98
32131,4560,2515,16,176,61,35,85,54,2045
32927,26687,13933,76,913,287,64,835,544,12754
46951,1922,982,15,76,47,22,59,27,940
49807,3481,1736,39,123,49,0,56,48,1745
50265,32135,15945,169,1086,275,121,1080,456,16190
51020,627,318,2,15,19,0,6,29,309
53543,1746,859,12,30,23,3,44,20,887
54401,30679,15084,338,854,444,113,748,415,15595
55955,2606,1240,14,60,19,36,61,61,1366
56309,1292,648,3,35,18,0,36,13,644
56757,870,426,0,33,8,0,30,3,444
42321,197,82,0,10,0,0,5,0,115
38614,18370,8575,167,405,166,193,588,198,9795
40019,4149,1966,21,243,19,16,100,50,2183
32509,702,702,0,140,0,0,0,0,0
33325,28987,14365,374,864,218,299,1104,408,14622
36346,1491,683,0,26,17,2,34,30,808
45776,786,378,0,32,14,0,41,0,408
47387,793,321,2,46,1,5,24,2,472
48309,30125,14614,195,768,436,292,804,566,15511
36613,13475,6835,112,222,57,117,376,307,6640
6437,22285,10977,65,548,411,56,560,462,11308
29684,3915,1830,18,96,30,102,178,52,2085
12051,6421,4500,193,485,104,0,142,68,1921
22153,31348,15410,72,994,316,133,1131,561,15938
23833,2301,1148,0,54,0,27,67,15,1153
24847,286,173,0,15,0,0,0,0,113
20141,7064,3582,32,191,46,32,314,111,3482
20839,100,60,0,17,0,0,0,0,40
21776,5607,2837,31,195,68,0,175,114,2770
25181,1192,648,0,49,4,0,38,46,544
92065,36309,18349,293,1160,509,205,1057,603,17960
99329,153,82,0,2,5,0,14,3,71
99585,299,142,3,9,7,0,8,2,157
99919,689,368,0,2,36,0,0,14,321
3882,1537,706,42,12,30,4,26,46,831
60521,18402,9150,54,403,229,104,433,354,9252
61490,1134,631,10,39,13,3,51,9,503
62812,10905,5329,14,515,132,32,252,96,5576
64431,336,164,6,8,3,8,14,0,172
79606,25290,12376,198,725,161,141,798,305,12914
80478,1330,842,0,45,69,0,29,47,488
71961,927,484,0,27,8,5,33,19,443
82054,1495,715,0,17,17,0,99,0,780
83628,4318,2327,57,173,48,25,97,30,1991
86301,22919,11116,296,193,445,128,460,459,11803
65744,80,41,0,3,0,0,5,0,39
76454,1553,774,7,25,18,12,48,28,779
76554,2139,1155,6,83,13,8,62,12,984
52339,4213,2078,37,94,47,23,149,24,2135
56017,1639,798,8,32,35,3,49,18,841
37027,55130,27328,297,1459,576,180,1849,696,27802
44003,4228,2142,15,136,103,0,152,81,2086
45255,21767,10471,20,622,100,157,723,325,11296
45715,2440,1205,16,122,53,14,92,66,1235
45860,2314,1303,15,72,17,0,43,0,1011
48162,28006,13281,205,569,280,322,890,414,14725
59638,605,342,8,11,5,0,9,6,263
56150,2680,1311,27,103,38,25,108,50,1369
58381,342,177,0,2,1,0,13,8,165
58560,144,75,0,3,1,0,3,11,69
50033,29,10,0,0,0,0,0,0,19
50048,778,399,0,10,16,10,26,5,379
50119,377,186,1,4,3,0,10,35,191
42038,5313,2970,41,320,104,12,106,100,2343
47637,1254,627,0,29,36,0,22,4,627
48743,105,67,0,21,5,0,0,0,38
48855,15045,7746,66,385,145,106,439,174,7299
43772,1880,1095,2,43,24,0,45,25,785
44149,18976,9193,81,416,235,41,474,246,9783
46406,9554,4480,128,205,95,95,340,146,5074
49753,1930,1014,3,45,29,16,27,37,916
14061,389,207,7,12,0,0,13,6,182
32312,32864,15891,144,874,455,196,983,524,16973
23356,1380,765,0,87,0,0,63,29,615
20169,24848,12527,108,807,239,178,895,286,12321
22207,33285,16448,154,1023,346,61,1305,303,16837
28657,8701,4118,41,239,75,16,159,302,4583
29426,1888,783,0,69,40,0,53,83,1105
30137,1807,929,4,46,14,3,77,6,878
12024,0,0,0,0,0,0,0,0,0
13362,173,79,0,16,0,0,0,0,94
17842,8660,4330,24,341,96,89,298,152,4330
33870,21760,10745,221,436,358,262,425,321,11015
35674,18690,9237,117,696,348,74,603,230,9453
25205,413,213,0,34,0,0,0,0,200
25621,1896,921,0,58,32,36,38,39,975
41135,101,70,0,0,0,0,0,0,31
45840,55820,27343,382,1565,537,351,1545,990,28477
46375,23484,11344,115,729,249,127,788,393,12140
4270,6274,3028,5,86,40,40,160,144,3246
7002,65300,32520,583,2286,565,248,2791,1126,32780
7716,8332,4346,35,242,206,25,303,181,3986
13835,1276,646,10,43,9,10,43,34,630
32132,7514,3307,35,189,157,32,125,154,4207
24831,96,59,0,0,19,0,0,0,37
21610,386,151,3,17,7,0,4,6,235
21645,1418,751,0,32,41,0,47,20,667
18013,18029,9182,133,461,276,71,499,323,8847
28906,19401,9597,36,437,334,51,425,341,9804
30067,46647,22513,357,1966,351,258,1957,457,24134
80403,20021,10285,200,726,238,93,815,275,9736
81611,10653,5575,30,310,176,69,344,134,5078
83469,28,15,0,0,0,0,0,0,13
65669,2048,809,18,42,11,0,84,32,1239
88044,3527,1595,0,88,72,21,75,50,1932
90003,72741,35361,428,2633,486,572,2819,534,37380
71742,5401,2589,16,141,54,13,139,111,2812
91423,33737,15966,166,1217,383,46,1537,407,17771
92007,11234,5414,10,462,183,0,441,182,5820
99684,702,380,45,12,9,3,15,3,322
95493,241,104,0,0,0,0,0,18,137
59825,2427,1116,0,41,60,10,70,69,1311
60007,33420,16504,120,1427,343,79,1020,737,16916
62347,1956,982,0,72,26,0,48,19,974
62401,18722,9083,181,526,327,87,481,254,9639
62432,417,236,0,27,1,3,10,1,181
68740,1118,650,0,48,3,1,51,13,468
70722,4865,2276,11,69,56,12,160,96,2589
76853,1544,795,6,28,24,7,33,27,749
78336,11436,5872,207,373,120,60,401,188,5564
65285,685,356,0,18,0,0,17,27,329
67879,1200,581,0,30,6,0,40,25,619
56262,708,378,3,20,18,1,19,14,330
56550,458,229,0,12,11,0,19,3,229
58250,210,109,6,4,6,3,3,1,101
73835,235,104,0,28,8,0,8,14,131
80840,6633,4369,815,157,0,335,107,5,2264
81138,58,38,0,0,0,0,0,8,20
82831,266,170,0,30,0,0,5,0,96
84097,21674,10777,211,652,167,248,692,187,10897
87728,468,279,0,2,0,0,12,2,189
91602,19358,9445,76,1092,166,163,950,220,9913
97050,193,108,0,3,4,0,5,2,85
97366,1676,762,0,19,44,0,24,44,914
5447,77,57,0,0,0,0,0,0,20
7010,24883,11685,127,798,425,117,719,396,13198
7711,1570,808,22,29,31,2,18,20,762
42164,16463,8002,73,477,196,172,385,136,8461
43336,0,0,0,0,0,0,0,0,0
47320,3460,1633,17,33,57,17,72,73,1827
4463,3190,1563,23,63,70,57,90,81,1627
5355,659,328,12,28,18,0,14,13,331
14626,29901,14292,159,775,452,62,609,461,15609
58639,1856,861,0,34,38,2,20,39,995
62286,6110,2949,38,183,66,26,127,144,3161
85553,1634,913,0,53,146,0,52,17,721
81084,76,45,0,0,1,0,0,2,31
19930,2441,1113,3,1,79,20,3,60,1328
22046,18401,9142,38,650,175,53,592,477,9259
28757,116,51,0,0,0,0,0,11,65
29445,60033,30686,629,1700,395,262,2268,614,29347
26753,5849,3014,19,249,154,0,149,121,2835
27523,11629,5712,36,591,156,81,426,100,5917
53565,4716,2289,14,149,74,18,142,78,2427
54481,29059,14112,633,868,266,835,598,232,14947
54555,4722,2432,2,122,87,27,95,94,2290
54751,25969,12864,715,678,252,772,536,262,13105
16844,2754,1398,18,51,63,5,107,21,1356
12438,32,19,0,9,0,0,13,0,13
12538,13996,6669,71,203,225,218,274,216,7327
13809,1546,874,0,61,9,15,16,13,672
25951,5798,2878,104,169,181,30,183,96,2920
26149,2061,1037,9,55,37,0,57,15,1024
26228,18,0,0,0,0,0,0,0,18
2571,10927,5059,73,270,207,47,331,186,5868
19543,6265,3110,23,123,81,0,134,68,3155
95138,20766,10301,169,727,205,45,797,269,10465
95203,15775,7949,86,717,125,133,484,227,7826
76513,37916,18635,356,1082,308,521,1269,395,19281
76544,25561,17423,1851,656,0,448,384,3,8138
77371,7910,3680,21,169,108,0,141,18,4230
80206,24527,12162,161,1417,277,18,1137,279,12365
82929,127,119,0,0,0,0,0,0,8
85941,11149,5356,55,292,52,114,329,143,5793
68627,665,360,7,30,9,0,26,24,305
78591,303,130,0,8,0,0,0,0,173
79043,1447,764,16,65,8,0,65,9,683
70403,31220,14869,215,741,184,200,1020,531,16351
72632,4272,2072,7,109,175,14,53,106,2200
73491,733,368,2,23,5,3,28,14,365
92629,26744,12872,70,750,385,66,717,485,13872
92843,46036,23294,350,1396,431,267,1423,668,22742
5839,767,355,2,39,8,5,44,26,412
6062,17720,9153,20,706,148,35,612,314,8567
8848,8355,4184,44,172,99,74,273,145,4171
65633,3971,1926,25,132,26,44,51,45,2045
65788,414,212,0,18,9,0,22,0,202
66838,79,39,0,0,5,0,0,0,40
58575,784,369,9,18,16,8,27,21,415
59471,279,159,3,4,1,7,4,14,120
52727,409,193,0,0,13,0,6,0,216
36850,2654,1200,134,22,46,20,143,44,1454
15349,1547,767,0,58,12,2,48,25,780
42501,17511,8356,249,497,170,123,404,368,9155
43740,277,132,0,8,5,2,4,0,145
45068,11402,5594,32,362,131,114,373,140,5808
55053,1083,553,12,24,10,0,31,16,530
63144,8725,4101,0,351,72,34,350,57,4624
63952,451,233,0,25,2,0,26,3,218
48831,3625,1814,22,135,39,18,107,77,1811
45434,12256,6175,8,348,156,15,372,226,6081
50021,27406,13408,202,729,291,220,791,251,13998
35175,5714,3101,21,97,76,0,41,106,2613
87323,4123,2233,27,135,16,28,63,43,1890
87514,866,420,0,0,16,0,0,0,446
89147,53140,25802,273,1615,599,375,1721,742,27338
97537,7536,3710,41,102,115,62,59,150,3826
98280,417,188,0,0,2,0,0,0,229
99170,995,488,0,13,16,0,31,16,507
5858,431,229,0,19,5,0,21,2,202
7031,15724,7851,108,599,155,41,641,227,7873
7512,10828,4990,35,172,161,52,286,171,5838
1468,4024,1800,0,47,10,46,85,70,2224
2739,6294,3005,22,151,143,50,142,168,3289
99745,90,51,0,2,0,0,3,0,39
30021,24137,11726,131,821,185,150,1201,182,12411
40390,7691,3746,103,152,130,234,93,96,3945
23897,403,158,0,17,0,0,19,13,245
24147,1264,569,10,29,21,5,8,9,695
29803,38920,19040,108,851,375,197,741,818,19880
29929,1002,492,6,15,8,0,31,10,510
17974,244,99,0,6,4,12,0,9,145
18051,3670,1954,0,86,4,17,80,98,1716
19711,52033,24953,1031,1258,579,1533,1555,646,27080
21661,2502,1295,0,31,49,3,44,24,1207
22401,28469,13064,257,1038,171,805,970,182,15405
24637,3640,1927,0,193,119,0,115,73,1713
33825,26526,13175,154,929,351,88,688,372,13351
27843,1054,589,0,64,4,12,55,7,465
27920,1327,634,0,35,0,0,0,13,693
39079,1769,869,38,14,8,9,65,15,900
52135,693,302,0,14,6,0,15,14,391
57761,1457,709,0,53,12,9,99,25,748
60452,28324,14366,360,720,239,200,833,580,13958
45742,2840,1355,63,84,13,0,72,139,1485
46256,23513,11494,21,689,335,144,538,538,12019
66024,664,380,13,0,16,0,16,0,284
66217,5838,2670,9,225,100,24,109,160,3168
68980,449,207,5,8,11,5,12,16,242
54630,4169,2117,28,96,43,9,101,62,2052
72202,10228,4895,98,367,111,73,449,178,5333
72569,391,186,0,8,0,0,15,0,205
73744,158,46,0,5,0,0,1,7,112
75173,4131,2137,49,59,41,8,112,85,1994
97416,1162,617,3,18,17,27,7,8,545
99148,1844,955,0,20,45,5,51,31,889
1259,528,258,0,14,19,0,3,26,270
37396,198,75,0,10,0,0,0,0,123
38391,1090,539,11,60,13,0,11,6,551
56683,708,350,0,24,2,2,12,14,358
60041,8897,4348,168,224,135,0,149,208,4549
60133,38400,18993,166,1586,321,345,1397,585,19407
90001,58975,30349,412,1801,331,593,1963,553,28626
67010,13897,6793,13,321,130,105,352,126,7104
68934,107,87,0,1,0,0,5,0,20
59468,624,303,1,28,14,0,6,17,321
62330,1746,870,0,65,37,0,63,69,876
50138,11741,5645,52,382,138,30,278,148,6096
58018,366,198,0,30,11,0,16,0,168
58071,417,242,0,16,7,0,9,10,175
64082,16310,8018,87,579,140,74,743,146,8292
71259,1499,610,22,25,14,0,36,7,889
92252,9394,4795,64,240,59,40,232,84,4599
77616,563,314,0,0,0,45,0,18,249
77873,1284,619,6,11,7,89,76,3,665
57799,684,224,21,0,0,47,0,0,460
58043,144,84,0,6,1,1,4,3,60
58345,128,64,0,0,0,1,0,0,64
59064,272,161,0,0,0,0,0,0,111
73107,25328,12551,144,863,200,150,1084,288,12777
65774,1124,523,0,77,4,25,45,1,601
66516,370,181,0,8,5,7,9,2,189
67336,1811,907,21,59,28,0,32,25,904
68788,4406,2303,28,73,42,40,103,13,2103
71008,743,414,0,20,41,5,1,9,329
81149,825,463,0,44,15,0,5,20,362
83344,1325,649,7,50,9,0,30,6,676
84095,68803,34025,268,2946,396,499,2702,467,34778
80016,54651,27326,253,2108,568,212,2225,592,27325
97013,23596,11725,179,776,254,123,722,329,11871
97040,1546,766,20,61,24,0,99,39,780
87048,9073,4686,55,218,127,30,167,131,4387
88112,173,89,0,8,7,0,8,2,84
95338,10898,5490,57,257,187,29,233,160,5408
30135,66134,31533,332,1852,655,418,2609,649,34601
30420,845,378,7,6,12,0,7,7,467
31522,16402,7624,43,333,304,8,449,286,8778
37687,4516,2492,50,190,79,43,167,60,2024
41831,801,427,0,48,7,30,6,48,374
43009,2453,1199,0,60,34,8,67,31,1254
94545,32525,16188,240,1010,285,184,1015,405,16337
95443,270,150,0,0,0,0,0,0,120
97437,2914,1448,56,54,38,19,40,78,1466
91384,28842,16710,313,1431,309,220,607,316,12132
93212,23424,15926,314,2098,199,178,387,90,7498
93541,226,155,0,0,0,0,0,21,71
98583,109,61,0,9,0,0,0,0,48
98661,47036,23777,271,1750,409,222,1520,611,23259
99613,455,266,1,29,5,3,15,0,189
41043,1631,895,12,14,54,0,22,47,736
43231,21828,10499,231,825,140,72,830,295,11329
33067,27784,13188,268,787,350,173,784,522,14596
33538,4523,2047,11,33,66,25,146,50,2476
33860,25150,12543,145,969,107,188,684,188,12607
52347,1312,658,2,23,18,0,44,16,654
49743,751,394,6,11,15,0,14,16,357
50141,524,278,0,12,20,0,13,7,246
38632,27317,13806,127,791,255,123,864,337,13511
39475,13418,6460,44,453,101,9,361,124,6958
46536,3065,1508,7,71,61,13,83,65,1557
47456,1522,747,0,34,27,0,14,54,775
78608,443,218,0,24,0,0,22,18,225
79095,2692,1325,22,106,40,0,65,24,1367
82331,2231,1188,0,23,47,9,45,16,1043
83221,27089,13567,197,726,349,144,629,291,13522
61258,236,124,0,22,3,0,24,1,112
71841,1026,559,0,49,17,0,25,18,467
72544,624,310,0,0,17,27,15,50,314
74966,3663,1875,18,108,59,34,119,62,1788
75450,141,58,0,12,8,0,0,0,83
88065,532,285,26,0,0,12,0,0,247
89420,0,0,0,0,0,0,0,0,0
90067,2314,1113,0,9,45,0,77,72,1201
5478,14802,7304,65,389,133,98,555,232,7498
5738,1197,636,3,33,18,0,47,29,561
14414,7101,3557,83,283,86,42,156,125,3544
10562,31772,16032,241,1557,297,141,1253,405,15740
39174,821,254,38,3,0,99,0,0,567
27962,7527,3630,0,360,152,0,260,94,3897
32225,54496,26557,359,1284,603,422,1779,871,27939
32653,13168,6437,124,222,195,52,389,284,6731
32934,18761,9366,154,390,286,92,378,347,9395
50593,37,20,0,0,4,0,1,0,17
51510,3792,1856,0,110,69,0,157,46,1936
65626,1654,956,32,121,24,0,25,46,698
66738,230,124,0,3,12,0,6,0,106
67206,16106,8129,207,334,239,40,259,290,7977
68641,1196,597,8,44,17,4,17,10,599
57065,360,195,0,10,6,0,5,12,165
59489,322,181,0,10,15,0,12,0,141
61833,2199,1034,0,106,10,0,52,85,1165
54974,1474,726,4,51,13,0,57,25,748
55910,1312,668,7,60,13,7,48,19,644
73567,652,352,3,19,15,2,22,14,300
74046,127,62,0,0,0,0,5,0,65
74873,11863,5639,34,434,180,113,439,124,6224
45207,7133,3238,54,174,38,66,189,88,3895
45233,16025,7749,76,345,234,118,376,297,8276
56688,137,79,0,0,4,3,0,3,58
51560,2132,1122,37,52,18,3,118,22,1010
52211,2427,1231,79,96,70,0,67,37,1196
36579,1204,733,19,0,35,0,0,16,471
30434,5386,2674,125,230,58,27,206,36,2712
35541,3390,1618,23,83,71,0,121,51,1772
35950,21556,10514,182,658,121,76,828,234,11042
41602,1002,383,0,0,0,0,30,0,619
48217,6887,3058,5,163,33,107,290,182,3829
49799,2145,1130,4,100,41,8,52,51,1015
50601,2639,1312,3,98,23,4,72,28,1327
14226,29700,13616,186,776,216,283,906,447,16084
3077,10389,5459,38,237,139,75,267,171,4930
24607,295,106,0,0,8,0,0,18,189
21156,320,119,0,0,0,14,0,19,201
21230,34947,16831,143,1689,272,131,1269,492,18116
21668,1815,953,2,75,17,13,19,20,862
23069,2803,1496,21,115,50,15,24,33,1307
8320,1091,1091,13,189,0,0,0,0,0
12175,570,319,0,20,17,0,11,22,251
13072,738,401,11,22,10,0,10,19,337
60919,481,246,7,22,0,0,12,13,235
61273,3243,1651,27,107,42,4,105,63,1592
57724,233,143,13,25,6,0,0,5,90
35966,3682,1736,66,10,84,18,53,19,1946
40510,2022,1399,57,173,18,5,40,12,623
43536,161,76,9,0,0,0,0,0,85
79783,284,144,0,11,0,0,0,6,140
93643,2960,1576,2,41,17,3,43,73,1384
97435,2137,1087,31,80,22,15,49,43,1050
66712,1723,759,10,36,11,13,40,22,964
68938,503,283,0,10,7,8,15,5,220
29743,861,432,10,39,37,0,43,8,429
39581,10792,5236,49,195,100,133,338,129,5556
11731,30357,15357,244,712,234,252,729,477,15000
14170,2544,1180,0,68,35,0,80,34,1364
71067,3461,1503,28,196,83,46,88,58,1958
51018,255,134,4,6,1,4,12,6,121
56518,398,210,0,19,3,2,10,0,188
20676,4422,2190,68,81,42,23,123,50,2232
21014,35681,17787,224,1104,293,228,1099,373,17894
22663,1433,777,0,39,29,0,34,0,656
54028,2387,1180,30,79,25,4,80,38,1207
57364,21,10,0,0,0,0,0,0,11
69357,3596,1836,14,102,22,20,126,77,1760
30665,67,31,0,0,0,0,0,0,36
31019,2035,934,4,82,27,21,98,27,1101
44241,16638,7853,82,569,87,283,597,327,8785
46149,2026,995,3,67,28,0,94,0,1031
46538,3854,1945,50,88,55,9,82,47,1909
28479,6274,3261,20,233,42,0,98,169,3013
28781,973,462,13,49,0,0,53,48,511
49735,19657,9574,71,545,284,149,513,258,10083
72459,1380,661,0,24,10,33,4,22,719
72520,186,65,0,0,0,0,16,0,121
72526,212,120,6,24,0,15,24,1,92
72903,26143,12372,267,614,341,219,468,409,13771
73434,642,316,2,23,7,0,19,9,326
70431,5735,3025,19,215,64,0,155,61,2710
70458,37140,17820,153,1154,475,74,1100,721,19320
71441,501,281,13,0,0,15,19,7,220
48073,34242,16970,224,1176,381,137,1272,540,17272
48611,6646,3258,6,233,110,55,187,80,3388
12208,21896,10537,211,834,202,416,532,119,11359
20170,43116,21872,324,1748,338,181,1610,641,21244
7630,7611,3479,19,282,49,33,223,158,4132
15783,111,58,0,0,0,0,0,0,53
12182,14928,6995,42,308,146,84,467,275,7933
11368,112425,58465,815,5239,568,598,4282,1334,53960
18419,4653,2367,37,178,65,50,132,43,2286
18629,1618,809,0,40,14,0,41,35,809
83602,7,7,0,0,0,0,0,0,0
91755,27734,13741,75,889,319,94,888,457,13993
91917,920,402,0,31,0,11,47,7,518
87513,801,468,0,62,23,0,20,23,333
89103,52149,26532,350,1756,579,456,2027,585,25617
93705,37707,18369,278,1167,273,240,1105,268,19338
96863,46,46,0,0,0,0,0,0,0
97021,965,505,0,45,21,0,64,14,460
77433,82257,41900,415,3310,393,572,3702,655,40357
79699,112,69,6,0,0,11,0,0,43
55115,9113,4323,35,160,112,11,228,229,4790
66753,1238,659,2,71,33,86,36,20,579
66862,55,22,0,0,1,0,0,0,33
69022,1809,886,0,32,21,11,30,28,923
69336,2638,1306,11,64,37,46,90,19,1332
61742,1250,641,4,29,6,0,19,22,609
62932,1498,682,22,23,8,12,11,23,816
63439,86,48,0,8,5,0,6,5,38
68649,2069,1015,0,68,18,9,62,26,1054
69214,350,164,0,1,13,0,0,14,186
62056,8574,4091,47,196,117,75,346,135,4483
62218,1820,954,7,65,13,2,40,17,866
61350,23835,11340,66,623,232,67,696,369,12495
66751,822,385,0,40,10,2,19,19,437
75801,16346,8105,180,635,177,197,507,222,8241
16117,16974,8168,99,546,295,92,406,417,8806
92273,1704,745,22,6,0,11,51,14,959
17045,3185,1523,10,77,33,10,86,49,1662
92544,48923,24351,331,1333,481,368,1375,915,24572
5821,1070,516,8,27,34,6,23,37,554
46280,7490,3743,0,146,86,21,255,79,3747
47135,1077,563,0,32,46,0,28,14,514
47922,1631,736,2,29,20,9,112,35,895
11697,3540,1699,0,56,38,0,100,72,1841
12164,347,131,0,1,3,0,1,0,216
38621,1636,730,0,20,17,11,94,11,906
39038,5854,2611,32,103,98,128,202,170,3243
39092,2652,1298,21,86,17,26,11,21,1354
29107,2737,1283,3,69,16,29,75,3,1454
26456,3506,1823,0,76,43,11,86,14,1683
23830,1331,707,4,44,50,123,7,26,624
12514,2905,1498,10,68,10,0,38,43,1407
13316,6179,2962,7,164,160,0,130,187,3217
24263,6137,2876,0,191,101,53,56,65,3261
25085,937,443,7,8,7,0,39,4,494
91962,2378,1247,0,33,35,7,54,84,1131
93727,82920,41382,693,3187,486,600,3122,938,41538
90049,36964,17187,24,1301,301,335,1406,378,19777
98357,1645,853,9,56,20,4,55,18,792
99694,1705,826,16,42,21,15,82,23,879
10560,4825,2327,14,73,59,14,129,67,2498
4644,0,0,0,0,0,0,0,0,0
25523,3145,1530,20,45,22,11,94,76,1615
32681,47,16,0,0,0,0,0,0,31
33035,15658,7134,157,592,98,50,1174,66,8524
34234,21865,10175,136,498,279,95,612,235,11690
78358,561,272,0,8,8,0,0,14,289
79755,111,75,0,15,3,0,0,0,36
95519,19099,9858,153,565,250,145,788,332,9241
95984,33,8,0,0,0,0,0,25,25
97006,72831,36974,726,3314,487,388,2675,694,35857
90240,26205,12867,47,984,154,140,1030,307,13338
97730,237,117,0,9,1,0,4,10,120
98107,25720,13021,33,1616,223,155,1504,286,12699
99130,856,408,0,48,18,0,39,15,448
99504,42504,22586,330,1438,547,252,1178,588,19918
84060,8488,4426,55,154,127,69,266,86,4062
85338,48517,24203,457,1869,560,337,1957,609,24314
76487,3201,1580,11,82,13,12,99,13,1621
76831,36,19,0,0,19,0,0,0,17
61559,3263,1630,10,81,29,11,52,34,1633
63628,15970,9150,179,856,172,104,358,291,6820
63645,11466,5702,67,253,108,72,202,194,5764
63954,721,357,38,8,4,2,15,3,364
54941,2366,1227,8,59,67,0,24,45,1139
57436,459,230,0,10,9,5,10,3,229
58068,383,190,0,4,22,0,7,0,193
48842,21827,10836,69,881,220,16,954,279,10991
68446,2862,1315,0,61,22,8,84,25,1547
68751,92,41,0,0,9,0,4,0,51
60534,10544,5210,46,220,55,85,430,126,5334
61374,118,59,0,0,0,0,3,0,59
61839,610,313,0,26,10,0,14,2,297
56212,452,225,11,4,10,0,18,9,227
56515,3007,1454,24,50,68,6,76,54,1553
72386,2048,1031,36,65,20,0,59,35,1017
73011,326,173,0,10,0,4,5,6,153
74337,4913,2548,27,193,33,20,179,43,2365
70652,2132,974,0,0,0,43,31,13,1158
71219,1364,729,1,23,21,5,9,5,635
1201,44607,21342,242,1384,546,359,1142,677,23265
2445,21324,9963,187,848,229,173,688,282,11361
33909,31467,15151,335,738,276,87,1005,583,16316
35760,4869,2394,22,175,30,21,158,90,2475
30607,10748,5345,96,399,94,101,565,120,5403
62928,183,100,0,41,0,0,4,2,83
63825,4508,2361,20,118,59,4,218,71,2147
64427,638,291,6,17,10,3,32,7,347
18081,155,79,0,0,0,0,0,0,76
19131,44972,19328,207,932,258,554,1304,772,25644
57744,2123,1135,0,73,50,0,57,59,988
57775,271,139,0,15,3,3,0,0,132
46516,31960,15900,190,1003,177,154,1083,366,16060
49423,45487,22202,545,1220,372,493,1210,549,23285
49821,1274,662,3,23,22,0,15,31,612
51533,838,432,2,8,18,0,6,8,406
53146,8244,4302,32,304,134,35,251,120,3942
34480,19029,9280,115,452,159,76,535,258,9749
39576,5790,2770,46,264,71,0,234,64,3020
20064,2207,899,146,0,0,135,2,0,1308
23323,39568,19328,309,1295,212,364,1548,600,20240
4055,3920,1965,18,148,15,0,108,58,1955
5046,1137,587,0,54,25,0,33,13,550
5748,323,170,2,9,11,2,15,4,153
6516,54918,27594,460,1558,537,582,1451,823,27324
7403,7999,3682,39,236,39,0,220,93,4317
14885,726,364,10,10,3,5,15,6,362
12015,3006,1464,56,77,56,18,84,30,1542
7960,44907,22134,289,1362,399,162,1434,623,22773
11222,36492,18000,160,2063,337,127,2093,300,18492
952,8156,3844,74,109,37,108,212,133,4312
1524,6902,3337,9,89,61,33,96,184,3565
17545,21897,10875,115,542,289,64,670,293,11022
17760,792,390,7,10,15,4,28,5,402
18709,2922,1357,31,79,29,0,38,96,1565
98236,6245,2938,25,149,120,0,139,153,3307
98329,11333,5998,153,300,194,70,434,157,5335
99005,9122,4570,19,279,98,30,477,181,4552
99202,20627,10479,410,681,187,306,645,486,10148
94118,41468,19090,138,1859,330,158,1699,469,22378
95365,4710,2486,0,145,42,5,99,45,2224
96109,758,431,0,0,24,0,28,0,327
97381,15822,7655,93,448,202,117,491,248,8167
13630,1451,720,6,34,24,10,39,5,731
79758,2306,1358,0,106,26,34,88,29,948
15338,1728,875,7,24,37,2,33,25,853
53019,1897,1009,13,85,31,6,60,25,888
54301,21939,10579,94,621,229,49,808,291,11360
65746,8652,4364,65,208,85,18,250,102,4288
20817,36681,17363,78,641,457,150,1042,501,19318
62850,359,185,0,6,0,4,9,1,174
22802,29921,14446,316,983,208,399,1136,404,15475
23829,2529,1788,0,75,12,1,68,46,741
70657,4931,2609,33,141,62,68,105,180,2322
19076,6534,2958,9,312,31,12,242,57,3576
71965,284,132,0,0,0,0,22,0,152
12570,7322,3473,59,235,78,92,190,72,3849
63827,831,442,0,19,20,5,22,1,389
76431,3415,1640,48,83,30,9,167,64,1775
59934,501,248,0,9,19,19,16,8,253
60473,22201,10368,159,601,162,140,716,338,11833
80864,1333,702,23,44,28,0,23,46,631
81242,561,256,0,13,13,0,12,18,305
83321,463,213,0,15,5,4,24,5,250
64659,1003,521,0,25,16,0,27,21,482
74833,834,419,13,11,15,18,20,7,415
95255,1358,752,0,14,72,0,44,11,606
97637,99,43,0,0,0,0,4,0,56
4224,2493,1247,7,45,31,13,91,48,1246
4489,221,99,0,0,0,0,0,20,122
1108,27850,13319,267,841,197,262,990,299,14531
1561,294,166,0,19,0,0,0,0,128
32949,2629,1283,0,63,48,21,25,29,1346
13753,5777,2917,73,119,53,99,135,67,2860
14481,1709,879,16,43,37,9,38,21,830
16404,3670,1899,17,120,31,13,99,38,1771
18070,1108,571,0,0,16,0,19,0,537
18251,18,18,0,18,0,0,0,0,0
19372,1667,806,30,19,11,0,16,23,861
94103,28735,16788,195,1552,240,73,1538,374,11947
97415,14059,6920,48,306,159,38,326,283,7139
90630,49169,23902,398,1082,389,490,1846,589,25267
98951,12920,6673,134,443,103,69,352,148,6247
72424,94,52,0,3,0,0,5,0,42
73848,2408,1235,1,150,34,0,135,24,1173
66618,9760,4741,19,399,130,77,322,150,5019
67441,1330,690,6,52,16,14,50,13,640
67761,220,111,0,9,0,0,8,6,109
68157,6420,3218,0,239,70,57,172,83,3202
69171,7,3,0,0,0,0,0,0,4
63561,1162,504,0,17,27,22,27,6,658
65282,119,61,0,10,0,0,0,0,58
84093,23495,11909,72,983,224,103,695,328,11586
62273,294,146,0,0,0,0,35,8,148
78932,555,248,0,1,0,59,15,2,307
49406,740,342,0,19,3,0,16,20,398
48146,36883,17758,324,1302,406,144,1398,450,19125
20143,1156,538,0,50,11,9,6,7,618
21911,11238,5743,158,328,169,32,285,139,5495
21912,1152,599,0,0,0,0,17,38,553
22904,5095,2407,252,5,0,115,4,0,2688
4976,9752,4666,0,211,183,73,215,136,5086
14840,2712,1381,16,49,103,12,60,62,1331
79016,138,49,0,0,0,13,0,0,89
79256,227,148,0,3,9,0,0,5,79
61231,5213,2527,15,119,82,20,180,93,2686
61741,1703,860,14,71,19,9,50,34,843
63879,589,282,0,20,16,2,16,6,307
64482,2203,1049,0,45,20,3,67,34,1154
68827,555,283,0,19,0,16,13,0,272
70352,165,71,0,23,0,0,24,0,94
66021,2674,1411,0,115,27,9,115,43,1263
87538,597,421,0,31,0,0,0,0,176
74941,2759,1341,10,65,44,27,59,71,1418
72427,328,158,0,25,0,27,0,0,170
80498,7911,4880,1,443,219,29,207,116,3031
83220,122,67,0,2,7,0,0,0,55
16678,2585,1218,24,59,45,24,91,59,1367
32435,7325,3540,27,95,90,126,151,106,3785
32824,46545,22543,156,2016,380,313,1883,361,24002
24171,8524,4240,57,190,195,39,193,100,4284
25843,974,485,0,0,0,18,21,25,489
22716,626,352,0,15,0,0,13,0,274
19107,13696,6571,46,451,99,207,414,86,7125
19147,39060,19231,73,2120,253,62,2097,428,19829
8511,867,429,6,29,10,8,15,32,438
29431,6947,3597,0,144,93,45,122,100,3350
12836,698,339,3,15,8,2,16,11,359
52337,660,319,2,12,2,8,24,4,341
52752,517,244,0,7,11,0,15,10,273
53033,4992,2516,21,96,79,16,114,125,2476
54844,216,112,0,0,3,0,2,1,104
56082,14502,7365,257,435,132,276,421,187,7137
37353,5387,2776,65,106,102,32,275,87,2611
37860,4037,2036,73,87,45,0,141,44,2001
16854,622,338,5,19,13,2,29,5,284
8327,3087,2953,0,529,0,0,0,0,134
13428,1754,847,0,48,11,15,52,11,907
14047,6298,3177,26,186,50,31,233,118,3121
24853,421,207,0,0,3,0,11,0,214
24944,490,186,22,18,9,8,46,8,304
64672,256,101,0,8,2,0,13,0,155
65026,11549,5637,42,493,84,28,298,199,5912
67445,617,308,4,5,15,3,6,11,309
68133,11191,5526,0,276,123,0,318,89,5665
68949,6316,3066,63,177,120,22,120,121,3250
69001,8911,4404,30,285,84,23,270,84,4507
89008,1324,589,11,37,9,0,7,5,735
90401,7256,3632,45,409,61,41,72,64,3624
78219,16897,7342,103,296,90,107,584,182,9555
79311,3541,1881,29,121,44,0,75,32,1660
71953,13894,6710,18,328,296,54,298,240,7184
73666,226,109,0,11,5,0,20,2,117
74108,7612,3870,55,223,59,34,205,77,3742
3825,9201,4686,34,486,16,74,375,159,4515
3853,538,241,0,0,5,22,0,18,297
6334,2493,1241,12,66,47,0,113,59,1252
915,26131,12458,253,813,266,256,786,425,13673
1104,23876,11057,218,577,183,204,767,313,12819
65556,6247,3299,50,242,184,101,166,105,2948
59528,274,143,0,9,7,0,0,10,131
59854,197,105,2,2,7,0,3,5,92
60067,38177,18153,89,995,420,61,1190,710,20024
52644,396,201,0,1,0,0,3,9,195
52730,4942,2749,32,161,14,40,200,64,2193
53224,22405,10905,83,649,220,106,740,387,11500
37205,24785,11323,111,634,298,162,763,485,13462
15216,22776,11255,97,932,159,116,876,298,11521
45614,4825,2302,0,149,64,0,91,92,2523
98358,926,419,0,61,29,0,30,48,507
54638,1528,770,3,43,23,6,44,23,758
55005,4623,2404,65,187,11,50,163,38,2219
56282,1641,861,4,33,12,3,29,26,780
61054,3674,1707,0,127,14,0,25,50,1967
78703,20890,10646,18,809,138,32,877,326,10244
79239,206,109,0,1,9,0,7,0,97
92657,9670,4909,61,233,105,24,210,144,4761
64628,5984,2759,0,141,53,51,170,74,3225
65590,1198,697,10,55,18,0,35,0,501
58467,733,376,0,9,11,0,3,9,357
58770,1635,791,10,43,6,14,77,10,844
68309,110,57,0,5,0,1,3,2,53
61335,441,236,2,13,1,5,8,5,205
62061,1671,860,0,32,21,9,64,6,811
20608,738,425,0,17,5,0,10,11,313
21660,3881,1875,28,127,32,54,163,26,2006
78341,2107,1171,69,23,20,0,39,14,936
64492,1902,922,4,77,6,0,120,30,980
68337,280,141,0,0,11,4,4,6,139
68757,874,467,0,23,11,0,17,7,407
75657,7722,3672,8,138,89,26,177,181,4050
76034,26001,13224,167,610,436,126,709,561,12777
70630,2610,1396,75,41,7,0,51,67,1214
70653,3430,1860,38,64,31,0,52,40,1570
70785,21416,10380,56,762,69,37,797,358,11036
71362,1746,742,0,60,0,7,84,59,1004
63873,4654,2307,21,82,71,0,118,43,2347
80419,0,0,0,0,0,0,0,0,0
73937,242,111,0,0,6,0,0,0,131
89439,1355,621,15,30,64,0,16,23,734
90290,5371,2598,0,158,38,54,193,73,2773
84631,3066,1567,28,117,36,7,70,52,1499
85013,20902,10855,69,847,217,0,650,326,10047
87062,1365,697,0,121,30,14,50,11,668
94607,26254,12912,161,1315,204,160,1069,311,13342
50011,1498,893,9,0,0,0,0,0,605
50105,955,489,3,32,7,6,41,13,466
50588,12513,6435,192,268,118,242,449,116,6078
50674,3716,1652,24,99,70,48,72,42,2064
70755,1941,912,9,34,23,18,62,46,1029
65265,15059,7251,148,389,162,61,472,255,7808
65620,252,135,0,23,0,0,0,16,117
44270,8800,4536,54,231,60,52,291,179,4264
44851,4679,2565,12,171,49,12,207,48,2114
99774,11,7,0,0,0,0,0,0,4
17554,7794,3584,14,127,127,112,149,36,4210
17579,6302,3187,39,169,64,61,118,85,3115
19026,31072,14699,128,1248,370,134,1149,387,16373
12465,199,104,0,0,9,0,7,5,95
13163,473,295,10,15,8,0,6,0,178
5751,726,315,0,10,16,4,16,6,411
73547,2331,1619,38,70,49,13,35,23,712
74050,356,185,0,0,6,0,12,14,171
51536,378,176,0,3,5,3,9,7,202
53142,32929,15827,223,1124,287,109,1240,393,17102
62479,935,509,15,54,13,0,14,11,426
62625,822,419,0,16,46,0,17,17,403
68022,23049,11698,87,877,210,15,1077,242,11351
70359,8444,4076,55,238,146,150,392,79,4368
61278,479,226,0,15,8,0,19,10,253
81631,8411,4381,0,382,103,27,440,97,4030
85320,1480,923,41,59,9,0,75,0,557
78607,41,14,0,0,0,0,0,0,27
78614,577,320,0,4,13,0,5,5,257
87528,3505,1758,0,106,12,57,103,22,1747
95361,34558,16892,289,794,328,288,1174,420,17666
76539,8566,4365,77,222,107,18,308,165,4201
29856,2688,1234,0,122,0,49,65,88,1454
34604,11573,5505,80,343,125,51,429,72,6068
39648,21035,9669,103,538,133,95,731,286,11366
45383,6912,3322,69,187,37,0,191,51,3590
45838,66,36,0,0,0,0,0,0,30
98104,14144,8720,88,845,187,17,255,92,5424
99203,20943,10071,171,627,373,100,637,359,10872
58036,279,163,16,15,12,0,4,7,116
41772,264,147,16,20,0,0,15,0,117
43317,153,67,0,11,2,0,4,7,86
43432,1278,695,0,70,16,0,31,19,583
43967,0,0,0,0,0,0,0,0,0
45358,348,175,6,15,8,8,10,0,173
50607,510,259,0,6,11,0,5,1,251
53185,18929,9754,45,527,275,22,406,288,9175
48092,26893,13510,251,806,304,137,884,492,13383
49265,5097,2523,34,94,60,0,87,64,2574
39638,3220,1473,0,101,26,27,114,50,1747
81008,10856,5364,60,258,142,80,349,170,5492
62639,291,149,0,0,7,0,14,0,142
62816,1198,593,21,51,13,0,23,16,605
72527,714,302,0,31,0,0,0,0,412
72926,612,297,0,6,12,0,7,0,315
67576,1920,1013,26,27,34,15,25,25,907
69365,38,12,0,0,0,0,0,0,26
74525,9492,4904,60,306,79,31,167,131,4588
17724,4816,2384,6,150,64,10,111,71,2432
17978,302,144,0,3,2,0,6,3,158
18840,10780,5159,126,221,151,41,277,193,5621
13904,9948,4768,44,284,132,61,335,144,5180
1331,13383,6162,41,388,202,54,385,274,7221
39406,1971,311,62,0,0,230,0,0,1660
27507,1841,904,2,0,36,0,0,13,937
31045,49,19,0,0,19,0,0,0,30
49746,3315,1612,17,63,42,10,81,68,1703
51109,2989,1603,0,149,25,0,78,65,1386
65011,2762,1417,40,103,38,20,11,15,1345
66506,3445,1630,107,0,0,26,0,0,1815
67501,26368,13913,290,1099,224,136,665,240,12455
67552,591,302,0,11,3,0,10,7,289
58216,156,83,0,0,0,0,0,3,73
60090,38476,19722,168,1593,368,98,1132,618,18754
47712,26881,12678,423,745,366,453,704,365,14203
71103,6720,3219,0,135,92,52,241,91,3501
72301,24477,11113,132,610,185,126,833,335,13364
45248,25324,12339,123,826,296,101,887,342,12985
38655,42623,21043,1100,1120,316,1008,1294,402,21580
32424,7182,4345,16,463,122,19,134,70,2837
32534,14524,6320,71,361,151,101,488,237,8204
44610,160,66,0,0,0,0,0,0,94
43347,1501,739,3,36,25,0,34,58,762
29848,631,384,28,5,2,0,6,1,247
13654,2722,1485,9,70,39,3,57,24,1237
16679,761,368,0,11,6,0,19,13,393
3909,9997,4593,0,232,100,0,240,133,5404
5654,1023,530,0,5,11,0,41,0,493
6855,8528,3963,10,282,93,31,195,165,4565
25245,541,206,0,0,0,0,15,0,335
25922,258,132,26,0,0,0,0,0,126
21710,4881,2411,12,127,36,13,148,63,2470
22480,675,294,0,10,8,0,7,8,381
10466,72479,31842,434,1760,516,878,2399,1052,40637
12065,42868,21163,250,1582,476,213,1406,615,21705
12416,281,134,0,39,0,9,36,9,147
2668,2723,1138,0,16,81,35,58,79,1585
28387,15526,7098,149,430,229,37,644,149,8428
60805,19666,9031,143,432,185,217,557,317,10635
35660,8986,4032,70,224,81,11,209,124,4954
41566,923,424,0,28,8,0,42,13,499
42369,244,143,0,10,9,2,10,4,101
50058,1909,882,0,36,21,0,47,29,1027
50101,29,17,0,0,0,0,3,0,12
50634,807,407,22,22,13,15,23,19,400
11732,3764,1791,0,46,114,36,55,79,1973
11739,1027,547,0,20,5,0,23,10,480
39503,54993,25967,565,1983,481,432,2090,718,29026
30634,1802,910,0,63,20,19,66,31,892
31563,1296,710,0,74,39,22,36,28,586
22511,1050,478,3,15,22,0,56,0,572
22807,3216,1164,22,0,0,46,0,0,2052
23426,80,40,0,0,0,0,0,0,40
12407,137,65,0,0,2,0,0,3,72
12733,1642,1052,0,56,17,2,13,0,590
30005,40056,20307,216,1742,198,81,1585,355,19749
20158,4448,2329,27,124,32,2,206,41,2119
92118,22484,11661,336,524,278,58,558,347,10823
93665,875,424,0,0,0,0,36,27,451
87539,22,22,0,0,0,0,0,0,0
95316,6616,3390,45,181,90,21,269,171,3226
95548,1224,606,3,70,8,43,61,18,618
95971,6254,3233,22,271,128,46,268,61,3021
84328,1637,844,7,36,41,18,47,18,793
61108,27819,13269,132,756,286,266,916,402,14550
62344,14,3,0,0,0,0,0,0,11
62515,1010,530,11,21,14,0,25,6,480
63764,5349,2576,14,185,87,23,224,97,2773
48848,7575,3804,18,166,105,25,263,128,3771
34956,10057,5761,81,519,107,42,179,141,4296
35811,27658,13181,269,1165,371,126,1140,498,14477
35903,17125,7925,267,444,67,186,660,239,9200
38945,46,9,0,0,0,0,0,0,37
40040,290,122,0,11,1,0,4,2,168
99204,6538,3082,67,193,51,63,128,115,3456
99784,186,96,1,11,4,0,0,1,90
93940,32411,16549,236,1199,461,448,750,491,15862
92284,26085,12728,52,624,348,62,746,363,13357
3847,337,143,0,0,0,0,0,0,194
4762,544,255,0,2,13,0,12,4,289
5845,1319,690,0,16,17,0,52,22,629
6477,13937,6647,97,300,243,43,370,210,7290
717,16659,7411,214,432,167,115,409,222,9248
30056,2217,1123,6,71,25,0,60,37,1094
30294,41782,19638,196,1063,327,260,1639,795,22144
31405,37497,17747,282,1165,372,260,1074,493,19750
36782,2691,1485,3,61,9,0,66,27,1206
37335,2924,1454,0,58,36,32,112,14,1470
19464,46918,22816,235,1559,507,383,1376,665,24102
42082,1689,920,0,128,24,0,126,22,769
43137,2276,982,27,101,20,2,35,14,1294
43333,509,236,0,17,29,0,16,0,273
32405,32064,15567,185,1144,341,246,1113,387,16497
49712,8043,3928,47,223,76,41,171,133,4115
51542,1146,578,0,0,17,0,28,24,568
52560,347,157,0,7,2,0,1,2,190
53207,37244,18318,157,1832,484,100,1615,527,18926
47516,1330,692,5,33,2,5,66,16,638
66412,148,69,0,0,7,0,7,6,79
66739,5497,2696,0,166,23,40,216,55,2801
69123,900,448,0,22,7,7,36,9,452
64153,5234,2430,31,323,32,0,382,5,2804
74860,1784,901,6,57,17,7,42,38,883
96752,3572,1778,35,131,26,3,76,48,1794
96774,181,102,0,0,18,0,0,52,79
98075,23587,11472,25,804,199,21,982,313,12115
98535,560,321,0,0,0,0,0,0,239
15333,2270,1039,12,55,37,0,73,20,1231
1109,29903,14117,489,617,170,679,1032,280,15786
31025,866,440,3,48,14,8,31,0,426
34137,454,178,0,81,0,0,0,0,276
38366,1889,959,10,46,29,0,78,38,930
96141,297,142,0,19,21,0,0,9,155
97014,1202,647,0,58,52,0,28,24,555
97635,138,74,0,0,0,0,0,18,64
98351,1228,573,0,56,17,0,29,29,655
99505,6330,3815,390,173,0,15,216,0,2515
78638,2304,1147,24,94,10,0,49,53,1157
60432,20222,10229,223,925,163,121,772,150,9993
61250,2502,1215,14,78,46,23,101,33,1287
49780,1924,899,27,30,24,30,32,24,1025
52306,1679,726,0,57,23,7,62,49,953
59336,210,128,8,7,4,0,5,0,82
64458,142,83,0,10,11,0,10,2,59
72422,4549,2177,7,202,35,18,86,32,2372
74132,9252,4522,25,296,114,69,270,164,4730
70528,2581,1150,16,101,34,7,79,22,1431
71245,4922,2303,104,115,5,225,205,0,2619
71486,5344,2612,52,131,89,26,202,70,2732
71834,1206,511,9,16,0,64,33,24,695
99356,230,131,5,1,4,5,0,0,99
79021,151,82,0,7,0,0,0,0,69
79046,674,292,1,15,4,8,12,26,382
79235,3470,1678,20,111,11,0,115,54,1792
91501,20300,9889,106,939,162,106,719,238,10411
91978,10518,5229,62,361,38,41,234,176,5289
55454,10109,4961,175,265,29,192,102,32,5148
15433,735,462,16,64,5,0,0,0,273
17003,11543,5793,233,293,81,146,201,116,5750
17353,3456,1764,5,57,71,23,66,57,1692
33411,71587,34215,364,2376,834,605,2234,970,37372
20715,26768,12747,296,772,203,270,789,346,14021
21758,4912,2606,19,110,58,6,78,71,2306
23943,84,53,5,0,0,0,0,0,31
26038,3050,1436,23,43,71,0,101,105,1614
36027,15496,7474,38,301,199,75,449,245,8022
27938,1261,611,1,7,33,3,6,15,650
2907,30781,15262,279,1139,152,160,1174,224,15519
47869,94,52,0,0,0,0,0,0,42
49107,10340,5023,62,276,162,40,312,216,5317
41385,561,241,0,13,20,0,29,4,320
41636,995,573,0,0,20,0,0,0,422
42156,271,143,0,12,12,0,10,0,128
42701,50987,24611,457,1710,663,209,1846,729,26376
43913,1596,729,11,66,32,35,20,22,867
45787,63,20,0,0,0,0,0,0,43
46324,22039,11019,160,758,178,238,838,297,11020
37724,2426,1203,2,98,25,4,77,43,1223
50461,5583,2764,55,107,32,2,102,109,2819
35120,14055,7024,131,607,86,98,522,116,7031
36003,1898,862,0,31,32,7,24,18,1036
92155,490,474,54,1,0,4,0,0,16
80528,21259,10661,22,800,113,154,895,255,10598
80814,3426,1794,0,96,55,0,114,42,1632
83274,8946,4376,40,294,80,25,350,86,4570
1060,15779,6282,32,371,123,456,491,144,9497
37921,26807,12652,125,774,387,285,1040,284,14155
38387,236,114,0,0,0,0,3,14,122
39429,16435,8117,49,367,147,30,414,234,8318
58386,121,72,0,0,7,0,0,4,49
54165,7811,3866,17,152,134,120,188,117,3945
44001,21130,10249,88,578,339,47,580,434,10881
45629,2855,1558,26,48,33,9,94,0,1297
45719,1019,530,0,15,10,0,34,17,489
49640,1582,765,3,13,45,11,11,61,817
50578,584,303,2,41,9,0,11,2,281
41189,2076,1080,69,48,28,1,88,30,996
43078,20446,9913,131,461,209,166,620,223,10533
43433,85,16,0,0,0,0,0,28,69
61085,3629,1825,36,85,40,12,104,17,1804
61319,1434,792,21,52,19,8,41,53,642
61820,38156,20113,2076,906,30,1951,744,160,18043
62615,5712,2888,26,122,24,13,154,58,2824
48076,25220,11675,179,641,223,200,852,412,13545
32401,22566,10533,138,577,198,94,686,246,12033
32403,3374,1842,156,112,9,11,161,12,1532
21824,113,68,0,13,0,0,17,5,45
15691,78,0,0,0,0,0,0,0,78
16023,4633,2208,0,138,51,56,78,57,2425
12185,2262,1117,5,55,36,0,84,59,1145
12474,1082,595,0,51,25,0,48,0,487
24165,1350,585,0,38,19,12,49,38,765
25057,432,221,0,0,41,0,20,0,211
25524,3440,1625,0,166,31,25,161,49,1815
36853,7828,3803,25,157,149,57,94,193,4025
26638,89,20,0,0,9,0,9,13,69
27407,50288,24272,328,1581,445,749,1586,665,26016
97055,18392,8933,116,662,385,107,709,446,9459
17832,739,388,8,22,4,0,12,18,351
17864,2258,1175,10,56,29,23,60,20,1083
17901,23126,11394,136,784,313,204,650,306,11732
18224,6075,2738,16,80,134,0,198,46,3337
32708,44826,21704,353,1220,550,325,1265,563,23122
25876,94,55,0,0,20,0,0,20,39
25878,686,382,0,30,37,0,0,0,304
26562,510,243,0,29,11,0,5,0,267
31832,274,118,0,15,11,0,0,0,156
31901,6336,3257,99,152,30,50,79,162,3079
32084,34892,16545,397,1179,428,349,1010,559,18347
5866,695,353,3,24,11,6,15,13,342
7013,26950,12697,295,1071,276,221,837,394,14253
10962,5314,2789,39,168,57,22,99,68,2525
2466,8761,4027,151,225,71,194,252,91,4734
3054,25815,13050,177,828,368,94,954,528,12765
3813,2702,1373,0,95,82,13,44,52,1329
3818,3948,1925,16,121,47,3,162,42,2023
70463,172,84,0,12,0,0,13,0,88
71466,660,307,11,0,0,23,38,41,353
73169,2247,1055,0,52,38,49,58,30,1192
47885,8994,4396,33,186,100,125,225,125,4598
50448,623,317,0,21,6,0,10,46,306
50701,31102,15669,228,1061,317,143,931,307,15433
78214,26946,13336,242,841,177,138,751,105,13610
90803,32389,16004,183,1172,606,174,1071,462,16385
75116,20044,9845,52,736,195,276,508,124,10199
75132,1705,848,0,59,0,0,52,0,857
77489,36548,16928,138,1204,432,373,1159,648,19620
67341,300,185,0,14,10,0,7,22,115
84623,287,128,0,0,0,0,0,0,159
85554,624,360,0,17,41,0,17,0,264
86003,3,3,0,0,0,0,0,0,0
39083,9774,4812,162,377,78,138,340,87,4962
39562,17205,8565,147,525,143,53,475,292,8640
46766,865,514,0,0,10,0,7,8,351
65034,1024,437,0,20,14,7,25,0,587
66941,181,114,0,0,1,0,1,5,67
66960,159,78,6,0,0,6,12,3,81
61753,3058,1453,10,110,41,8,130,60,1605
56650,739,357,0,29,10,3,27,11,382
57036,632,313,3,15,18,4,17,6,319
78535,747,393,0,14,0,0,39,0,354
79936,112355,55631,1220,3394,625,1048,3039,1342,56724
70601,32201,14765,238,518,335,333,1104,332,17436
23395,532,156,0,0,0,0,0,0,376
25606,1466,586,0,24,25,0,52,0,880
13635,1177,558,10,14,0,4,39,10,619
13790,17875,8513,76,647,126,183,396,219,9362
16692,674,393,3,26,13,0,16,1,281
30545,698,351,0,8,7,1,4,3,347
22738,1587,712,0,91,0,12,58,0,875
10550,37817,17482,399,1042,238,185,1347,562,20335
10915,98,40,0,0,0,0,0,0,58
29609,29191,14252,102,882,273,158,942,382,14939
30062,66053,32661,325,2251,724,346,2171,806,33392
54407,1535,807,14,43,31,0,59,27,728
55763,534,284,0,8,10,0,10,25,250
37348,784,522,0,0,0,0,13,0,262
38023,7050,3520,43,197,130,0,325,21,3530
47003,937,496,0,21,30,0,12,5,441
47114,295,157,0,7,5,0,1,0,138
13166,5572,2838,20,148,63,29,148,82,2734
15492,115,66,19,0,0,0,0,0,49
67659,73,46,0,0,0,0,0,0,27
68019,394,207,0,4,14,0,0,12,187
72131,4739,2392,2,172,90,28,134,16,2347
72838,110,62,0,0,0,0,0,0,48
73149,5082,2524,40,152,34,64,161,107,2558
42234,2625,1308,0,93,13,0,95,0,1317
26704,5424,2986,20,71,106,5,152,116,2438
27828,9489,4325,0,349,158,88,351,224,5164
28734,26935,13003,135,795,365,102,716,428,13932
29301,35704,17757,302,1172,374,250,1004,605,17947
51444,289,150,0,10,8,0,10,2,139
94509,66933,32881,704,2249,673,416,2335,943,34052
79372,1209,615,9,40,7,0,50,6,594
14433,4350,2251,59,72,27,32,121,84,2099
16650,1897,997,7,41,34,0,42,55,900
6880,28234,13422,216,689,300,52,653,397,14812
11733,16545,8445,103,309,204,101,457,282,8100
12159,7845,3766,82,175,154,28,147,137,4079
19035,3903,1913,0,47,31,0,90,77,1990
84533,187,133,0,33,0,0,0,0,54
85710,54663,25573,402,1520,568,367,1556,681,29090
97267,32174,15605,227,863,592,108,1037,677,16569
4963,7257,3896,23,260,107,29,182,128,3361
4970,1427,760,16,17,32,5,12,39,667
6242,1308,725,24,57,23,10,12,25,583
27040,11803,5868,80,316,153,25,443,215,5935
27942,1045,462,0,28,47,0,72,4,583
32218,61846,29813,289,1624,434,388,2585,820,32033
32683,140,50,0,3,3,0,9,0,90
30519,46415,23283,227,1658,348,152,1275,553,23132
31520,23474,10611,129,559,194,130,979,361,12863
20712,9496,4565,90,394,129,45,316,58,4931
28636,5013,2586,9,121,133,0,49,44,2427
78648,8150,3948,111,233,44,41,113,70,4202
81635,6634,3469,5,237,110,3,190,38,3165
82081,98,57,0,18,0,0,17,0,41
70763,4279,1957,103,161,40,18,146,21,2322
72142,2508,1392,0,146,55,6,123,5,1116
73095,1911,1049,17,28,18,11,27,33,862
74021,19907,9940,146,635,153,92,618,201,9967
97536,932,523,0,27,54,0,3,16,409
93501,4861,2599,0,173,38,30,104,24,2262
83610,873,388,2,11,19,2,3,16,485
38927,1337,737,20,27,0,70,63,0,600
40108,11729,5803,88,368,88,76,293,132,5926
40988,390,194,0,0,0,0,0,0,196
43549,1310,672,0,6,9,19,38,24,638
54655,1880,941,4,38,19,10,35,38,939
56178,1911,990,6,75,13,33,45,10,921
46959,586,359,0,79,0,0,0,0,227
48074,9152,4450,69,260,162,89,240,46,4702
68447,567,273,0,5,22,0,14,23,294
59643,384,246,0,3,0,0,16,8,138
59930,506,224,0,0,18,0,0,6,282
61924,2258,1126,0,35,25,12,57,31,1132
58027,1319,651,0,40,25,0,30,19,668
63624,3867,1941,31,127,61,5,137,74,1926
72139,218,112,0,2,0,0,6,0,106
70646,793,429,0,89,0,0,40,0,364
1013,23065,10958,273,726,212,250,630,311,12107
1337,2498,1263,10,79,58,17,34,52,1235
95436,6352,3242,35,209,135,0,179,197,3110
95742,11921,6077,14,673,136,0,662,167,5844
96712,7575,3985,29,235,91,30,221,150,3590
92376,87027,43147,747,2619,463,855,3178,880,43880
94602,29933,14845,143,1143,447,97,1040,468,15088
38826,4941,2351,0,87,43,0,122,61,2590
45646,499,267,0,12,9,36,13,10,232
46155,185,143,0,0,0,0,0,0,42
36376,2224,1099,19,75,36,16,63,42,1125
36560,3381,1639,7,72,12,16,119,29,1742
32449,637,285,0,21,0,0,36,0,352
63742,66,33,0,0,0,0,0,0,33
17602,51069,25594,412,1357,556,318,1607,739,25475
72619,2097,934,7,25,25,0,25,53,1163
73760,341,176,0,13,1,3,14,3,165
51630,237,119,0,10,0,10,12,0,118
45884,158,93,0,23,0,0,28,0,65
46121,5716,2726,112,104,82,87,132,102,2990
49781,3614,1733,42,68,43,12,80,39,1881
52620,897,457,2,20,26,6,26,12,440
35146,11870,6349,10,338,95,93,358,141,5521
36066,19097,9497,47,683,121,100,705,252,9600
36608,35591,16554,311,1257,322,496,1195,389,19037
37686,8250,4331,30,144,131,122,272,75,3919
58833,80,57,0,0,6,0,0,0,23
59545,44,22,0,8,0,0,0,2,22
59718,35923,18997,381,1609,252,444,1495,509,16926
59912,14841,7258,63,472,163,21,533,336,7583
43060,2809,1410,0,62,30,4,95,30,1399
30809,45542,22332,330,1232,469,176,1384,548,23210
17850,793,460,0,50,13,0,24,12,333
19539,4819,2544,62,47,65,22,167,96,2275
12822,6123,3140,41,167,42,11,248,117,2983
16878,1816,878,12,34,12,7,50,22,938
28006,1076,572,0,33,33,13,22,14,504
22572,7010,4070,20,440,122,20,77,154,2940
26234,1281,615,13,0,22,0,15,44,666
3244,7892,4064,21,274,104,5,223,98,3828
4918,307,163,0,32,0,0,0,10,144
10310,23262,11065,142,715,284,151,780,304,12197
12009,8036,4287,104,229,47,19,340,112,3749
12018,7324,3857,41,107,121,0,138,144,3467
6107,18914,9226,39,532,237,26,532,354,9688
7067,18079,8613,89,558,264,127,573,230,9466
59314,82,40,0,0,1,0,0,1,42
63943,536,262,0,5,0,0,21,7,274
70437,8188,3947,0,335,62,53,314,65,4241
72032,33539,16056,340,999,316,402,989,366,17483
83706,32855,16752,289,994,364,499,982,390,16103
83872,563,288,0,34,0,0,17,0,275
87747,1423,681,2,49,29,22,92,29,742
97750,283,153,4,21,2,0,9,11,130
98122,38620,20511,490,2099,246,384,1222,353,18109
98644,342,205,0,0,0,0,0,0,137
95437,14632,7188,98,480,221,49,298,161,7444
80247,29105,13844,260,1049,183,331,1070,412,15261
29152,1827,945,29,43,0,0,42,0,882
29810,4224,1935,46,196,77,0,141,59,2289
30457,5885,3048,42,260,128,18,123,41,2837
31030,17701,8708,275,531,269,211,510,138,8993
37872,1633,752,14,29,28,10,38,35,881
44627,6829,3577,14,282,45,75,194,32,3252
45033,249,133,0,0,0,0,6,4,116
46216,2099,1023,35,39,14,0,27,36,1076
47524,459,280,0,7,32,0,13,14,179
54756,924,493,10,34,18,8,46,15,431
38647,827,375,0,14,0,0,42,7,452
39773,15695,7206,44,321,237,103,519,227,8489
31049,1856,924,18,60,24,0,38,6,932
32226,16013,8190,119,481,268,52,564,173,7823
44021,6244,2943,62,190,89,49,162,91,3301
45628,5082,2469,78,224,45,19,168,50,2613
95521,21462,10444,491,545,262,387,459,231,11018
95834,28229,13797,201,928,166,166,981,436,14432
97213,32845,16410,109,1469,491,25,1686,454,16435
76129,2920,1087,108,0,0,214,0,0,1833
78569,4092,2088,0,107,55,44,199,78,2004
68727,814,433,4,13,10,2,19,17,381
68763,4648,2442,41,117,80,23,155,47,2206
56251,902,454,6,14,5,13,38,11,448
50484,404,197,1,8,8,2,2,13,207
50515,260,139,0,2,3,0,20,11,121
53705,25167,12199,65,1033,193,83,1038,404,12968
63125,33031,15827,232,1090,288,286,919,481,17204
65261,770,427,1,12,11,0,8,10,343
45205,18533,9640,176,585,141,146,488,100,8893
72026,304,204,0,0,4,0,0,11,100
48854,19773,9871,107,712,221,111,610,370,9902
61370,1393,741,15,56,24,4,33,13,652
28516,11268,5274,56,263,254,30,217,199,5994
29111,1663,898,5,52,21,38,94,2,765
30269,35904,17351,161,911,457,99,1003,649,18553
21919,2696,1441,0,0,94,16,0,131,1255
33701,15209,7185,5,338,258,37,207,241,8024
72858,4239,2032,0,104,36,18,150,65,2207
73750,7485,3834,129,353,44,29,69,0,3651
73771,386,191,0,11,0,5,8,0,195
75050,42916,21507,366,1311,308,295,1465,413,21409
81025,722,411,2,15,13,0,19,2,311
94579,22040,11028,313,661,158,159,786,365,11012
95041,353,221,0,0,0,0,0,0,132
95354,24743,12395,144,940,261,211,793,274,12348
95633,3857,2052,0,138,85,0,195,31,1805
96074,174,104,2,10,0,0,3,0,70
96773,59,26,0,0,8,0,5,0,33
16114,639,347,3,17,12,3,39,8,292
10933,422,192,0,0,0,0,16,48,230
12154,2807,1514,21,77,30,0,95,29,1293
12792,205,125,0,20,7,0,0,0,80
12992,4517,2226,0,148,91,12,165,32,2291
19428,16853,8552,191,744,171,62,555,231,8301
21755,5581,2972,29,121,39,30,109,59,2609
24808,556,225,0,9,5,2,15,15,331
4653,607,249,0,26,0,0,31,13,358
75270,0,0,0,0,0,0,0,0,0
75416,3103,1545,23,32,28,62,46,7,1558
76869,100,55,0,2,0,0,0,0,45
78043,44838,21469,392,1393,223,582,1442,349,23369
84627,7357,3376,216,211,29,232,157,41,3981
78537,47346,23354,496,1563,136,329,1646,446,23992
78655,3480,1648,56,83,24,41,21,54,1832
79502,1272,666,0,6,9,0,26,28,606
97146,6457,3268,13,201,121,33,89,99,3189
95132,41844,20717,250,1384,450,238,1450,609,21127
91320,45520,22685,165,1267,662,167,1435,636,22835
99693,313,158,5,7,0,1,10,3,155
30214,29617,14118,191,543,337,157,544,412,15499
30904,25784,11987,72,747,250,267,925,295,13797
31061,43762,21833,733,1347,435,807,1313,599,21929
36273,3015,1525,2,103,43,0,103,75,1490
45864,168,75,0,6,2,0,5,0,93
46110,608,278,0,0,21,0,28,0,330
47458,28,18,0,0,0,0,0,0,10
4072,19342,9312,87,427,276,38,619,400,10030
4553,1704,823,11,61,10,12,74,23,881
2542,909,519,0,42,0,0,39,0,390
22437,1192,484,0,118,30,0,92,0,708
13613,2574,1301,0,110,64,5,92,66,1273
15025,16265,7698,68,507,188,32,616,286,8567
15027,2221,1049,0,60,39,12,87,26,1172
16210,974,482,16,33,4,4,15,6,492
6812,13992,6975,31,391,109,132,273,335,7017
92532,25475,12362,149,1027,238,113,1383,399,13113
92705,46470,23295,326,1352,446,291,1498,466,23175
95458,3019,1625,6,81,25,24,44,69,1394
97266,34953,17795,170,1293,344,92,1497,350,17158
97903,137,43,0,0,0,0,0,10,94
98576,5121,2629,60,208,41,11,139,53,2492
87939,128,52,0,0,0,0,0,17,76
99677,78,34,0,0,0,0,0,0,44
62243,5795,3058,33,167,65,41,127,155,2737
78639,8409,4089,111,118,78,30,131,239,4320
80130,28932,14536,194,912,264,78,1105,263,14396
69138,4184,2084,53,90,14,10,72,67,2100
73544,241,104,1,1,2,0,2,2,137
77505,24022,12219,187,687,280,167,587,351,11803
84734,281,146,0,17,0,0,14,0,135
85233,35284,16588,173,1096,313,235,1000,335,18696
86025,5660,3029,52,200,67,41,165,105,2631
59026,165,102,0,3,11,0,4,6,63
59221,1870,938,0,29,14,8,66,34,932
60030,36817,18255,275,1125,288,206,993,404,18562
57702,34801,17125,153,987,464,109,911,638,17676
49854,6194,3039,50,162,94,11,79,148,3155
41317,84,26,0,0,0,0,0,0,58
33815,14328,7412,54,299,243,64,481,287,6916
44645,2299,1199,11,43,22,15,49,22,1100
45034,1273,740,0,51,12,0,15,16,533
45896,1839,925,18,24,5,25,47,19,914
52048,387,195,3,10,8,0,7,7,192
52556,13653,6714,124,417,310,45,267,207,6939
54229,4886,2476,22,188,53,4,198,82,2410
61748,2720,1298,25,84,16,13,109,12,1422
61853,13981,6697,25,404,113,23,465,137,7284
62025,34313,17047,349,858,265,663,922,425,17266
70773,224,83,0,0,10,0,0,0,141
70791,26719,12763,98,894,202,170,994,302,13956
75762,12697,6173,0,320,310,0,355,101,6524
75954,2698,1441,2,55,39,15,46,57,1257
76008,17910,8937,20,623,234,43,746,125,8973
65064,465,218,0,0,12,21,0,0,247
58274,978,499,6,6,10,3,24,6,479
59871,298,167,0,9,4,0,0,4,131
68424,667,339,0,9,18,0,8,14,328
19436,639,265,0,15,0,0,0,18,374
15473,3891,1981,42,136,81,8,155,58,1910
25972,329,188,0,0,25,0,0,0,141
27886,20450,9722,116,508,385,35,643,351,10728
28348,35673,16869,283,1259,226,63,1429,389,18804
28395,2466,1281,27,66,25,13,79,56,1185
30228,42259,19440,274,1260,466,231,1391,514,22819
37204,14768,6733,188,512,102,271,483,164,8035
44609,3935,1781,4,129,50,19,116,83,2154
47638,3483,1838,19,125,23,18,158,38,1645
54888,1288,639,2,29,18,3,16,34,649
54944,9145,4847,69,307,103,24,295,94,4298
55337,45158,21922,369,1589,433,364,1618,657,23236
49831,871,452,0,31,6,3,26,16,419
52580,654,308,0,5,11,0,12,4,346
13669,15782,8553,60,643,207,41,380,296,7229
14585,95,41,0,0,0,0,0,0,54
14615,16613,8136,172,756,149,89,921,216,8477
20743,39234,17945,215,1259,335,232,1527,701,21289
22660,1955,810,0,70,30,0,87,35,1145
23923,2499,1341,69,107,41,39,19,71,1158
24016,8378,4478,31,243,33,24,128,106,3900
4250,4050,2065,68,207,45,38,98,44,1985
6776,26049,12749,115,710,180,177,679,596,13300
8302,45352,23686,309,1515,454,229,1357,563,21666
29404,1981,1072,66,60,0,14,26,0,909
12496,1463,754,0,46,32,7,32,4,709
13145,1566,785,14,30,15,21,45,20,781
27403,22569,10473,727,416,179,557,610,256,12096
76531,4740,2341,0,82,59,9,126,65,2399
77432,103,54,0,0,0,0,12,0,49
80833,729,327,0,16,4,0,18,28,402
83844,1906,986,41,0,0,91,0,0,920
84021,3992,2138,46,125,54,4,121,37,1854
85626,1086,575,0,0,0,0,0,0,511
66411,1274,632,14,25,13,21,56,30,642
15053,116,58,0,0,0,6,0,0,58
4434,1121,529,0,44,27,8,28,9,592
4756,3207,1551,26,48,43,37,32,68,1656
5819,9145,4595,37,241,104,43,276,169,4550
75977,395,216,13,0,0,0,0,7,179
76351,2047,922,21,92,49,0,48,73,1125
88005,27284,13327,313,759,314,273,709,427,13957
99359,142,90,0,0,7,0,8,4,52
93312,60238,29886,537,1781,657,470,2155,417,30352
93666,952,437,0,26,0,17,33,0,515
94708,11455,5600,37,239,234,0,356,194,5855
48602,30043,14904,126,985,319,234,1035,288,15139
8349,1658,722,16,20,39,0,56,10,936
8542,5927,3320,138,134,60,224,134,93,2607
10537,2106,975,0,16,51,0,90,13,1131
25211,210,139,0,0,0,0,0,0,71
12851,368,206,0,5,8,0,13,2,162
12860,597,347,9,5,27,10,2,0,250
13116,3504,1465,43,71,39,107,14,96,2039
13140,4509,2255,75,144,42,22,169,46,2254
28452,934,390,0,40,0,0,31,0,544
27356,2746,1425,0,59,36,13,54,20,1321
28159,2908,1488,38,105,14,0,73,26,1420
65536,29232,14227,126,701,297,150,833,403,15005
65785,5012,2602,1,180,68,30,229,83,2410
59332,207,105,0,3,0,0,0,3,102
59870,10121,5358,46,300,247,11,364,166,4763
60558,13227,6317,11,455,99,39,390,327,6910
62447,3615,1771,0,80,34,24,94,27,1844
37614,1942,902,104,0,0,203,4,0,1040
97209,17585,9539,128,897,398,0,826,165,8046
77651,12853,6422,39,414,188,82,622,138,6431
78124,6353,3130,18,182,109,23,184,65,3223
78261,17127,8632,89,929,152,26,754,131,8495
93626,1983,906,10,64,29,10,59,39,1077
94601,52299,26145,195,2091,458,420,2140,449,26154
82642,53,19,0,0,8,0,0,0,34
75474,14744,7016,99,430,244,70,479,308,7728
75976,680,295,0,25,0,0,21,7,385
85735,11274,5604,62,377,202,102,357,234,5670
64643,1202,632,3,43,14,12,34,17,570
47351,507,226,1,17,0,0,13,6,281
47578,835,384,0,5,16,9,25,9,451
48045,24999,12020,258,692,237,149,724,641,12979
48221,41821,18902,176,1069,370,329,1455,549,22919
40506,2544,1061,144,0,0,38,0,5,1483
37082,6479,3105,30,210,80,86,195,70,3374
60926,35,16,0,0,0,0,2,0,19
62640,3583,1666,15,113,53,7,93,58,1917
55749,410,220,2,21,4,0,7,4,190
53579,1776,940,8,94,30,14,61,17,836
43971,1100,558,7,30,21,3,27,11,542
44512,32763,15577,252,690,511,184,912,563,17186
3751,583,320,0,0,0,0,0,5,263
4910,2050,1006,20,76,19,0,61,27,1044
14174,5475,2898,20,176,102,19,94,135,2577
23301,1580,718,3,8,4,0,17,15,862
23893,222,93,0,0,19,0,0,17,129
10168,0,0,0,0,0,0,0,0,0
11219,90036,44986,691,2560,858,729,2576,847,45050
22747,872,382,0,5,9,0,50,16,490
28203,15946,7582,19,793,5,19,738,133,8364
17829,230,125,0,5,0,2,5,1,105
18083,447,219,2,16,0,0,15,15,228
29685,1704,897,46,37,31,8,33,19,807
77059,16944,8620,80,637,205,55,462,369,8324
79851,1428,808,23,43,0,21,0,51,620
53058,3293,1635,4,87,36,12,70,32,1658
54227,1570,796,5,62,24,5,19,25,774
64762,1538,781,8,70,15,3,56,24,757
65753,5124,2486,36,133,65,103,209,49,2638
66226,14143,7041,74,474,161,75,497,98,7102
71104,14479,7283,89,551,61,190,435,216,7196
71425,172,100,0,30,0,7,0,0,72
56287,78,36,2,3,0,0,8,0,42
57269,290,172,0,11,4,0,6,4,118
57301,18465,9283,130,565,178,66,443,182,9182
57328,1114,508,1,22,0,0,16,53,606
57337,165,73,0,12,6,0,0,4,92
73658,222,131,0,0,10,14,6,2,91
74759,1454,745,5,48,12,3,70,22,709
30807,70,18,0,0,1,0,6,3,52
31787,1566,708,1,42,17,0,72,40,858
32195,2986,1346,20,35,43,43,57,15,1640
32625,1626,838,0,40,31,19,71,31,788
50136,399,194,6,5,9,2,4,7,205
50570,224,115,0,4,0,0,0,0,109
50636,1723,897,8,38,5,15,49,38,826
51241,1830,970,24,52,29,0,51,31,860
53190,19279,10018,1125,308,134,806,356,175,9261
54627,1720,912,7,44,37,9,46,29,808
55006,3902,1971,19,116,41,14,104,61,1931
55074,2378,1214,8,97,10,3,86,26,1164
57015,824,424,7,44,8,0,34,4,400
41859,355,157,6,13,7,0,11,15,198
44697,204,99,0,1,0,0,0,0,105
39367,14985,7621,35,320,255,148,566,286,7364
40481,143,60,0,0,0,0,0,0,83
30259,2886,1381,23,67,48,0,69,64,1505
30296,28671,12883,198,994,249,293,1043,430,15788
30815,40347,18476,375,1374,477,499,1426,563,21871
31560,2853,1433,0,128,26,0,68,42,1420
32141,18828,9430,111,316,285,87,434,274,9398
33609,18413,9444,67,565,122,127,492,282,8969
47324,162,70,0,4,3,1,10,7,92
41257,539,232,0,20,32,13,59,0,307
8882,16024,7928,176,829,158,124,496,186,8096
45885,12741,6340,40,322,187,138,304,162,6401
50854,2587,1212,11,75,38,13,57,55,1375
14420,20925,10354,282,436,213,594,425,275,10571
16361,35,13,0,0,0,0,0,0,22
30520,5179,2511,36,138,38,13,168,40,2668
31096,7046,3954,196,295,97,26,200,78,3092
72404,26394,13201,159,1353,109,263,1139,328,13193
73134,5573,2341,42,306,87,54,326,0,3232
11530,28454,13759,226,705,275,158,646,467,14695
69021,1418,686,6,37,10,0,19,17,732
11779,38063,18793,251,1300,357,319,1277,502,19270
90277,34506,17127,54,1083,322,78,1386,545,17379
12750,417,211,0,40,0,0,15,0,206
70645,1421,709,0,0,22,0,37,22,712
28009,1221,523,19,42,28,17,36,20,698
91361,20443,9706,70,610,278,52,498,423,10737
41832,364,149,0,0,0,0,22,34,215
98439,5357,2827,27,261,18,46,243,51,2530
730,31634,15371,253,900,403,295,840,469,16263
99720,174,100,0,6,3,2,6,0,74
19492,344,118,0,0,7,0,5,4,226
97449,2074,1046,30,68,110,0,15,34,1028
5857,2357,1136,0,28,27,7,77,60,1221
71944,811,407,7,22,5,18,35,3,404
59740,289,135,0,6,0,0,0,11,154
30513,11753,5435,102,225,334,57,347,330,6318
33404,28717,13423,177,577,234,215,663,414,15294
60051,23298,11641,114,889,280,120,758,371,11657
83852,914,405,0,43,8,0,33,12,509
37058,7758,3734,60,213,109,0,206,142,4024
38152,988,329,67,0,0,73,0,0,659
85017,41993,20087,495,1425,124,446,1544,267,21906
47464,221,121,2,0,7,0,2,3,100
75642,71,34,0,0,0,0,0,0,37
25630,653,356,0,20,25,0,39,0,297
26266,165,108,0,0,0,0,0,0,57
55962,752,414,3,32,6,3,17,12,338
91776,38410,18533,363,1389,334,352,1084,611,19877
50236,1472,682,0,43,29,17,33,21,790
98030,37808,18384,244,1091,244,159,1345,430,19424
72959,2864,1519,48,56,40,11,38,15,1345
73014,1937,982,14,58,24,12,39,19,955
74738,686,380,18,17,15,0,20,11,306
95720,83,37,0,0,0,0,3,2,46
95818,21732,10472,87,662,235,85,779,273,11260
66449,996,480,9,49,27,4,51,19,516
66780,524,321,0,3,0,0,14,0,203
67210,9722,5292,97,214,72,14,262,82,4430
68507,14332,7141,86,393,119,66,539,193,7191
69220,20,11,0,0,0,0,0,0,9
70542,3633,1827,31,179,48,11,61,49,1806
30034,46214,20346,261,1200,471,309,1298,903,25868
48881,5874,2952,20,217,135,55,209,66,2922
49075,115,45,0,0,0,11,11,0,70
56215,4338,2127,15,111,53,4,166,55,2211
75831,5494,2626,34,166,46,7,145,130,2868
14058,1951,959,4,50,26,16,54,37,992
6384,2759,1357,25,23,31,14,66,64,1402
18211,1412,691,0,19,13,0,17,0,721
19010,21027,9229,318,506,226,380,485,237,11798
4783,508,238,2,7,3,0,3,13,270
8884,8293,3989,44,297,72,59,261,177,4304
62921,394,175,0,11,2,2,40,6,219
63036,875,466,0,0,7,20,8,15,409
745,51429,24828,685,1464,557,227,1610,498,26601
1245,809,377,0,13,19,7,26,17,432
19540,11423,5726,106,327,91,55,271,192,5697
29204,18709,8732,270,435,277,199,446,347,9977
12484,2671,1391,0,39,85,24,94,72,1280
12760,416,233,0,14,10,0,12,10,183
27563,4762,2446,7,171,66,13,46,49,2316
45873,2263,1188,7,36,52,4,31,36,1075
46914,1484,832,12,42,32,7,28,41,652
46917,1657,847,2,41,23,0,30,19,810
49066,648,304,0,35,8,0,37,22,344
40370,3000,1515,2,62,29,0,97,22,1485
40923,452,175,12,0,0,0,0,0,277
43223,25963,12932,196,919,219,242,825,189,13031
37916,12760,7017,1114,0,0,1395,15,0,5743
38231,1555,709,0,28,26,0,24,2,846
38773,3046,1490,10,36,42,0,107,41,1556
38866,11617,5752,102,393,116,140,626,141,5865
56047,127,67,0,5,0,0,6,4,60
57063,912,441,9,12,37,6,14,22,471
44889,7071,3404,37,198,178,22,240,116,3667
45067,14970,7360,181,514,119,98,511,189,7610
45122,10511,5321,41,337,96,12,234,206,5190
44816,16,16,0,0,0,0,0,0,0
44825,102,44,0,0,0,0,0,2,58
45415,13519,7015,59,424,300,68,306,220,6504
57108,22449,10736,71,867,156,18,745,366,11713
57424,249,141,0,13,7,2,14,8,108
41255,1188,651,0,32,11,0,34,38,537
43146,12275,7928,97,944,113,43,285,60,4347
43516,2742,1306,18,97,30,18,115,32,1436
4563,1529,778,0,58,28,6,23,6,751
98405,23278,11058,240,1141,248,210,750,299,12220
99929,2484,1302,11,47,23,9,43,47,1182
81222,460,144,5,0,9,0,33,8,316
82936,0,0,0,0,0,0,0,0,0
75844,6001,2887,85,124,69,12,221,183,3114
76253,294,144,0,8,9,0,17,0,150
95554,287,148,0,16,6,0,8,0,139
96028,1359,671,0,76,0,0,175,0,688
78626,33626,15829,174,1268,254,336,1352,502,17797
90048,22892,10745,41,1272,267,0,1102,224,12147
92408,14434,7618,127,669,176,106,457,112,6816
70450,2506,1263,11,45,21,0,121,43,1243
71631,382,184,0,9,0,0,0,0,198
13326,5584,2644,8,134,79,30,149,139,2940
11780,15753,7736,110,222,135,63,321,233,8017
6469,2904,1417,24,86,79,9,82,62,1487
16928,1375,701,16,21,10,1,25,21,674
1608,3639,1590,44,35,13,62,157,75,2049
43524,1302,713,0,36,25,0,26,14,589
43606,25219,11879,209,502,250,464,703,428,13340
43612,29686,14460,179,1015,146,94,943,311,15226
27298,10052,5005,54,288,125,87,307,139,5047
27542,9953,4953,86,249,111,59,405,172,5000
32254,13039,5799,84,388,89,54,389,218,7240
33055,43405,20209,171,1173,363,304,1971,384,23196
48346,23478,11350,253,765,210,118,686,463,12128
15557,3427,1671,20,93,43,15,74,26,1756
15744,162,94,4,4,4,0,11,7,68
8061,2943,1310,27,127,22,0,162,28,1633
11572,29846,14653,78,818,397,82,970,382,15193
12441,68,34,0,0,0,0,0,0,34
13612,2322,1223,0,109,15,14,78,41,1099
14537,114,63,13,0,0,0,10,0,51
14609,42042,19931,284,1278,464,248,1685,656,22111
15018,849,427,0,16,14,0,23,22,422
1501,16549,8071,58,484,244,126,395,312,8478
1748,17178,8410,26,533,144,81,502,195,8768
76114,25416,13204,197,847,262,232,975,370,12212
78070,16241,8508,97,446,268,40,385,260,7733
58725,425,180,0,6,0,1,17,0,245
59404,27618,14015,80,878,359,123,865,367,13603
15679,2692,1309,18,77,36,21,69,45,1383
19503,1379,684,3,49,17,1,116,2,695
7436,13009,6225,94,358,91,102,421,203,6784
12031,182,90,16,6,0,0,6,3,92
35582,4444,2117,44,104,17,0,126,77,2327
26104,15983,7629,49,380,246,90,534,377,8354
42028,850,434,0,24,0,0,21,0,416
39307,17145,9024,202,612,97,191,236,135,8121
29681,57959,28598,214,1875,557,283,2142,703,29361
32907,44097,21107,255,1168,490,411,1539,526,22990
32127,30415,14613,162,455,598,139,627,592,15802
86031,1704,830,14,30,15,14,32,24,874
86038,26,18,0,0,0,0,0,0,8
76227,32000,15566,112,1415,151,127,1427,255,16434
76363,523,263,9,17,8,0,19,13,260
94563,19341,9367,148,382,340,35,474,297,9974
95017,603,314,0,5,9,0,13,12,289
95250,0,0,0,0,0,0,0,0,0
89004,347,195,0,0,11,0,5,6,152
35078,1919,899,19,53,0,12,53,44,1020
49070,2609,1356,22,83,12,24,72,32,1253
18053,2145,1098,0,54,17,0,39,6,1047
18615,2027,1024,7,37,14,23,48,25,1003
19154,34253,16730,180,1253,286,165,999,610,17523
6412,4268,1814,26,52,43,13,111,26,2454
28480,2536,1490,62,64,16,5,55,22,1046
12823,472,210,0,0,0,0,0,31,262
23442,915,391,16,33,6,4,37,10,524
19952,10629,5043,13,350,105,8,307,108,5586
26581,913,436,21,32,15,0,19,9,477
27614,33287,15346,89,1170,323,5,1151,587,17941
94957,1400,723,0,31,0,0,33,31,677
95334,16787,8229,193,635,129,133,571,162,8558
95988,8381,4179,8,287,93,139,338,101,4202
92129,54986,27006,235,1529,511,246,2074,678,27980
98325,1474,834,21,39,35,2,52,37,640
98388,6639,3460,55,243,44,30,272,81,3179
2071,1696,1298,17,76,17,0,17,17,398
3268,1134,586,13,24,26,0,30,29,548
63072,3306,1583,27,41,34,32,80,108,1723
78881,2122,1034,16,41,8,0,48,43,1088
79382,7243,3674,14,264,59,0,380,62,3569
79772,13875,8095,38,721,154,126,553,75,5780
80239,47489,23066,187,1822,319,322,1826,413,24423
81434,244,162,0,0,0,0,13,0,82
84626,197,78,2,0,4,0,0,5,119
58218,953,475,0,47,23,0,34,12,478
68045,1831,881,0,36,13,14,37,20,950
68448,391,183,0,2,9,0,11,3,208
73004,1013,484,11,60,4,9,50,14,529
74741,997,516,3,10,7,22,20,8,481
76013,33760,16163,326,967,224,504,898,599,17597
76367,14917,10198,121,1063,71,54,451,96,4719
77446,6116,2561,265,35,8,437,36,56,3555
51638,1318,610,3,33,28,9,26,25,708
52154,843,419,0,15,16,0,19,4,424
53003,178,109,0,0,0,0,0,0,69
54313,38120,18264,113,1324,385,161,1278,558,19856
38242,20275,9694,92,558,291,146,727,233,10581
39110,42442,20587,191,1606,299,134,1901,691,21855
44010,1555,695,0,10,48,13,50,32,860
47437,148,83,0,0,15,0,0,0,65
48228,55737,26832,539,1183,534,292,2020,474,28905
61115,22574,11105,67,754,152,80,695,374,11469
56360,3729,1889,9,99,35,0,127,36,1840
57197,936,398,27,0,0,77,0,0,538
49917,222,97,0,2,7,0,6,6,125
51055,1608,761,0,19,32,18,60,43,847
4359,286,134,0,0,0,0,0,0,152
5494,1823,942,0,79,37,0,48,25,881
680,46395,22051,523,1041,598,315,867,728,24344
14555,1064,553,0,14,27,0,27,24,511
30756,138,72,0,0,0,0,0,0,66
31516,14541,7212,18,575,51,51,521,180,7329
33774,19108,8764,53,575,213,30,626,399,10344
24175,7901,3897,89,214,126,12,190,92,4004
44230,8549,4017,17,131,144,73,158,162,4532
50641,1611,847,4,45,18,8,57,33,764
20057,3841,1832,262,2,4,242,0,0,2009
18014,11217,5605,24,279,174,6,272,215,5612
18823,270,136,0,4,5,5,6,21,134
12033,7924,3746,30,219,179,46,193,133,4178
12766,452,204,0,0,11,0,21,0,248
29175,546,273,0,0,0,0,23,8,273
29472,9242,5490,38,482,123,17,190,102,3752
74456,186,79,0,7,0,3,7,0,107
28658,27479,13464,165,613,357,74,894,394,14015
11963,7430,3608,7,204,67,12,183,103,3822
78934,6394,3281,52,145,212,87,207,77,3113
91304,53761,26700,266,1715,469,184,1489,777,27061
37051,3253,1604,81,39,4,0,42,61,1649
98036,39766,19645,191,1402,311,262,1364,553,20121
43620,5863,2590,50,97,71,52,129,50,3273
98537,2019,1049,0,79,24,3,70,46,970
96064,4769,2491,23,120,68,25,128,80,2278
28399,1990,944,0,20,55,19,53,63,1046
44663,24914,12233,258,923,173,144,453,388,12681
31808,6961,3392,60,185,88,58,464,205,3569
32223,24039,11904,128,445,281,83,601,524,12135
33405,20537,10324,40,886,166,178,555,188,10213
20007,27562,12802,631,925,137,398,1053,307,14760
20535,0,0,0,0,0,0,0,0,0
58265,447,252,0,26,7,0,6,1,195
61344,376,196,2,0,1,8,7,4,180
68975,156,86,0,0,0,0,17,0,70
70736,471,267,0,0,0,0,0,8,204
77412,55,32,0,0,0,0,0,0,23
64747,3599,1759,9,37,48,66,117,52,1840
66943,587,326,0,50,2,3,38,2,261
57640,161,110,0,0,0,0,14,2,51
64163,748,358,2,5,5,0,21,12,390
72417,5024,2612,69,86,22,40,41,26,2412
72628,914,483,0,38,22,0,11,15,431
80421,9365,4818,0,345,257,28,225,168,4547
83025,631,286,0,0,0,0,95,0,345
75160,25317,12130,58,895,294,292,874,358,13187
75220,43088,23302,242,1960,143,254,2027,211,19786
89040,3632,1704,0,90,38,9,115,55,1928
91791,34363,16508,218,1010,270,285,1119,593,17855
93286,9755,4856,45,300,111,84,320,157,4899
95681,1148,682,0,48,45,0,23,0,466
96038,827,420,0,23,10,0,17,0,407
97032,5131,2584,9,144,69,0,146,73,2547
3275,11542,5701,14,377,142,78,466,143,5841
7054,29516,13920,106,1050,339,203,1082,337,15596
2054,8202,3925,14,181,175,22,176,151,4277
53578,6275,3162,17,216,47,4,231,51,3113
43213,33551,16037,207,1220,387,197,1222,327,17514
37208,17582,7850,119,592,92,228,584,290,9732
38756,6085,2984,43,171,63,37,181,84,3101
21093,37917,18512,113,897,413,75,1117,589,19405
21867,10,0,0,0,0,0,0,0,10
23320,56765,27095,417,1899,501,259,2022,584,29670
23322,65603,34480,340,2710,669,415,2323,900,31123
23883,2009,995,38,48,35,0,36,17,1014
49242,14941,6977,136,417,184,288,385,195,7964
57221,742,343,11,7,10,13,11,13,399
58626,349,191,0,23,9,0,0,4,158
72645,2006,1144,28,19,53,0,57,21,862
74442,901,450,8,20,9,0,33,13,451
50514,1443,698,4,37,49,5,46,21,745
16671,512,246,3,14,6,11,16,7,266
36587,9475,4601,60,209,130,15,290,93,4874
83871,2101,1014,5,38,52,3,49,52,1087
84055,1391,710,31,74,21,0,55,38,681
39501,23211,11225,182,775,254,246,453,342,11986
85023,34488,17351,206,1327,362,228,1135,402,17137
74875,1268,595,0,50,38,7,36,15,673
26037,6457,3332,31,185,99,29,143,162,3125
90047,48883,21536,287,1360,483,456,1542,796,27347
91745,54975,27480,387,1551,585,290,1774,837,27495
49728,291,163,0,17,5,0,13,4,128
53032,4833,2461,7,208,19,11,156,55,2372
99506,7029,3865,349,181,10,91,231,0,3164
74562,917,465,0,46,17,0,20,11,452
93252,2738,2006,37,174,36,0,18,14,732
28743,1987,938,6,15,43,40,15,30,1049
48359,9603,4740,39,290,88,37,395,103,4863
11433,36489,16723,314,1053,401,248,1172,651,19766
12919,3121,1491,19,51,20,14,50,27,1630
56304,16641,8962,311,499,184,297,552,219,7679
56511,1907,971,15,62,22,17,63,23,936
48650,7157,3658,83,286,129,17,185,108,3499
67487,1381,700,0,57,17,0,55,6,681
57631,421,221,0,8,9,6,16,8,200
63043,22524,11215,87,789,196,248,747,174,11309
72638,7202,3723,42,202,113,94,176,62,3479
84751,1991,1031,18,66,10,37,63,31,960
85551,389,194,0,12,7,6,9,3,195
70452,13111,6267,48,281,112,93,352,175,6844
71456,1523,933,111,9,33,0,33,7,590
84762,236,97,0,0,0,0,0,0,139
85705,56450,28107,709,1940,518,817,1892,764,28343
70814,14363,7067,94,645,261,158,676,166,7296
62938,3027,1630,0,99,39,1,108,33,1397
62947,449,266,0,51,0,0,6,0,183
35545,122,62,0,0,0,3,0,2,60
90260,35161,17989,293,1432,249,317,1533,579,17172
49659,6674,3306,37,160,43,52,163,136,3368
30124,2896,1490,38,76,57,19,60,46,1406
50126,6754,3363,16,157,102,0,86,77,3391
43780,1697,894,6,12,1,0,22,80,803
27330,39279,18833,163,1359,413,319,1169,493,20446
45236,24486,11617,72,901,257,83,793,352,12869
34217,5127,2263,5,32,97,33,123,139,2864
98941,644,312,0,20,3,5,12,4,332
43064,14243,7166,69,465,114,58,589,46,7077
85927,132,57,0,0,0,0,0,0,75
83223,98,52,0,7,0,0,7,0,46
23899,323,175,0,11,9,0,6,5,148
83340,4826,2414,41,52,127,0,84,95,2412
7110,28428,13782,86,1185,191,154,1133,319,14646
37909,15863,7699,372,618,157,156,447,152,8164
17225,20068,10088,67,541,299,120,727,218,9980
38726,559,223,2,14,4,0,21,7,336
10803,12544,6199,43,332,87,30,468,129,6345
39066,4367,2210,27,137,62,31,107,114,2157
13744,1143,609,0,36,46,0,6,16,534
40210,14307,6589,59,409,260,56,471,301,7718
26074,1242,576,55,21,2,60,12,0,666
57750,224,100,0,11,0,0,3,0,124
2360,59133,28589,441,1459,850,323,1793,873,30544
61042,605,321,6,10,0,0,0,14,284
62942,558,293,0,19,6,0,17,12,265
69140,1910,992,0,69,20,0,53,20,918
88324,268,73,0,7,11,0,6,0,195
23661,12830,6350,55,396,136,49,304,223,6480
78653,22804,11346,86,1038,213,123,908,106,11458
79748,250,146,0,14,0,0,6,2,104
16352,257,148,0,11,8,4,0,3,109
12028,929,461,0,18,20,16,50,17,468
4042,4553,2261,0,147,103,11,101,67,2292
25690,292,161,0,0,0,0,0,0,131
5853,512,248,0,19,6,4,10,22,264
27409,17532,8492,83,670,118,33,608,237,9040
95428,2563,1376,4,73,41,3,94,60,1187
36585,1031,534,0,0,20,0,98,3,497
38449,2494,1284,2,111,22,11,89,55,1210
21641,102,37,0,0,0,0,6,0,65
94585,29599,14439,291,897,202,185,1051,444,15160
17550,889,373,0,14,0,0,38,0,516
45345,6458,3038,0,163,84,51,27,114,3420
35215,48483,22012,191,1138,168,208,1634,764,26471
61101,19546,9846,109,409,164,112,419,180,9700
63751,1398,743,0,26,29,22,41,53,655
30144,55820,26625,742,1424,480,1042,1656,518,29195
47615,1756,753,4,40,7,51,33,45,1003
12523,1512,820,0,33,23,0,42,19,692
49948,530,297,5,10,17,0,9,11,233
50036,16455,8112,235,623,177,99,390,221,8343
49820,247,118,0,7,0,3,0,17,129
97404,34390,16779,174,1271,442,204,1281,534,17611
90717,21696,10601,112,645,269,0,861,189,11095
89124,1051,589,3,8,4,0,49,45,462
97029,335,170,4,13,10,0,13,0,165
97135,827,418,0,0,25,0,34,50,409
77420,2161,892,4,86,75,0,155,11,1269
2122,25059,12434,206,952,201,122,1011,334,12625
77973,0,0,0,0,0,0,0,0,0
67215,6128,2940,42,139,61,20,215,63,3188
24375,1697,871,12,50,5,8,71,43,826
21850,3096,1582,11,63,27,8,58,19,1514
67701,6380,3072,22,202,13,63,133,74,3308
68875,689,353,0,31,3,0,46,16,336
29624,16094,7549,149,470,184,87,469,247,8545
76357,622,296,0,19,0,12,12,14,326
37328,1270,639,0,11,47,0,14,32,631
37709,4151,2072,26,80,57,17,140,85,2079
18462,361,171,0,10,10,0,2,9,190
18942,3185,1760,0,70,54,34,77,6,1425
20132,18617,9373,164,500,165,64,710,201,9244
20680,745,426,0,28,10,32,45,13,319
23021,176,105,0,0,0,0,0,0,71
24150,769,369,0,0,27,0,0,39,400
25811,41,10,0,0,10,0,0,0,31
25969,1177,621,0,34,8,9,70,10,556
41735,195,92,0,16,0,0,15,0,103
42323,881,471,0,0,0,43,30,0,410
43416,2989,1620,24,102,57,9,95,109,1369
27819,294,124,0,8,0,0,6,6,170
28394,5303,2832,68,189,57,31,206,29,2471
60475,9674,4819,19,268,102,69,343,34,4855
66071,12524,6047,19,229,151,0,225,181,6477
62626,7710,3792,67,277,118,42,218,123,3918
63782,306,179,0,0,0,5,0,13,127
64150,3313,1691,44,102,37,0,102,41,1622
47842,9612,4891,22,351,68,30,273,116,4721
49095,2146,1053,15,57,40,13,76,48,1093
73945,2884,1404,35,73,26,12,56,10,1480
97532,2525,1267,0,52,50,18,77,57,1258
72531,1037,509,31,16,37,0,11,0,528
75448,724,389,0,19,0,0,13,8,335
49815,335,186,4,3,0,3,4,13,149
52257,241,130,0,6,0,0,2,14,111
62886,280,136,0,10,0,0,12,0,144
64078,9701,4982,89,403,34,36,356,185,4719
54650,24143,11606,197,668,208,61,698,309,12537
78565,112,61,0,0,0,0,0,0,51
95370,27951,13474,126,709,506,177,673,474,14477
95604,87,42,0,18,0,0,11,0,45
95670,54648,27214,435,1802,466,174,1960,608,27434
97396,3298,1664,41,135,40,3,105,81,1634
98580,11195,5491,87,315,191,123,314,263,5704
99169,2428,1255,0,37,30,29,50,22,1173
88348,348,141,0,0,25,0,13,22,207
89511,25690,12723,151,777,486,73,672,501,12967
78017,5498,3606,168,302,14,40,47,18,1892
29329,247,150,72,24,0,20,8,8,97
30341,32341,17045,74,1353,209,240,1593,179,15296
30504,26966,13701,402,910,176,185,1054,199,13265
30742,7842,3522,25,250,85,59,231,52,4320
6525,8868,4383,22,200,87,22,302,141,4485
37854,12871,6128,0,336,129,59,195,215,6743
45360,453,236,0,20,4,10,21,11,217
37853,3556,1763,39,133,50,36,94,68,1793
98026,36729,18238,181,1028,380,166,1413,676,18491
55007,2385,1245,30,48,27,0,66,38,1140
37309,2588,1206,22,38,70,14,156,6,1382
58481,257,133,0,0,0,0,0,7,124
38359,336,181,0,2,11,0,0,15,155
59422,2623,1295,0,62,43,2,55,42,1328
60451,34945,17167,146,1195,283,223,1118,322,17778
39657,1622,747,2,58,37,0,92,30,875
81645,1114,660,0,110,26,0,34,14,454
85336,441,188,0,14,14,13,10,0,253
60938,1959,930,14,48,19,4,44,30,1029
58273,270,155,0,1,18,0,7,4,115
62829,0,0,0,0,0,0,0,0,0
70374,6863,3401,48,228,111,29,172,135,3462
25699,110,36,0,9,0,0,0,0,74
14719,3424,1696,35,75,29,12,121,84,1728
15541,3682,1792,53,101,78,16,115,52,1890
33619,39747,20686,288,1219,370,299,1281,440,19061
33710,33883,16849,160,1261,536,230,835,419,17034
19802,26303,12296,214,963,236,175,1081,522,14007
20879,27871,13153,136,1075,200,278,1276,501,14718
29829,11879,5777,38,499,93,119,376,87,6102
12790,3956,2000,12,54,53,10,119,76,1956
54932,1364,666,11,53,28,0,35,6,698
37865,21557,10180,101,922,193,131,660,318,11377
10110,0,0,0,0,0,0,0,0,0
12524,15964,8360,50,645,224,75,462,229,7604
2672,281,156,0,0,0,0,35,0,125
4974,2593,1191,0,156,27,0,89,14,1402
66801,28691,13961,432,723,217,727,618,386,14730
67459,241,139,0,8,2,6,3,5,102
74070,15183,7515,113,433,120,103,460,195,7668
41562,3045,1372,0,25,30,0,103,68,1673
70787,176,24,0,0,24,0,0,0,152
72030,631,329,0,0,0,0,0,7,302
26680,323,181,0,27,0,0,0,0,142
27921,4889,2558,15,234,33,47,232,51,2331
28138,9912,5319,65,347,217,20,371,153,4593
54463,591,308,0,10,15,2,15,16,283
55602,197,108,1,0,7,0,0,11,89
52402,41407,20092,393,1598,357,382,1424,367,21315
52737,436,222,0,12,0,6,5,6,214
82922,229,165,0,21,0,0,0,0,64
82943,261,102,50,0,0,0,0,0,159
95938,4350,2014,0,63,29,36,251,63,2336
78635,464,280,34,0,0,0,0,0,184
62448,5565,2654,52,130,63,22,168,72,2911
92106,19080,9711,131,627,212,273,628,269,9369
13776,514,225,0,30,15,7,20,11,289
15438,2029,961,10,67,17,0,73,31,1068
15684,695,281,0,17,0,0,56,0,414
17072,197,73,0,0,0,0,0,0,124
19946,5438,2419,78,144,86,29,186,143,3019
2865,17448,8151,120,450,209,82,476,214,9297
5457,1592,825,5,27,20,19,56,43,767
6093,3122,1447,4,112,67,8,102,43,1675
7003,48810,23485,293,1968,487,270,1911,736,25325
7043,12772,6100,59,207,183,14,410,232,6672
12512,155,64,0,0,0,0,0,0,91
10505,925,388,0,38,0,29,20,19,537
10533,7551,3598,35,119,41,0,290,64,3953
11020,5728,2997,38,161,74,22,123,88,2731
723,17393,8528,133,425,273,113,408,307,8865
37719,185,33,0,0,0,0,30,0,152
39571,13754,6755,90,332,170,135,231,241,6999
40209,249,117,0,17,7,0,37,0,132
30327,22655,10963,0,408,297,71,647,482,11692
31031,6213,2758,13,174,153,25,226,123,3455
31556,88,27,0,1,0,0,4,0,61
33023,73671,35412,460,2321,456,529,3138,1120,38259
35546,3801,1786,0,94,58,10,123,53,2015
36344,5850,3063,31,119,45,13,337,79,2787
37085,4500,2332,140,117,60,36,172,80,2168
27047,1335,654,11,18,8,0,47,8,681
28216,51116,23286,451,1787,225,272,2025,750,27830
28432,1790,905,0,31,0,0,39,33,885
25164,1325,545,31,0,0,0,0,35,780
25913,248,116,0,0,0,0,17,0,132
96009,345,185,0,0,10,0,6,16,160
50133,401,194,0,13,0,5,7,2,207
52656,2498,1261,10,117,24,12,75,17,1237
54408,1036,537,2,39,16,2,32,14,499
56332,1546,768,2,45,18,2,57,26,778
42129,6954,3486,15,101,53,13,211,134,3468
45147,191,64,0,7,0,0,0,5,127
31641,1966,893,0,11,35,0,22,95,1073
46613,10980,5282,104,248,24,55,280,110,5698
48184,17605,8165,181,469,219,132,543,246,9440
48432,672,329,0,21,5,0,17,7,343
16236,228,125,0,0,0,0,13,0,103
17110,25480,12329,165,655,293,72,802,325,13151
17247,393,157,0,0,0,0,0,0,236
18837,3133,1498,14,76,39,10,61,36,1635
5343,791,416,0,35,7,0,16,8,375
28571,2769,1251,0,36,80,6,26,68,1518
12726,1266,682,0,21,22,0,18,23,584
24224,5973,2939,0,97,172,36,100,151,3034
24851,589,336,0,12,33,0,22,0,253
20905,18123,8772,93,420,286,117,540,314,9351
21664,439,220,0,10,7,2,13,9,219
15139,6450,2871,8,252,70,14,178,168,3579
94565,96081,47922,684,3470,736,740,3729,939,48159
94567,696,308,0,19,12,6,18,11,388
97015,23027,11369,75,890,290,51,1069,245,11658
91411,25801,12687,92,1058,179,186,1239,238,13114
92861,5872,2824,35,139,71,16,96,95,3048
93205,1384,711,0,0,28,0,18,24,673
93221,14328,7078,47,373,141,64,421,198,7250
97817,6,3,0,0,0,0,0,0,3
4773,602,287,0,3,3,27,0,0,315
4964,127,70,0,0,2,0,0,0,57
61038,1149,638,0,9,13,15,21,15,511
63051,14157,7034,59,543,168,124,540,269,7123
78833,1536,625,37,6,18,12,0,70,911
80219,69190,34748,559,2594,497,504,2371,782,34442
81147,12288,6192,34,256,282,134,239,210,6096
72648,657,411,0,0,0,0,0,0,246
72928,760,359,0,2,1,0,72,1,401
59263,1489,748,0,45,12,0,58,5,741
73601,10238,5089,74,307,130,0,354,169,5149
55444,16515,8347,123,586,145,89,481,212,8168
55721,3519,1854,15,127,78,5,58,74,1665
36912,2272,1079,109,54,45,4,23,2,1193
43983,454,265,0,28,0,0,8,0,189
44676,4402,2178,14,108,45,35,146,85,2224
45215,30814,14276,127,871,252,303,888,450,16538
48140,3364,1729,29,95,82,12,121,36,1635
60155,7829,3920,0,174,27,59,221,150,3909
60516,29268,14113,171,854,460,54,966,508,15155
56527,858,433,5,24,16,6,27,28,425
58787,166,83,0,0,4,0,13,0,83
41083,1270,632,0,15,12,17,32,3,638
47640,1073,525,0,30,11,0,26,57,548
47960,14559,7182,63,517,295,84,271,297,7377
47981,929,449,0,28,0,0,39,8,480
44004,31474,15135,136,983,615,218,810,582,16339
44028,9000,4488,23,252,84,54,230,211,4512
49686,33069,15925,91,930,515,137,1072,568,17144
50576,318,152,8,0,3,2,7,4,166
51007,529,272,2,1,5,0,5,27,257
51358,1247,599,3,14,17,17,27,18,648
97497,1561,810,8,39,36,0,48,12,751
98002,34508,17184,209,1417,203,150,1040,396,17324
98327,9431,4742,75,356,109,75,188,56,4689
98531,25252,12370,193,822,297,113,1049,525,12882
85357,342,138,12,5,0,0,8,38,204
75024,42876,21203,152,2170,435,106,1721,275,21673
68723,535,262,0,7,19,0,7,4,273
58625,393,232,4,0,0,0,0,6,161
59801,32653,16618,492,1172,354,836,1089,261,16035
50833,2337,1152,21,76,26,9,77,18,1185
63538,392,227,0,19,1,0,0,4,165
65457,115,42,0,0,9,0,0,5,73
45337,1918,1071,8,44,1,4,7,100,847
47140,2489,1249,44,61,41,1,102,59,1240
54806,11513,5783,201,390,146,41,347,140,5730
55797,1578,841,3,67,31,2,29,29,737
62092,2932,1365,30,77,24,7,61,49,1567
28712,20017,9616,149,289,189,133,405,392,10401
30024,77334,36966,704,2262,526,514,3053,853,40368
44090,11996,6060,181,255,223,155,399,226,5936
36521,5386,2451,33,146,84,62,163,114,2935
37318,1586,761,0,67,23,4,44,39,825
38552,211,115,0,23,0,0,4,4,96
39046,27639,13087,181,931,330,72,722,280,14552
39365,7432,3787,57,219,37,34,213,146,3645
40056,3161,1597,0,80,35,17,84,97,1564
40152,1027,570,0,25,35,0,29,44,457
40242,11056,5293,78,343,144,49,329,184,5763
22043,25376,12983,13,1152,266,158,1104,248,12393
27055,14131,6834,56,325,180,70,344,162,7297
25043,1392,722,8,38,25,9,20,10,670
32570,30768,14996,83,857,368,181,877,401,15772
93591,6579,3033,26,155,43,14,193,113,3546
93625,7862,3823,45,137,70,0,265,84,4039
15672,3620,1747,13,142,28,14,104,55,1873
5477,4504,2383,32,134,39,21,127,20,2121
10177,0,0,0,0,0,0,0,0,0
24314,1522,680,0,59,25,6,64,51,842
22308,13335,6886,55,397,117,77,454,112,6449
14825,749,323,0,16,56,0,17,0,426
75013,40675,20718,248,1480,223,186,1735,421,19957
82414,15608,7741,66,336,173,86,487,234,7867
96006,380,186,0,0,6,0,6,0,194
98372,25487,13021,187,758,386,76,776,532,12466
88343,5,0,0,0,0,0,0,0,5
95002,2146,1167,23,51,10,9,76,31,979
95118,32560,16265,98,1431,192,167,1416,365,16295
30220,5375,2630,71,89,50,3,227,114,2745
33876,4689,2471,0,102,84,25,107,185,2218
36330,36607,18097,92,1290,371,229,1438,422,18510
46940,2632,1387,17,112,56,10,94,68,1245
3854,780,372,0,0,14,0,0,0,408
1581,18982,9565,36,539,247,0,524,172,9417
22611,9005,4481,48,198,86,66,198,163,4524
24603,795,391,0,12,10,0,6,6,404
31070,985,547,0,27,0,4,20,7,438
31772,536,279,0,0,14,11,0,54,257
15260,0,0,0,0,0,0,0,0,0
94021,436,173,0,0,0,3,0,0,263
94070,31049,15001,168,1153,222,55,1285,419,16048
95326,9888,4569,41,372,118,6,457,57,5319
98224,255,169,0,0,12,0,3,0,86
20180,7467,3674,10,184,63,4,258,135,3793
60519,63,24,0,0,0,0,0,0,39
62441,6786,3416,49,218,50,31,200,70,3370
64018,915,467,8,68,6,6,42,13,448
79713,384,201,0,14,13,0,11,9,183
67752,1330,655,1,37,10,0,35,25,675
69146,293,189,0,14,0,0,2,23,104
73132,28199,12964,54,1034,249,117,1088,419,15235
77808,11941,6043,29,547,143,132,474,166,5898
84523,1755,895,15,33,26,0,81,32,860
85701,5347,2812,35,275,57,143,137,54,2535
66540,384,217,0,15,7,0,10,5,167
66859,262,128,0,7,3,0,8,3,134
48223,24632,11678,172,533,270,175,801,434,12954
48440,252,128,0,14,0,0,14,14,124
39040,3032,1442,0,56,17,0,180,20,1590
33914,37375,19402,480,999,501,46,844,556,17973
34608,34476,16655,320,663,444,208,1472,420,17821
36265,20694,10249,433,512,193,298,578,198,10445
46785,1503,721,7,46,8,10,20,25,782
61310,3748,1837,57,108,28,16,63,40,1911
62621,1195,594,28,32,18,0,23,16,601
78754,24408,11690,58,1379,68,61,988,336,12718
80907,28897,14714,298,936,358,361,950,309,14183
75069,37834,18233,303,1042,277,285,1156,303,19601
75647,12719,5873,43,302,20,78,322,279,6846
65760,481,229,0,11,0,0,10,17,252
58351,492,251,0,14,8,0,2,3,241
58652,1278,678,3,23,21,6,20,12,600
68324,105,60,0,10,0,0,9,0,45
69343,2274,1066,14,29,29,3,24,38,1208
16444,1224,538,32,0,0,62,0,0,686
17824,3871,1832,25,131,147,14,123,76,2039
15440,161,93,0,0,18,0,0,17,68
16027,274,134,0,11,0,0,3,0,140
16360,1433,724,5,41,19,10,47,28,709
34652,23409,11027,36,628,480,256,630,403,12382
35210,13484,5924,67,537,134,28,386,216,7560
36751,585,267,0,18,9,0,11,6,318
38472,3033,1374,6,122,15,0,77,98,1659
39305,20524,9819,89,674,250,145,854,368,10705
39341,7164,3593,55,173,80,15,189,37,3571
44039,33018,16178,84,931,384,67,1062,424,16840
44687,275,130,0,0,18,0,0,15,145
53217,29184,14272,55,785,351,183,870,509,14912
53517,1872,969,3,69,20,14,58,39,903
48423,31796,15462,255,838,370,257,968,516,16334
49001,21070,10615,60,794,87,164,805,185,10455
41076,17198,7910,241,342,206,200,420,277,9288
41822,2067,1025,0,87,40,15,71,24,1042
42262,8750,4805,215,344,21,194,370,36,3945
15353,100,56,13,5,2,0,3,0,44
15663,426,207,5,8,10,0,6,7,219
16435,1787,844,7,35,29,9,44,25,943
16917,1185,560,7,31,9,19,35,18,625
4631,1351,591,11,37,38,0,27,36,760
24649,2732,1338,66,43,14,0,72,85,1394
29423,1035,418,62,0,0,60,0,0,617
26575,704,337,8,6,28,10,7,3,367
27377,7884,3550,0,314,68,3,251,108,4334
75103,14458,6936,44,340,298,32,523,202,7522
75161,7005,3430,14,89,52,0,174,105,3575
80759,4828,2357,20,129,30,12,61,13,2471
83870,333,159,0,21,5,0,5,7,174
84740,170,102,0,0,0,0,5,3,68
85042,46570,23410,566,1347,144,440,1431,442,23160
14736,270,151,0,16,0,0,16,2,119
5031,128,44,0,0,0,0,0,0,84
83801,7015,3726,19,169,273,2,125,117,3289
84414,29750,14547,230,1095,408,166,1087,282,15203
84518,827,352,0,37,2,35,31,8,475
95595,182,106,0,9,0,0,13,0,76
96103,1417,664,1,42,56,0,2,67,753
96105,93,35,0,0,0,0,0,0,58
97138,10293,4991,59,366,180,135,398,147,5302
98381,333,149,0,16,0,0,20,19,184
98628,461,248,0,22,5,0,11,8,213
99519,469,412,0,35,5,0,3,0,57
94528,307,162,0,0,0,0,0,0,145
90501,42335,20508,301,1138,247,241,1500,392,21827
91942,40205,18933,291,1822,318,122,1405,591,21272
92267,5,5,0,0,0,0,0,0,0
93105,27515,13242,20,694,348,180,812,508,14273
48135,26809,13435,188,923,205,169,746,402,13374
49249,3758,2000,0,62,55,0,56,49,1758
24201,16141,7630,67,539,211,102,370,249,8511
12036,224,141,0,26,0,0,0,0,83
12935,1651,802,11,68,16,6,49,13,849
1360,2997,1524,44,30,38,0,48,51,1473
41102,20300,10390,33,655,209,103,640,287,9910
41722,1043,583,25,110,0,0,49,21,460
66756,950,491,0,12,7,0,21,18,459
67877,2481,1267,22,97,20,0,72,64,1214
68015,1166,615,5,34,23,0,24,11,551
58374,580,276,3,11,10,0,9,16,304
59454,160,92,0,0,4,1,3,4,68
62014,4131,1967,20,118,61,81,55,65,2164
98220,861,475,0,0,0,55,51,0,386
99111,4349,2326,15,161,64,0,167,49,2023
96055,3914,1952,21,65,21,25,117,107,1962
97034,18977,9191,34,337,294,28,457,381,9786
70071,3302,1603,34,37,29,48,81,37,1699
76527,3681,1886,17,79,56,8,102,49,1795
78104,69,49,0,0,0,0,0,0,20
78393,2166,1084,0,66,11,0,42,39,1082
78712,860,395,70,0,0,36,0,0,465
92386,2140,987,0,96,19,0,86,43,1153
80504,54023,26239,201,2309,498,202,1921,827,27784
82083,229,122,0,0,10,0,0,7,107
83271,460,243,0,15,17,0,8,8,217
74653,3740,1924,35,86,47,28,87,42,1816
75234,33737,16555,295,914,206,147,1328,466,17182
76093,1753,844,8,68,11,0,65,39,909
76103,14508,6844,74,385,194,145,523,197,7664
65676,398,223,0,0,11,0,9,8,175
66942,304,186,0,10,2,0,5,20,118
45807,12407,6081,185,305,152,107,269,235,6326
46723,7878,3872,29,209,118,59,319,125,4006
40339,0,0,0,0,0,0,0,0,0
43102,4500,2400,12,74,35,13,80,59,2100
43314,3033,1548,7,77,33,18,103,18,1485
39082,1028,425,0,46,18,37,14,19,603
39327,4217,1960,3,88,47,59,130,54,2257
58843,584,330,0,16,0,0,8,14,254
59642,51,30,0,0,0,0,0,0,21
61414,937,497,0,26,5,0,44,5,440
61841,1341,653,0,66,12,8,62,10,688
62543,531,272,0,26,2,14,9,4,259
63080,13587,7226,94,556,190,54,438,164,6361
56529,4370,1856,0,26,43,0,183,68,2514
56629,195,103,0,0,9,0,0,8,92
56713,1026,504,5,33,10,10,42,25,522
54006,701,345,0,46,14,0,17,13,356
48519,7262,3344,11,192,37,85,254,97,3918
49322,1480,809,4,20,9,2,18,18,671
49401,24290,11345,871,450,135,1791,505,185,12945
50250,2340,1113,6,84,30,8,59,65,1227
51040,3543,1741,28,121,41,0,145,83,1802
51401,11965,5852,42,265,163,77,363,242,6113
44506,2877,1436,18,53,3,12,89,6,1441
3282,871,440,15,25,20,19,15,32,431
4973,1508,720,4,63,21,27,55,33,788
6611,36174,17439,79,929,258,178,1114,466,18735
16052,2465,1314,30,50,57,6,34,54,1151
16828,4345,2232,46,78,60,26,101,97,2113
24130,19,10,0,0,0,0,0,0,9
8608,893,398,0,0,12,0,33,0,495
19962,11820,5624,18,323,146,178,258,74,6196
27046,1922,911,0,16,0,0,86,17,1011
12763,648,309,5,8,6,0,43,15,339
12855,242,113,0,4,3,0,5,4,129
13352,32,0,0,0,0,0,0,0,32
76435,467,211,0,9,8,0,25,12,256
77520,35970,18215,294,1345,305,232,898,344,17755
53059,1833,987,0,40,25,5,34,31,846
59276,21,10,0,0,0,0,0,0,11
66413,1895,971,11,58,21,4,56,23,924
67650,147,64,0,0,0,0,12,4,83
70118,36194,16826,669,1079,295,802,1264,453,19368
70778,3749,1672,0,112,26,37,84,23,2077
71846,2810,1375,37,182,35,71,132,39,1435
57718,7205,3664,49,225,31,0,256,69,3541
31009,1317,673,18,45,6,19,5,5,644
4937,6546,3115,17,162,84,0,225,83,3431
45384,2053,978,77,0,0,84,13,0,1075
46929,2980,1446,13,62,5,10,104,16,1534
33332,11518,5819,72,169,79,88,379,142,5699
33442,28846,13033,156,949,349,167,682,245,15813
24184,4180,2068,20,96,41,0,81,106,2112
28713,8704,4178,76,198,171,81,193,120,4526
29375,75,45,0,8,0,0,2,0,30
33853,12254,5814,43,391,127,6,295,105,6440
33603,21044,10129,98,692,263,315,746,274,10915
23891,3408,3408,46,664,4,0,0,0,0
8528,86,29,0,0,0,0,0,0,57
10007,7023,4118,50,366,51,31,293,58,2905
19958,25027,11874,182,383,544,65,464,451,13153
20012,16351,7742,12,710,241,56,550,293,8609
12530,117,92,0,0,0,0,0,25,25
13081,1105,534,4,38,14,12,34,29,571
26354,10449,5380,0,407,85,79,274,178,5069
26802,1041,551,21,11,7,0,5,22,490
49230,10259,5154,32,231,221,76,225,185,5105
36609,24282,10973,250,680,340,118,708,341,13309
41531,981,539,0,49,9,0,17,0,442
41835,895,452,0,0,34,51,20,0,443
1341,1836,934,40,24,27,27,49,27,902
1719,5794,2982,25,108,40,36,150,133,2812
27520,40611,19560,258,1253,178,26,1296,338,21051
2721,26268,12034,59,610,174,124,836,366,14234
47024,3340,1599,0,73,40,33,54,42,1741
12436,39,19,0,0,0,0,0,0,20
4220,3085,1558,23,96,73,2,145,66,1527
19529,3367,1804,6,99,60,4,109,89,1563
32952,20732,10368,119,389,421,51,479,440,10364
75938,2809,1340,0,55,68,0,31,26,1469
76455,973,557,8,38,14,11,12,4,416
98271,28585,14677,74,1080,345,285,974,436,13908
85032,72830,36499,638,2707,652,455,2415,1132,36331
76701,2002,1062,39,69,21,91,122,21,940
18037,7875,3850,25,209,91,26,241,140,4025
95333,2479,1300,0,107,12,26,77,26,1179
18427,140,54,0,0,0,0,0,0,86
78751,15805,8301,294,717,128,309,668,96,7504
24283,2123,1011,0,58,38,3,76,30,1112
79562,3809,1900,0,183,23,3,213,55,1909
11364,36806,18053,61,1050,670,99,1185,819,18753
56151,780,386,0,12,15,0,20,7,394
59759,3798,1878,0,51,95,17,86,48,1920
60407,1696,898,5,39,25,22,50,9,798
61260,1062,474,2,16,24,12,15,17,588
29710,35157,17041,208,1193,426,94,1212,601,18116
55396,2131,1049,3,75,38,11,46,34,1082
14894,1253,640,8,23,36,2,57,15,613
77418,10381,5203,2,88,143,14,262,70,5178
64501,12692,6487,58,434,95,54,387,160,6205
66775,141,67,0,2,0,0,2,8,74
76360,3533,1889,10,45,82,0,87,33,1644
71429,3228,1581,4,84,63,0,149,10,1647
63005,17887,9028,98,486,232,9,568,289,8859
73731,115,62,0,0,13,0,0,4,53
89144,19787,9655,67,533,243,15,692,247,10132
83854,40905,20649,80,1557,421,167,1147,462,20256
84638,316,151,3,16,10,0,14,1,165
94941,32013,15149,84,611,398,55,786,508,16864
95073,10949,5389,128,328,205,61,207,206,5560
97738,1788,925,8,34,33,2,82,51,863
98008,25539,12793,111,851,291,108,980,291,12746
99621,653,348,5,6,11,6,12,2,305
50836,250,111,2,4,1,0,4,6,139
51006,1008,506,10,36,11,1,20,20,502
51247,5044,2316,65,165,25,0,134,22,2728
44012,23777,11516,67,709,358,32,659,367,12261
44099,2334,1198,15,38,13,37,55,5,1136
45158,373,184,0,15,5,8,10,4,189
45406,19432,9067,106,794,170,97,423,437,10365
45428,335,325,0,23,24,0,0,3,10
59526,2662,1298,7,88,6,28,98,13,1364
15938,2312,1153,10,58,47,2,57,31,1159
19064,24672,11837,92,875,312,146,738,381,12835
11570,27722,13497,93,609,405,150,741,296,14225
12108,395,242,0,0,7,0,53,6,153
68732,184,113,2,0,1,0,2,16,71
71295,13992,6860,60,545,309,112,552,185,7132
71770,3591,1909,20,93,11,5,48,74,1682
77435,4258,2089,64,196,28,21,168,59,2169
78947,4688,2199,64,159,32,35,178,70,2489
59255,3487,1672,27,123,37,0,88,34,1815
60915,10121,4997,33,187,70,188,230,163,5124
80602,34857,17121,110,1573,205,66,1371,335,17736
75048,25034,12068,79,635,359,88,1002,422,12966
75704,10352,4779,0,495,52,26,409,103,5573
87016,3308,2117,96,50,17,8,6,32,1191
7435,2629,1308,51,116,20,12,76,8,1321
30288,9230,4212,0,236,97,1,240,298,5018
33493,5543,4512,50,594,92,30,44,27,1031
33521,430,187,0,13,7,0,0,6,243
13687,503,244,3,18,16,0,24,21,259
14475,280,174,0,0,0,0,22,5,106
23964,1051,614,44,51,10,0,6,0,437
24415,32,16,0,0,0,0,0,0,16
25136,1903,964,83,44,13,22,41,22,939
19072,9633,4570,17,430,104,21,297,163,5063
59046,395,181,3,3,7,2,20,17,214
62018,3034,1474,12,141,28,3,119,38,1560
62547,926,482,14,49,12,0,43,22,444
63141,20550,9963,123,475,217,60,484,261,10587
63746,34,12,0,0,6,0,0,0,22
67220,14060,7137,133,409,135,220,556,220,6923
83546,504,292,10,20,3,4,8,2,212
83611,1979,1136,4,13,45,1,43,32,843
85051,44042,22204,170,1417,398,345,1544,610,21838
87051,1251,642,0,70,0,0,0,0,609
74549,74,35,4,0,0,5,0,0,39
72101,2946,1310,41,87,40,21,51,20,1636
72335,19017,10821,212,1298,121,119,492,268,8196
73042,1116,573,0,30,13,10,41,16,543
73105,5409,2517,0,110,41,14,134,96,2892
74116,4044,2027,13,126,24,28,143,45,2017
74126,10472,4718,53,228,104,110,438,177,5754
81330,94,47,0,0,0,0,22,0,47
82630,0,0,0,0,0,0,0,0,0
15561,191,95,0,13,0,0,0,0,96
15662,188,61,0,0,0,0,0,0,127
33183,37504,17873,221,1023,320,254,1604,536,19631
25082,1575,778,0,65,60,23,49,0,797
28609,5788,2881,36,179,41,33,188,86,2907
11957,782,379,0,21,21,12,4,17,403
12053,4621,2324,80,195,31,40,104,87,2297
12477,18162,9018,88,428,209,62,543,230,9144
13110,2038,993,14,15,22,10,17,64,1045
28212,45694,22233,417,1633,322,459,1586,334,23461
36767,1456,585,11,85,48,16,42,37,871
31052,8557,4090,48,158,132,23,261,152,4467
1237,2580,1315,13,39,41,3,102,77,1265
35571,811,436,19,22,0,0,26,32,375
37352,3058,1493,10,119,47,0,120,48,1565
47590,419,258,0,18,8,0,0,9,161
57252,4807,2490,16,201,60,0,147,100,2317
58239,14,7,0,0,0,0,0,0,7
93446,44753,22151,181,1366,545,97,1486,752,22602
93451,4089,2166,38,169,44,9,135,58,1923
92595,33642,16555,209,953,231,262,1041,588,17087
60518,3543,1772,16,100,31,30,79,36,1771
62439,7166,3530,24,155,128,52,119,128,3636
56177,54,27,0,2,2,0,2,1,27
57476,424,244,4,7,5,0,8,4,180
58445,260,146,0,3,0,0,6,0,114
62551,575,312,2,2,8,0,13,6,263
64442,841,448,14,19,55,5,22,15,393
72119,0,0,0,0,0,0,0,0,0
72521,5355,2480,23,204,25,67,166,112,2875
98409,25096,12985,240,980,110,308,944,220,12111
98684,29433,14570,198,1054,254,261,852,322,14863
78752,21324,11975,119,1219,207,165,649,114,9349
79101,2133,969,45,102,27,0,12,0,1164
79735,13734,7867,107,794,71,146,414,105,5867
90650,105886,52976,1012,3703,943,736,3997,1116,52910
92109,48417,25726,592,1976,283,480,1837,369,22691
95246,1032,578,0,0,33,0,0,69,454
91351,32572,16146,154,1324,275,170,1153,366,16426
93208,47,2,0,0,0,0,0,0,45
88431,61,30,0,0,0,0,0,0,31
99739,303,176,2,10,2,3,3,3,127
58029,96,66,0,2,0,0,2,4,30
41522,5107,2559,32,165,86,17,42,97,2548
43970,80,26,0,0,0,0,0,0,54
36106,15094,6829,77,371,132,195,225,288,8265
50451,505,299,4,32,9,0,8,10,206
51544,698,354,13,5,23,0,17,5,344
53016,358,196,3,14,2,1,6,2,162
48190,157,60,0,0,0,0,0,0,97
49725,739,382,0,21,17,0,27,25,357
49775,78,44,0,0,5,0,0,0,34
37601,35920,17084,473,1024,299,266,1187,521,18836
37923,30253,14747,271,1122,283,177,1126,259,15506
38037,1678,750,11,32,4,0,104,28,928
38256,2670,1370,0,62,19,0,26,47,1300
39120,31239,15967,249,1565,461,191,745,593,15272
46341,10330,5071,108,265,136,15,425,171,5259
79326,109,60,0,22,0,0,0,0,49
80017,36613,18396,240,1185,263,332,1201,355,18217
81324,1289,709,0,12,10,10,27,31,580
81612,0,0,0,0,0,0,0,0,0
61348,4483,2263,53,112,112,0,142,74,2220
62544,1597,810,10,48,22,7,27,34,787
71743,3802,1866,19,40,41,8,73,41,1936
73832,1061,487,0,26,9,0,11,17,574
68105,23508,11905,150,760,234,222,660,248,11603
87577,385,224,0,0,0,0,0,8,161
89451,8543,4282,130,258,230,72,280,126,4261
17830,1968,1025,10,53,16,1,61,23,943
20176,53017,26494,261,1805,399,351,2292,749,26523
21524,740,345,89,0,0,0,52,13,395
14804,1402,734,3,50,27,4,42,28,668
16235,1239,637,10,38,6,0,35,9,602
1236,1140,561,0,0,0,0,23,13,579
28357,2682,1408,0,86,11,13,45,17,1274
32806,27768,13996,62,1172,240,31,1240,378,13772
49744,851,395,4,16,30,23,27,23,456
50223,546,321,0,9,4,0,16,9,225
51355,912,397,3,17,25,16,24,13,515
54123,258,150,0,12,7,0,0,3,108
66964,132,52,4,4,0,0,2,1,80
69351,248,142,0,7,0,0,9,0,106
63026,43287,21445,237,1569,553,30,1445,750,21842
63155,0,0,0,0,0,0,0,0,0
58348,755,396,5,13,13,0,16,12,359
60457,14018,7219,128,586,237,26,457,188,6799
62301,32078,15134,142,957,302,353,830,342,16944
62417,3281,1608,0,123,21,12,130,84,1673
49096,3327,1730,6,145,31,15,106,48,1597
54822,4423,2193,18,174,59,15,163,89,2230
55806,8727,4552,64,319,81,66,293,138,4175
38201,11005,5319,90,297,108,39,302,109,5686
38487,1304,713,0,13,39,0,37,9,591
35005,7528,3608,57,223,118,22,191,163,3920
42327,4038,1974,69,91,35,17,148,35,2064
28528,590,333,0,0,17,0,0,0,257
28749,29,13,0,0,0,0,0,0,16
29840,323,173,0,13,20,11,0,0,150
13647,37,18,0,0,0,0,0,0,19
14052,16614,8024,48,431,189,130,418,243,8590
15741,52,28,0,3,3,0,3,0,24
16142,6968,3457,89,183,121,221,131,60,3511
4669,192,104,12,12,3,0,12,0,88
7463,9948,4942,21,255,126,16,220,78,5006
24555,2453,1230,10,107,7,5,58,24,1223
25021,250,118,0,28,0,3,0,0,132
84054,20005,9857,87,928,87,158,996,80,10148
72717,784,346,0,21,7,12,45,21,438
74042,402,222,0,11,5,1,0,3,180
74576,84,39,0,6,0,0,0,3,45
71051,1707,821,0,47,10,0,78,32,886
71842,2197,1063,4,46,66,13,65,38,1134
92264,19881,11817,32,409,648,84,368,245,8064
99572,580,288,0,16,0,14,41,0,292
99827,2565,1360,2,18,190,0,127,13,1205
59248,618,338,0,20,18,0,12,15,280
59324,946,456,0,32,9,0,15,12,490
61010,7805,3736,66,265,44,63,260,63,4069
68323,231,108,2,0,14,0,7,9,123
70056,40399,20272,383,1529,310,249,1234,487,20127
70091,332,204,10,40,0,0,12,0,128
78025,4749,2229,38,102,61,63,158,25,2520
56680,146,72,0,0,2,0,2,2,74
62478,389,187,2,10,5,0,31,8,202
62939,3111,1390,0,63,73,24,75,28,1721
63461,5709,2625,24,198,97,14,172,111,3084
72773,1257,708,0,40,14,0,35,27,549
73061,1659,867,4,49,32,0,55,18,792
73719,79,42,0,1,0,0,0,0,37
80237,20982,10751,75,631,227,52,708,181,10231
74954,5194,2497,39,130,15,50,113,81,2697
84001,702,334,5,23,5,2,22,8,368
87002,21691,11308,160,591,158,40,665,359,10383
88310,36282,17986,480,962,434,196,1213,524,18296
93631,16349,8056,136,563,322,101,496,414,8293
97820,1008,500,7,30,11,0,39,8,508
97823,1015,477,7,19,20,7,11,31,538
2864,34624,16687,110,1180,305,180,1190,647,17937
2920,37199,19224,201,1378,384,338,1126,359,17975
3603,5290,2676,0,261,138,0,207,116,2614
6090,857,403,0,0,12,0,24,33,454
7094,19390,9443,104,778,127,240,586,432,9947
1610,23040,11080,547,586,117,801,637,203,11960
53222,26509,12912,42,800,277,115,1190,398,13597
55036,93,53,0,4,5,0,4,0,40
41553,2157,1055,0,98,35,0,142,68,1102
43021,12327,6220,0,403,106,79,578,130,6107
43410,10030,5408,4,467,188,77,263,139,4622
47367,23,11,0,0,0,0,0,0,12
47374,45489,21876,354,1243,498,381,1412,630,23613
3226,995,524,0,24,13,11,9,16,471
4940,0,0,0,0,0,0,0,0,0
6058,1536,761,3,8,18,7,12,22,775
58520,246,147,1,0,6,4,2,11,99
59632,1615,822,1,29,22,0,75,32,793
61775,327,157,8,5,6,8,6,7,170
82723,246,136,0,28,0,0,35,0,110
79243,73,30,0,0,4,0,15,6,43
97501,45607,22067,224,1626,572,321,1527,738,23540
98498,28496,13887,245,869,335,193,722,477,14609
98948,13077,6918,67,451,140,42,300,139,6159
73071,42656,21956,1287,1564,331,1061,1169,228,20700
95460,2277,1245,0,78,86,0,34,15,1032
95514,117,81,0,0,8,0,25,0,36
67749,2025,994,33,32,6,5,81,30,1031
68764,760,401,0,26,11,4,13,31,359
10037,21139,9399,39,636,81,128,954,283,11740
38356,2667,1249,17,75,107,0,30,58,1418
39150,5730,2835,30,123,65,20,166,91,2895
39179,1339,584,51,35,0,0,22,15,755
39641,3450,1644,35,112,39,0,71,56,1806
63431,230,131,0,0,0,0,9,11,99
57373,509,258,0,3,2,0,2,2,251
57572,1854,875,27,40,2,11,35,35,979
48059,14957,7082,43,394,247,68,374,242,7875
21801,30007,14503,192,850,331,276,744,312,15504
23837,4608,2287,95,153,14,0,102,46,2321
23860,30658,15883,226,1372,340,95,754,412,14775
57105,22501,10752,241,601,232,220,526,314,11749
73072,46675,22372,671,1537,401,619,1391,411,24303
73425,40,25,0,6,0,0,0,0,15
75215,16681,8016,113,469,141,102,568,238,8665
70819,4721,2095,0,118,43,64,115,15,2626
71322,6089,3093,184,71,159,0,258,47,2996
38030,545,270,0,26,0,0,25,0,275
39769,1570,797,3,67,32,6,2,49,773
47112,16246,8144,62,571,164,42,589,152,8102
27873,502,263,0,5,0,0,17,5,239
41408,485,221,0,0,0,0,12,13,264
28756,4715,2167,38,85,17,83,48,46,2548
26033,2387,1177,0,74,70,15,72,53,1210
24354,14334,6928,33,253,253,68,260,245,7406
56056,84,42,0,3,1,1,2,1,42
49688,2579,1381,5,66,36,6,97,49,1198
50567,318,185,0,0,8,0,7,13,133
72326,1601,853,0,22,10,10,23,40,748
71950,898,457,2,48,0,0,21,1,441
11947,511,170,0,0,0,60,0,73,341
12469,605,274,0,5,12,0,3,10,331
12487,3483,1670,47,19,4,70,85,52,1813
13074,4078,1949,8,88,41,34,176,47,2129
6032,17624,8356,100,468,210,92,486,237,9268
6067,20137,9415,46,533,407,65,672,314,10722
6353,64,30,0,0,0,0,0,0,34
7102,13382,6841,200,388,111,172,291,127,6541
19955,34,14,0,0,0,0,0,4,20
20755,10297,5670,245,530,0,66,492,31,4627
21044,44034,21582,127,1432,589,270,1657,503,22452
21756,3600,1735,25,55,46,4,82,47,1865
2043,23298,11130,72,534,355,99,600,339,12168
11371,0,0,0,0,0,0,0,0,0
22192,58439,28327,276,2068,406,422,2498,722,30112
23153,1246,684,0,0,17,0,15,23,562
1230,8542,4241,86,105,149,14,178,122,4301
29642,32358,16074,76,1128,516,141,1123,381,16284
12547,2899,1459,34,99,34,13,161,72,1440
12872,47,16,0,0,0,0,0,0,31
28166,9394,4552,70,216,174,116,189,110,4842
47921,1214,632,0,24,3,0,48,25,582
40854,1001,453,13,12,5,2,39,30,548
54462,356,184,0,10,5,3,6,5,172
37882,2690,1261,0,102,38,16,58,61,1429
43720,1331,674,0,22,31,18,12,0,657
44224,39564,19205,203,1230,473,155,1255,510,20359
44657,9583,4736,41,319,61,58,279,150,4847
33972,15299,7468,149,277,187,175,326,222,7831
35114,8624,4207,105,443,16,32,405,77,4417
35503,9074,4648,67,146,154,7,217,154,4426
51343,403,184,38,29,1,49,26,1,219
47929,710,348,15,20,1,0,38,1,362
48017,11993,6004,23,520,133,10,418,214,5989
48416,5051,2369,40,125,46,39,146,89,2682
48823,51230,25111,2810,1143,315,3232,921,597,26119
44418,1531,828,7,42,27,35,19,63,703
45660,7246,3625,40,331,122,69,137,82,3621
23451,42776,20418,226,1342,459,345,1327,488,22358
3457,796,433,17,7,12,8,7,12,363
5776,716,337,28,0,17,14,3,2,379
6248,5570,2827,30,105,72,31,132,51,2743
14801,5379,2768,37,234,93,36,135,94,2611
16691,320,172,0,6,2,3,2,4,148
16750,472,309,41,17,2,2,5,13,163
12858,113,60,0,0,0,0,0,0,53
12942,846,392,0,27,7,0,30,23,454
8330,27809,13838,160,1044,231,292,1105,517,13971
83542,103,72,0,13,6,0,0,3,31
91011,20423,9746,121,455,350,115,377,409,10677
91360,43342,20854,202,1137,536,323,1100,543,22488
93117,58431,28891,2210,1274,417,2374,1076,388,29540
85550,4994,2470,43,120,0,48,126,31,2524
86047,15393,8536,115,845,118,145,552,116,6857
97901,720,376,0,12,18,0,16,22,344
98207,1397,1171,68,48,0,15,0,0,226
98558,301,130,0,51,0,0,0,0,171
94060,1081,602,0,32,0,0,0,82,479
94520,38568,19669,397,1650,381,101,1708,432,18899
95329,2685,1297,9,77,98,14,61,36,1388
97062,28652,13776,176,1134,316,171,1093,514,14876
76354,12021,5400,150,200,108,120,298,130,6621
52052,3081,1617,0,87,21,13,55,69,1464
52221,232,153,0,1,11,0,0,0,79
54455,17934,9066,90,606,235,97,652,324,8868
67559,54,21,0,0,0,0,14,0,33
59746,132,69,0,3,5,0,2,2,63
59926,391,226,0,0,0,12,0,7,165
60085,70850,35807,612,2300,402,788,2663,808,35043
60110,39333,19947,384,1526,281,253,1122,183,19386
48703,2919,1449,0,51,71,12,36,69,1470
57235,897,477,3,29,11,0,30,14,420
58030,675,374,3,16,8,3,21,7,301
36081,15894,7222,262,364,88,682,386,231,8672
39217,1291,468,23,0,0,117,0,0,823
40117,2701,1432,21,85,29,19,105,41,1269
93065,72061,35083,582,2258,585,389,2533,725,36978
95129,39828,19991,176,1584,211,62,1198,519,19837
98330,103,75,0,0,0,0,0,0,28
99009,3671,1854,22,65,14,20,172,56,1817
99330,1142,446,0,81,18,0,86,0,696
99508,35605,17107,369,1088,258,403,1002,238,18498
99558,104,65,2,12,2,0,0,0,39
77578,20310,9790,101,813,89,93,937,297,10520
77880,1197,678,0,47,14,0,10,14,519
94128,135,67,0,0,0,0,0,0,68
95946,9370,4733,1,232,189,115,196,248,4637
81140,2351,1216,0,106,25,10,43,61,1135
88330,3879,2093,153,104,0,61,53,0,1786
90743,267,148,0,22,4,0,10,10,119
70531,1496,697,76,97,0,0,66,13,799
12563,8555,4310,98,482,20,20,366,101,4245
12828,8546,4238,21,240,55,28,338,152,4308
13301,108,43,0,0,0,0,0,0,65
14068,6632,2968,7,216,69,40,151,154,3664
10026,39363,18124,467,1572,244,191,1539,402,21239
2748,11313,4839,15,227,121,163,223,276,6474
3043,1673,830,6,74,45,10,32,56,843
4741,4,4,0,0,0,0,0,0,0
4971,2041,1018,15,75,40,0,68,16,1023
15716,867,397,0,50,10,16,0,12,470
26866,673,295,0,0,11,0,10,4,378
28447,1643,687,60,0,35,0,0,15,956
28465,7252,3596,58,185,219,33,111,236,3656
32920,10181,5068,109,104,259,36,190,159,5113
48067,24901,12897,130,940,284,93,878,264,12004
49046,7900,4092,60,207,133,57,192,93,3808
15456,2591,1271,20,70,39,8,58,59,1320
15742,990,487,0,37,16,0,28,15,503
18447,10045,4686,62,232,230,31,217,187,5359
35652,8700,4219,17,212,189,90,208,184,4481
36558,3414,1759,34,117,43,2,98,29,1655
7108,22047,9826,287,874,99,83,1004,273,12221
38332,1097,561,6,42,5,0,33,55,536
7460,3407,1800,61,75,39,38,64,59,1607
45208,18503,8850,40,725,106,13,580,244,9653
45505,19919,9442,65,611,177,84,575,319,10477
10956,31619,15221,164,737,384,104,900,429,16398
29907,14801,7732,323,535,48,14,396,200,7069
19127,6082,3376,47,210,50,251,68,64,2706
27505,5862,2889,38,169,39,18,124,111,2973
20815,30512,14553,49,870,427,108,917,390,15959
31565,2008,941,0,65,85,0,84,23,1067
84310,3984,2070,25,118,123,17,76,22,1914
97495,1858,878,36,47,37,0,77,182,980
97814,12433,6455,76,340,260,65,268,105,5978
76664,3762,2034,11,121,52,16,70,48,1728
99338,15724,7887,77,557,161,82,581,238,7837
77624,619,347,0,29,0,0,4,40,272
16238,447,199,2,8,1,6,10,9,248
24471,1627,856,0,45,50,17,18,21,771
79718,886,464,19,32,15,4,45,12,422
63546,1950,943,27,68,14,23,82,21,1007
12996,2079,1137,1,103,24,14,100,31,942
13363,2279,1066,22,33,0,0,99,46,1213
28034,17327,8476,51,376,157,106,562,187,8851
28638,11698,5632,27,336,98,27,365,134,6066
66451,1595,772,45,31,17,10,57,11,823
29320,1017,476,0,0,0,0,0,0,541
54929,8682,4310,10,246,137,33,230,186,4372
1151,8807,4218,109,179,62,70,289,99,4589
55305,20818,10086,31,602,268,32,679,262,10732
1879,12345,6040,127,518,93,18,507,211,6305
2215,25619,10900,860,516,102,1647,396,90,14719
15057,15671,7749,52,550,209,72,702,197,7922
3071,5316,2952,92,193,96,94,177,16,2364
4039,7562,3469,12,170,78,0,311,117,4093
4985,52,19,0,0,0,0,4,0,33
95662,32006,16002,150,1033,382,147,1078,514,16004
88436,50,20,13,0,0,0,0,0,30
72456,444,235,0,17,10,1,4,2,209
75975,3703,1741,0,109,29,15,134,31,1962
17884,215,97,0,14,5,0,11,3,118
19343,7946,4075,33,163,124,21,175,118,3871
8724,40924,20068,343,1173,408,264,958,598,20856
2138,38835,18805,1117,1168,212,1072,1089,328,20030
60442,10531,5375,27,487,104,82,356,75,5156
61324,92,63,0,6,9,0,0,0,29
40356,43722,21155,214,1154,359,178,1583,764,22567
43228,54362,25985,427,1976,381,303,2026,686,28377
46742,3613,1839,24,131,43,19,69,81,1774
11566,33401,16741,117,941,350,123,975,565,16660
38563,3512,1632,21,112,63,26,89,34,1880
52758,220,111,0,15,5,4,1,1,109
28754,10138,5334,113,260,155,44,244,138,4804
27109,2570,1185,135,0,0,112,0,0,1385
31805,2431,1065,0,61,45,9,56,16,1366
12911,25,19,8,0,0,0,0,0,6
30071,25218,12824,233,1175,157,92,1055,128,12394
92626,50541,24776,420,2075,337,292,1889,707,25765
95918,2643,1538,0,86,91,0,29,0,1105
96087,589,363,0,18,6,0,0,12,226
85924,2696,1426,25,13,88,0,43,38,1270
85930,1337,737,6,47,3,6,52,16,600
97498,1539,730,6,57,24,16,23,26,809
10977,64882,32999,477,2142,413,405,2232,654,31883
3841,6437,3058,23,76,110,0,110,152,3379
1103,2389,1090,71,100,0,0,75,63,1299
27110,2601,1215,101,0,0,99,0,0,1386
32754,10436,5464,69,200,117,64,256,243,4972
34679,103,30,0,0,0,0,0,0,73
35470,4676,1948,76,96,0,244,157,17,2728
37090,15099,7718,46,463,297,57,297,218,7381
38040,4796,2422,47,40,17,61,127,96,2374
21802,89,37,0,10,0,0,0,0,52
22646,116,35,0,0,0,0,44,0,81
23108,222,97,21,0,0,0,0,17,125
23832,36849,17966,375,1268,308,125,1307,572,18883
24351,558,291,0,32,6,0,35,0,267
79534,83,50,0,0,0,0,4,4,33
80451,994,452,0,34,8,22,27,0,542
82058,47,33,0,0,0,0,0,0,14
82516,486,229,0,0,4,7,6,0,257
95350,53098,25467,312,1490,659,311,1421,851,27631
95468,1325,600,17,83,45,2,53,34,725
97441,382,133,0,27,0,0,0,0,249
98953,6954,3440,67,248,17,67,276,110,3514
92675,37457,17896,226,788,417,286,840,626,19561
76012,26919,12804,147,722,219,319,654,304,14115
84039,910,444,3,59,0,0,42,40,466
85206,36901,17843,333,1008,497,149,992,444,19058
76251,671,327,4,8,11,0,14,27,344
77382,39861,19465,81,804,224,205,1130,514,20396
77546,53320,26003,253,1633,455,154,1691,580,27317
40346,864,465,15,28,24,0,33,13,399
41214,617,320,0,42,0,0,33,0,297
41838,499,299,27,4,29,0,41,0,200
42130,313,133,0,19,0,0,0,0,180
42459,4128,2021,20,84,38,80,106,34,2107
42647,3422,1749,0,73,67,42,106,73,1673
43566,7926,3894,30,363,127,0,305,85,4032
62034,13667,6914,71,475,175,39,440,170,6753
64456,1429,657,4,55,10,3,21,5,772
56436,39,20,0,0,0,0,0,2,19
46771,0,0,0,0,0,0,0,0,0
47010,249,127,0,18,0,0,0,5,122
2367,2945,1524,7,63,6,13,76,62,1421
68817,312,151,0,16,5,0,7,0,161
62266,87,43,0,13,0,0,0,0,44
58352,501,278,9,24,2,0,16,10,223
72565,685,334,3,17,7,0,53,15,351
73089,12689,6288,26,406,92,48,444,198,6401
79739,1213,678,12,45,23,0,46,14,535
1010,3739,1833,26,33,48,0,115,47,1906
97324,1297,612,0,23,22,6,28,30,685
91767,50264,24420,375,1495,314,337,1680,532,25844
87734,212,106,0,1,9,0,3,0,106
40342,21952,10735,92,634,200,151,646,474,11217
34428,9369,4415,64,274,172,125,135,160,4954
35079,9267,4659,50,139,49,14,169,109,4608
35204,9399,4263,53,257,146,58,162,155,5136
36311,2715,1399,26,116,22,14,40,21,1316
30731,2221,1133,0,17,65,27,60,30,1088
32352,6698,2984,43,268,109,148,291,47,3714
63112,18744,8923,143,560,88,176,719,237,9821
63369,1940,896,0,55,8,6,93,59,1044
18066,6332,3207,13,132,48,0,174,71,3125
18935,18,18,0,0,0,0,0,0,0
70788,3790,1939,23,85,34,22,113,80,1851
71952,96,62,0,0,0,0,0,0,34
52543,371,227,0,0,0,0,0,0,144
53566,15156,7245,79,445,208,56,486,111,7911
45115,143,94,0,0,0,0,8,0,49
49816,706,383,6,12,11,1,15,31,323
50620,42,17,0,2,0,0,0,1,25
50638,3297,1633,12,91,40,20,102,39,1664
53001,1825,954,19,93,35,13,67,48,871
54001,7782,3732,62,183,113,51,239,128,4050
35042,5961,2860,0,155,114,0,138,130,3101
38352,654,315,0,0,30,14,0,35,339
59066,586,313,8,17,8,0,19,13,273
38940,1637,812,5,41,24,0,40,0,825
40601,51082,24684,225,1333,518,419,1478,995,26398
48075,22052,9645,112,447,266,176,773,412,12407
49238,1648,828,12,59,24,10,40,22,820
55405,16169,8646,54,777,122,67,640,116,7523
31648,912,366,0,27,0,0,42,0,546
17701,43427,21869,480,1191,508,686,835,475,21558
20606,459,222,0,0,12,12,0,8,237
21206,51561,23624,497,1630,436,339,1755,815,27937
12926,2192,1187,17,87,18,9,46,40,1005
13060,2809,1251,28,47,35,36,40,23,1558
13778,5557,2682,13,121,47,43,125,113,2875
14723,1104,554,4,46,8,0,52,17,550
16329,518,269,5,9,8,9,10,7,249
25045,5140,2500,0,161,62,15,136,11,2640
12491,1535,730,0,21,27,14,27,36,805
6786,9391,4477,88,381,69,28,335,175,4914
1438,711,385,0,75,0,0,47,0,326
54015,3520,1732,16,173,26,49,119,26,1788
54247,2052,1103,8,71,32,2,37,45,949
54962,1158,642,2,46,18,4,20,27,516
55902,25050,12126,86,879,228,101,964,367,12924
55969,1017,514,5,29,16,3,27,12,503
45223,11982,5934,39,400,118,127,475,174,6048
14450,41035,19534,97,852,494,220,1222,640,21501
16229,5426,2795,38,169,70,50,135,99,2631
17220,399,183,0,21,0,0,18,15,216
30572,796,342,0,0,0,3,0,20,454
31046,3198,1764,58,131,51,0,110,73,1434
33437,38921,17945,59,575,406,26,668,394,20976
22639,562,325,9,28,0,0,0,10,237
24413,188,80,0,11,16,0,0,16,108
29571,14140,6612,113,525,178,23,415,200,7528
36116,44556,20437,266,1474,335,199,1478,543,24119
28031,27460,13129,152,1083,189,51,1124,290,14331
11692,20991,9755,73,484,136,199,704,262,11236
12507,236,137,7,0,0,8,6,0,99
13045,29223,14161,614,705,367,925,702,314,15062
6426,3509,1840,1,10,27,13,48,55,1669
7078,13097,6781,24,278,118,23,314,139,6316
1543,8586,4512,66,218,42,40,176,102,4074
48209,32620,16014,184,1090,194,280,1315,282,16606
46056,2347,1136,3,55,45,0,89,43,1211
37115,40484,19141,361,1216,318,219,1397,603,21343
59323,2520,1224,3,38,16,0,108,22,1296
50054,2909,1411,34,98,45,3,103,4,1498
59743,103,56,0,1,1,0,1,4,47
34203,37632,18245,93,1135,446,35,858,399,19387
36034,974,535,0,37,0,16,39,2,439
62010,11357,5709,23,318,134,29,384,188,5648
62419,230,128,0,6,10,0,0,16,102
67867,1874,924,21,37,11,0,84,12,950
68778,560,290,2,23,2,0,14,6,270
77960,56,56,0,0,0,0,0,0,0
79091,132,61,0,8,10,0,8,0,71
64071,571,267,2,0,20,2,9,16,304
57331,429,218,7,26,7,6,30,4,211
72478,370,198,0,0,48,0,0,0,172
81621,5929,3153,0,288,43,32,264,116,2776
70451,0,0,0,0,0,0,0,0,0
70756,364,185,0,0,30,0,48,0,179
62080,2433,1182,7,62,32,12,74,29,1251
70576,1128,721,20,103,5,6,31,0,407
99644,187,73,5,4,3,0,2,3,114
49420,6393,3299,56,205,54,32,141,78,3094
28580,12874,7303,61,605,119,44,285,239,5571
50055,903,415,3,43,7,0,32,6,488
51342,1318,639,7,34,19,0,66,19,679
40176,986,516,0,40,34,0,48,6,470
44032,1516,801,0,33,30,11,7,6,715
27609,32870,15232,101,1092,196,149,1233,346,17638
32963,14790,7154,68,48,295,0,70,324,7636
42085,981,531,0,40,0,17,48,6,450
84542,1522,751,16,60,6,19,45,20,771
86024,649,300,0,17,24,0,3,19,349
21629,9726,4742,24,296,55,16,294,157,4984
7026,31697,15154,124,1310,280,45,1401,322,16543
1907,14950,6853,71,353,201,57,351,213,8097
16942,837,428,4,13,26,2,26,3,409
38651,7744,3647,33,77,75,82,219,53,4097
57339,1605,808,9,44,21,16,39,17,797
58531,355,175,1,0,0,0,0,4,180
17941,808,422,2,27,2,6,16,8,386
54750,1062,521,10,34,15,5,32,19,541
49908,3444,2203,31,163,20,5,48,22,1241
51058,826,416,10,35,15,0,10,14,410
81050,9065,4270,61,177,125,52,376,100,4795
30216,2376,1250,52,188,27,12,17,40,1126
89191,628,492,138,0,0,20,0,0,136
15037,10557,5008,51,240,122,66,223,193,5549
12205,27212,13342,181,1067,348,54,888,647,13870
926,96530,44087,697,2448,788,494,2809,1216,52443
1604,37468,19054,145,1178,212,188,1144,364,18414
29331,194,107,0,0,0,40,0,0,87
66851,550,264,0,16,8,0,12,13,286
95688,37227,18597,125,828,549,302,1193,631,18630
53818,16304,8853,812,296,102,611,345,199,7451
97058,20470,10267,163,645,208,75,620,317,10203
97904,238,123,0,6,3,0,4,1,115
98373,25068,12596,318,917,227,210,1242,359,12472
94544,79235,39468,470,3071,632,671,2827,763,39767
41524,167,76,0,23,0,10,0,8,91
15926,2518,1326,7,30,43,16,53,20,1192
45216,8925,4489,34,290,99,14,519,110,4436
19523,463,251,0,12,0,0,0,0,212
98031,36750,18869,208,1433,357,237,1152,449,17881
35751,237,173,0,40,0,0,0,0,64
26372,589,332,0,52,20,0,19,20,257
47384,1851,939,9,59,16,9,42,23,912
47666,1842,914,16,32,12,14,40,2,928
757,22066,10650,178,733,221,217,748,172,11416
35749,22295,11162,88,963,80,76,832,204,11133
96743,14496,6504,6,439,305,17,408,134,7992
94304,3902,1950,40,290,10,0,180,37,1952
4677,327,160,0,8,6,0,18,1,167
75789,7972,4060,36,141,109,14,182,69,3912
77430,2104,1093,8,57,20,15,76,26,1011
48195,29268,13949,98,543,449,208,825,605,15319
77983,2301,1129,36,56,27,37,76,51,1172
48348,24257,12097,81,755,208,61,797,414,12160
84790,44224,22084,310,1289,566,255,1269,642,22140
38661,1860,832,0,0,35,0,23,74,1028
64654,46,29,0,1,0,0,0,1,17
65629,710,355,0,32,0,0,38,9,355
68460,717,388,0,26,10,1,22,5,329
28731,8354,4106,100,207,218,20,251,148,4248
37049,3685,1684,13,75,40,31,71,51,2001
80741,974,566,10,21,8,9,15,11,408
17050,37619,18060,171,1058,446,187,1079,604,19559
795,44766,21317,131,1374,383,322,1752,547,23449
31550,801,445,0,54,16,0,42,14,356
21219,9427,4617,59,204,98,78,427,141,4810
19053,26383,13019,186,988,334,161,634,277,13364
23663,13832,6497,201,302,76,156,492,130,7335
12504,1498,655,76,0,0,113,9,0,843
48607,1654,821,20,57,13,6,50,8,833
82901,29321,15494,110,1339,239,62,1079,307,13827
20762,2964,1556,74,88,14,27,146,6,1408
1086,372,185,9,0,0,32,0,0,187
12413,2815,1251,54,117,31,0,68,125,1564
5043,1009,503,15,4,11,6,34,13,506
33880,41346,20882,341,1103,529,297,1444,709,20464
36849,4108,1302,91,0,0,167,0,0,2806
24570,6,0,0,0,0,0,0,0,6
97735,94,47,0,0,7,0,13,0,47
73007,2349,1164,25,70,27,0,32,15,1185
73625,653,360,12,44,19,2,21,13,293
68526,6847,3437,18,245,124,21,288,55,3410
76245,2068,1040,0,19,109,0,43,0,1028
61435,29,6,0,0,0,0,0,0,23
61480,1210,583,9,40,10,13,31,14,627
70072,56308,26373,333,1569,572,331,1676,922,29935
36088,4802,2001,157,75,17,399,96,31,2801
48134,21792,10867,81,815,299,61,769,320,10925
27401,22105,10300,431,774,201,568,527,284,11805
27809,5083,2802,80,78,93,33,152,91,2281
21746,2953,2953,94,291,16,0,0,0,0
22947,3793,1778,0,112,65,72,77,41,2015
3048,3504,1738,6,103,73,0,162,69,1766
4259,3208,1523,30,101,7,11,122,35,1685
58713,18,11,0,0,5,0,0,0,7
58853,196,82,0,13,4,7,10,8,114
61770,1138,530,9,18,15,0,27,10,608
62601,353,184,3,6,0,0,0,14,169
63863,6201,2794,37,141,34,115,221,99,3407
68319,573,326,1,12,6,6,3,24,247
70456,2589,1103,6,132,17,6,160,38,1486
70541,346,171,5,12,6,0,25,4,175
70770,3441,1616,28,155,71,0,63,31,1825
71241,9996,5051,53,299,141,26,228,215,4945
72010,6557,3261,17,184,78,43,284,112,3296
64848,601,322,9,0,0,2,0,44,279
84320,2673,1423,7,60,76,17,93,18,1250
84521,834,396,0,46,8,2,50,27,438
76031,16855,8511,57,634,141,127,311,129,8344
72683,323,136,11,7,0,0,7,0,187
74080,2961,1492,0,97,32,0,108,18,1469
14103,10541,5174,55,282,74,30,260,142,5367
14727,5225,2610,11,111,119,0,218,85,2615
15122,19647,9360,56,540,281,58,551,196,10287
16720,1250,647,7,20,23,14,40,23,603
33569,27428,13424,205,852,319,91,657,247,14004
33613,34941,17953,751,1068,319,1007,833,310,16988
28524,304,101,0,0,0,0,28,0,203
29212,29586,13995,285,998,495,240,1109,505,15591
36590,0,0,0,0,0,0,0,0,0
37388,25511,12089,148,642,285,206,716,274,13422
37769,5763,2806,32,182,25,16,133,103,2957
37888,3290,1580,16,19,62,23,57,27,1710
15558,2302,1132,2,99,27,33,82,32,1170
15727,198,76,0,20,0,5,14,7,122
15929,32,18,0,0,0,0,0,0,14
8536,19793,9754,15,874,186,28,961,297,10039
17846,3853,1829,0,111,66,6,133,112,2024
18441,154,79,0,0,7,0,0,17,75
99748,172,104,0,4,0,0,4,4,68
76932,3769,1948,23,171,45,37,142,50,1821
77339,41205,20759,312,1381,400,207,1770,450,20446
80304,27038,13670,119,973,285,61,979,495,13368
65632,2446,1247,9,31,8,0,81,72,1199
69155,1121,636,3,16,9,0,17,32,485
89086,6060,2899,62,164,0,59,228,9,3161
78340,440,271,0,13,16,0,2,10,169
71483,10280,5750,85,481,184,154,164,151,4530
72057,896,417,0,11,8,0,11,0,479
74016,5697,2730,13,161,28,16,166,99,2967
90704,3922,1955,1,97,15,1,177,66,1967
92592,84418,42147,507,2219,819,467,2788,1161,42271
2916,9075,4304,32,283,109,41,282,89,4771
3269,2976,1615,0,68,23,0,83,92,1361
6483,16522,8225,167,416,222,109,572,184,8297
1570,16971,7728,82,532,156,158,763,235,9243
2109,3853,2139,18,133,22,20,97,46,1714
60099,30934,14888,186,1036,296,212,1162,445,16046
37814,34684,17382,148,1182,405,201,1114,369,17302
28659,21229,10615,128,731,295,128,771,223,10614
29113,1211,735,4,65,21,25,10,10,476
43105,7626,3843,68,278,64,22,248,95,3783
44633,2634,1421,48,92,42,17,50,28,1213
45131,227,94,0,4,1,0,5,2,133
45246,14206,6421,107,284,129,0,358,207,7785
56223,1432,676,5,41,18,12,31,29,756
57758,91,55,0,6,0,0,0,0,36
62067,2755,1226,0,33,43,5,23,26,1529
43974,75,39,7,0,0,0,4,0,36
44053,18895,8479,140,531,197,98,426,160,10416
46104,879,485,0,18,19,0,0,23,394
49638,873,471,5,16,14,8,13,30,402
50249,1276,664,7,21,18,3,35,12,612
43220,26549,12940,102,676,217,47,735,323,13609
34668,47309,22569,328,1069,528,345,1208,638,24740
35967,16373,8048,212,418,224,68,679,159,8325
89015,42748,21415,305,1201,601,201,1117,680,21333
89045,2051,1134,0,81,0,0,10,29,917
89820,5481,3184,53,285,37,50,109,85,2297
98115,53431,25685,176,2043,612,296,2170,487,27746
91931,496,198,0,33,0,0,63,0,298
1028,16200,7472,50,342,230,130,497,246,8728
24536,259,120,0,34,0,0,36,0,139
38545,1612,799,18,15,35,7,93,5,813
38850,2846,1443,0,105,26,38,121,14,1403
40404,853,351,38,0,0,85,14,0,502
29370,1187,568,69,19,13,0,54,0,619
30562,1386,652,13,50,6,0,0,2,734
37211,76834,39146,649,3165,524,327,2915,526,37688
18503,1158,739,9,48,11,0,22,0,419
18509,13744,6875,164,557,154,135,424,165,6869
19007,20925,9742,160,757,229,169,772,221,11183
21840,349,171,0,0,13,0,0,19,178
23968,577,226,0,0,15,0,8,0,351
24954,3905,1859,37,126,62,9,125,53,2046
42254,230,127,0,4,2,2,4,3,103
43332,1734,862,3,72,24,7,42,27,872
32308,22441,10166,154,894,173,123,537,357,12275
32311,21038,9908,42,730,253,176,937,326,11130
32696,12363,5941,257,298,79,49,280,265,6422
49866,8092,4088,10,245,137,31,277,115,4004
46050,2215,1056,5,85,24,12,55,31,1159
67743,141,78,1,0,0,0,0,6,63
64132,14817,6778,56,345,78,99,511,265,8039
48235,44753,20079,369,925,350,374,1382,623,24674
54653,943,469,2,30,5,4,21,3,474
61751,83,45,0,8,0,0,0,0,38
62258,9253,4514,53,449,149,39,285,171,4739
75231,41072,21209,225,1915,305,311,1470,458,19863
5874,541,256,0,10,8,0,3,4,285
7401,6762,3004,17,123,133,16,169,72,3758
31027,8966,4306,65,285,92,32,378,101,4660
35653,11043,5721,147,341,91,0,356,84,5322
35670,6667,3481,86,248,84,130,287,81,3186
35904,14030,7126,43,427,137,91,314,214,6904
37187,7360,3651,33,167,67,8,343,165,3709
99151,132,61,0,4,3,0,0,5,71
99561,501,265,6,10,5,0,10,0,236
57041,95,51,0,12,0,0,11,0,44
58005,920,479,0,23,16,0,46,5,441
58277,158,77,0,3,7,0,4,4,81
59061,243,136,13,0,16,0,0,4,107
59845,1295,654,5,31,40,0,32,14,641
87320,540,266,4,20,4,14,4,11,274
65591,1903,1012,0,42,33,0,35,19,891
67118,703,331,2,32,6,1,36,3,372
67223,582,336,0,0,8,18,15,16,246
68926,600,286,7,23,10,7,13,11,314
60126,48410,23842,248,1347,534,258,1508,599,24568
52726,4716,2431,5,105,48,16,124,74,2285
54160,279,153,7,2,1,5,2,2,126
54205,1956,993,4,68,15,14,36,33,963
54437,3034,1552,31,64,36,2,63,48,1482
57538,240,135,0,10,0,0,13,4,105
62571,1659,846,10,37,27,21,41,34,813
97604,152,110,0,0,0,0,0,0,42
78592,840,426,13,12,13,7,24,0,414
79719,598,293,0,18,5,7,5,5,305
76530,2037,1128,0,90,26,3,32,35,909
56162,223,112,0,2,6,0,6,4,111
72355,2285,1039,87,11,64,0,38,8,1246
74470,1488,748,9,41,22,0,50,27,740
75251,2414,914,11,52,16,0,57,32,1500
75771,20488,10277,97,876,270,50,614,501,10211
49706,4509,2246,29,118,30,65,140,67,2263
49894,676,342,0,54,0,0,94,18,334
50002,1460,738,12,43,20,0,49,18,722
54207,142,76,0,11,2,0,4,4,66
64475,363,197,0,6,4,2,13,0,166
66044,28701,14686,1569,776,210,491,799,265,14015
71439,1818,771,10,12,24,18,63,17,1047
71766,801,440,0,14,25,3,11,5,361
71865,159,72,0,5,14,0,0,2,87
61615,23168,11005,34,541,323,142,648,456,12163
61818,1712,880,24,114,21,20,49,16,832
84624,5723,2941,15,293,70,51,165,49,2782
80471,0,0,0,0,0,0,0,0,0
88347,118,66,3,0,0,0,0,0,52
95030,13288,6473,7,291,207,7,314,168,6815
78056,1936,773,0,62,17,0,62,62,1163
28673,6307,3285,68,238,86,0,197,199,3022
29655,6915,3338,30,305,79,1,199,181,3577
37341,11212,5415,42,195,146,63,321,231,5797
42207,1127,471,8,11,0,9,18,24,656
94533,75635,37510,562,2591,344,449,2573,884,38125
97039,514,278,2,30,6,0,9,3,236
98273,30595,15438,114,1096,193,186,886,357,15157
2081,19378,9424,134,563,120,70,631,190,9954
54891,3318,1723,24,104,52,10,73,58,1595
42445,10752,5246,70,386,226,148,347,145,5506
43905,107,51,0,0,0,0,0,0,56
44047,9122,4512,76,288,105,31,335,217,4610
65761,1058,569,18,15,35,2,16,6,489
39755,681,265,16,24,0,0,7,0,416
42748,8882,4306,56,500,70,0,197,124,4576
37681,6055,2780,88,140,0,26,215,54,3275
38664,3074,1455,0,217,11,0,126,10,1619
61327,1326,692,12,41,23,3,26,30,634
62560,1196,487,11,17,21,7,29,32,709
62650,26749,13481,512,836,295,225,639,331,13268
55748,1394,703,9,25,13,7,56,35,691
56172,3008,1467,14,58,42,22,82,35,1541
56369,667,380,0,16,12,10,29,19,287
53093,2029,1082,2,85,30,5,66,24,947
49636,401,210,1,0,19,0,0,11,191
7733,16566,7740,82,224,188,0,297,291,8826
8060,24364,11964,113,1111,343,122,940,377,12400
8823,9301,4497,0,522,72,38,442,150,4804
21678,1771,795,3,40,54,29,26,56,976
26343,293,121,0,27,0,0,42,11,172
18439,502,286,0,6,19,0,7,3,216
28778,9939,4732,125,306,113,67,380,137,5207
28792,34945,16804,258,951,258,228,685,327,18141
11790,17694,9307,480,299,123,546,370,210,8387
78563,190,68,0,0,0,0,0,14,122
53558,11866,5971,0,343,133,40,470,292,5895
61485,447,242,0,11,6,0,2,10,205
67563,318,170,0,0,8,4,2,0,148
67839,1377,714,0,53,41,7,19,9,663
70038,250,120,0,10,0,0,9,12,130
63129,53671,25854,520,1644,777,385,1831,1053,27817
64152,29231,14406,65,894,291,87,940,289,14825
74834,7712,3896,52,175,89,48,204,169,3816
75044,41901,19806,281,1266,436,240,1541,647,22095
31011,694,365,6,33,1,15,22,22,329
49853,1163,611,4,14,24,11,25,33,552
50231,170,78,0,4,0,0,4,1,92
50255,73,44,0,0,0,0,3,1,29
53527,10906,5466,14,360,55,135,420,139,5440
55403,16588,9217,34,730,138,47,354,140,7371
41564,935,445,0,58,20,0,77,0,490
42455,3103,1632,13,68,13,48,72,44,1471
43920,22290,10605,150,811,233,92,501,424,11685
45062,686,382,3,11,8,0,28,18,304
39531,17521,9108,52,740,179,187,627,202,8413
32618,8058,3623,81,186,176,101,234,240,4435
46514,41297,19940,191,1242,313,202,1147,497,21357
47860,384,217,0,6,2,6,15,1,167
36915,805,391,0,28,8,0,19,1,414
16645,163,82,0,7,1,0,11,1,81
7068,5849,2791,16,136,74,61,119,64,3058
7446,14920,7375,154,174,287,41,453,178,7545
7931,3174,1658,0,56,22,10,36,82,1516
8224,538,269,0,21,0,8,22,15,269
28364,15183,7377,148,465,114,66,463,148,7806
29001,2029,884,0,64,28,0,65,92,1145
29686,935,502,0,12,11,42,33,16,433
30012,27605,12931,117,1049,187,147,1077,304,14674
11385,106717,53086,651,4366,822,633,4855,1343,53631
11772,45964,23069,321,2030,532,193,1750,627,22895
12517,455,276,12,0,0,0,13,0,179
23409,194,109,0,18,0,0,17,0,85
23436,1038,546,7,64,23,0,34,33,492
21212,33342,15819,215,988,270,275,1321,436,17523
94501,63843,30784,341,2034,669,273,2530,895,33059
95330,21552,10932,239,685,153,92,742,216,10620
97112,2019,1041,20,27,38,35,53,39,978
91803,30385,15190,150,845,329,153,999,396,15195
1225,3135,1630,13,55,50,0,65,28,1505
61520,16806,9163,169,860,238,98,386,196,7643
62520,1637,781,10,79,16,0,26,3,856
62820,152,81,0,0,2,0,5,0,71
71072,1367,655,0,61,53,0,61,10,712
71334,10390,5430,52,462,121,44,331,195,4960
72577,814,454,0,19,29,0,19,26,360
81248,102,52,0,0,0,0,0,0,50
58455,393,190,0,10,4,0,6,2,203
67474,273,118,0,5,1,0,1,0,155
65339,527,277,17,11,4,7,7,13,250
66554,551,260,0,14,8,0,22,9,291
73528,559,290,0,32,8,2,21,10,269
75555,1672,848,2,27,2,0,20,22,824
77013,20706,11339,261,993,118,296,795,100,9367
52404,39284,19675,238,1399,359,212,1458,296,19609
53571,161,86,0,0,0,0,0,0,75
53589,20191,9783,125,707,284,64,693,291,10408
55040,12893,6789,45,432,137,93,315,123,6104
36539,809,347,17,8,42,24,7,8,462
37397,9525,4949,32,233,124,61,179,46,4576
38730,2104,989,1,61,13,11,50,21,1115
40448,49,17,0,0,17,0,0,0,32
44119,13108,6615,46,474,195,129,529,176,6493
44437,4406,1989,10,59,14,12,96,48,2417
59447,209,116,0,0,11,0,8,0,93
61238,3534,1871,14,196,54,4,110,39,1663
61358,312,152,0,16,2,5,13,1,160
61865,1560,782,3,34,21,27,34,16,778
50263,23858,11527,46,987,109,104,1016,174,12331
4413,199,117,0,21,0,0,0,0,82
5345,2383,1126,17,73,43,8,64,47,1257
7608,107,48,0,1,0,0,6,0,59
15031,331,115,0,0,0,0,0,0,216
41124,983,578,13,51,17,13,17,20,405
47805,12695,6420,107,396,111,72,437,152,6275
13436,123,91,0,0,2,0,0,0,32
29306,16085,7361,89,271,107,131,531,100,8724
29835,6112,2999,55,224,135,55,108,157,3113
26384,615,376,0,0,11,0,10,0,239
28101,826,352,2,34,0,16,25,17,474
44423,2423,1109,0,53,5,0,79,46,1314
45642,0,0,0,0,0,0,0,0,0
35555,9617,4905,47,241,143,63,257,154,4712
39354,2894,1343,126,16,23,118,59,16,1551
31216,17246,9350,66,533,190,52,505,235,7896
80644,3207,1587,0,58,24,20,102,42,1620
20194,12421,5917,24,516,130,93,396,253,6504
83615,1639,864,0,27,14,0,32,1,775
20758,466,241,0,10,0,0,0,0,225
11959,784,363,0,0,32,0,5,10,421
75850,674,401,0,2,0,0,0,17,273
12308,15422,7570,213,457,88,88,570,175,7852
69169,589,277,5,14,7,0,26,6,312
85035,58327,28128,615,1967,344,688,1862,411,30199
27299,5945,2944,99,124,18,38,214,70,3001
70393,929,426,0,8,30,0,26,0,503
24265,680,264,0,31,0,0,0,0,416
95630,76973,40091,214,2710,668,228,2536,904,36882
24574,3882,2104,66,105,62,67,17,65,1778
25107,492,231,0,14,0,0,0,14,261
93460,4929,2484,30,42,113,60,131,94,2445
11782,14915,7245,66,389,111,90,425,196,7670
63744,113,47,0,0,0,0,6,1,66
47933,27661,14284,369,750,326,77,870,306,13377
48438,6956,3353,19,104,68,31,194,68,3603
37042,77168,38573,846,2492,659,774,2747,871,38595
38135,29714,14370,159,685,433,209,899,707,15344
38334,2054,948,43,24,17,50,56,30,1106
47576,346,138,0,0,8,0,0,8,208
79605,29639,14937,333,917,306,194,921,451,14702
80125,10552,5388,54,368,197,0,483,175,5164
80214,26245,13719,180,1282,355,96,1323,295,12526
83204,18435,8805,114,656,250,70,758,309,9630
62036,803,450,0,21,19,0,20,15,353
62836,800,423,12,24,9,0,51,30,377
73074,1095,526,9,38,9,3,47,38,569
67543,2029,983,0,44,13,3,71,62,1046
68841,482,242,0,14,5,0,14,11,240
70659,1628,774,24,30,44,19,78,11,854
75640,4585,2582,0,215,61,0,194,26,2003
89005,15680,7896,23,267,291,64,328,191,7784
17876,1926,890,11,73,18,0,43,32,1036
17933,146,112,0,0,0,0,22,0,34
17970,3139,1464,12,99,35,32,85,29,1675
21619,5891,2841,27,145,70,0,238,150,3050
12430,1147,546,0,48,7,0,12,68,601
16912,2186,1163,11,106,37,23,104,6,1023
17502,2750,1370,50,135,25,6,111,39,1380
44301,15060,7391,116,403,167,35,574,139,7669
44667,13410,6874,171,358,130,89,407,144,6536
38652,16734,8355,218,431,172,127,665,287,8379
40213,16221,7808,108,650,100,87,715,320,8413
32703,50992,24596,251,1617,344,290,1894,597,26396
33331,25854,12935,143,760,315,80,845,240,12919
66932,90,42,0,0,9,0,0,0,48
68110,9286,5142,43,382,107,53,342,135,4144
62810,834,410,3,28,14,0,35,18,424
58227,499,244,1,21,10,1,8,12,255
58521,615,297,6,13,25,0,14,0,318
58523,3721,1902,17,142,57,0,106,44,1819
59014,1733,835,24,24,23,0,35,21,898
62357,475,188,4,0,1,6,17,6,287
48179,3596,1781,36,88,26,0,153,101,1815
48813,20972,10364,148,566,278,141,718,383,10608
71031,1033,501,37,2,31,2,75,22,532
71234,3878,1934,12,106,50,0,100,59,1944
72127,2168,1097,6,80,7,3,66,62,1071
72175,291,135,0,4,0,4,0,6,156
74825,2099,986,3,41,12,4,43,27,1113
75438,908,459,0,31,12,0,46,18,449
75703,41842,20449,415,1085,322,200,1203,661,21393
45380,5385,2567,17,149,46,5,127,87,2818
55128,28849,13466,155,818,318,174,775,438,15383
54758,4473,2208,15,105,62,21,149,52,2265
36580,5762,3031,22,157,19,42,194,81,2731
39301,26208,12689,102,934,291,261,942,432,13519
33401,28287,13532,285,1041,228,326,767,301,14755
33430,22603,11261,213,551,344,179,519,308,11342
33487,20176,9744,0,724,436,136,508,361,10432
41540,224,132,0,4,0,0,12,13,92
41632,480,239,0,10,10,0,5,9,241
49611,266,122,0,25,0,0,0,0,144
14032,8955,4611,62,269,45,13,266,85,4344
15656,10115,5037,76,259,149,22,240,189,5078
4860,1537,757,0,42,46,29,44,91,780
6489,33620,16170,145,1030,542,92,1009,526,17450
24161,484,248,0,21,0,0,0,6,236
24915,501,252,0,35,4,0,0,8,249
19941,2853,1190,17,145,14,0,46,11,1663
10701,59312,28336,310,2158,584,466,2148,931,30976
11797,8737,4073,23,197,137,41,160,83,4664
12433,549,232,0,25,8,0,0,7,317
12752,251,147,0,9,0,0,8,4,104
1773,4775,2256,6,66,99,18,49,96,2519
2653,5852,2646,0,171,58,0,168,165,3206
26520,1204,541,0,37,0,81,39,23,663
59062,7,5,0,0,1,0,0,2,2
59530,71,31,0,0,5,0,0,0,40
60108,22766,10740,217,819,284,96,938,384,12026
57470,94,57,0,0,0,0,0,2,37
58205,338,264,30,0,0,3,0,0,74
35587,676,407,33,0,9,8,9,0,269
41538,49,31,0,0,0,0,0,6,18
42733,1107,522,0,36,15,0,23,10,585
46776,1399,795,1,52,32,7,37,4,604
50604,1679,849,20,26,31,24,20,32,830
12136,699,314,0,26,8,0,23,22,385
12775,1986,979,0,88,79,51,15,37,1007
52641,12254,6324,105,438,173,87,323,144,5930
53098,11770,5821,40,383,108,64,273,175,5949
54208,6367,3255,41,159,80,39,174,116,3112
29630,14972,7402,331,313,153,571,255,221,7570
22476,385,170,0,38,0,0,21,0,215
22851,5920,2880,12,221,70,19,185,66,3040
22964,330,146,0,5,24,0,16,0,184
24221,519,223,0,0,0,12,19,21,296
11576,12099,5658,7,292,213,62,265,218,6441
12831,17228,8639,97,598,122,100,449,220,8589
13118,6039,3496,37,249,54,59,130,56,2543
24630,7177,3702,7,179,163,3,220,105,3475
92708,57416,27901,272,1467,679,318,1608,894,29515
87317,1696,856,0,196,0,58,5,90,840
83540,2417,1178,7,63,21,13,98,15,1239
84084,38383,19576,339,1691,385,275,1393,280,18807
98447,735,317,43,0,0,64,0,0,418
99751,143,70,4,6,0,0,6,3,73
7456,12147,6007,78,408,78,23,353,147,6140
7606,2580,1357,20,117,15,7,123,14,1223
2818,18190,8656,29,523,198,115,393,317,9534
2831,3501,1791,15,122,32,0,166,37,1710
6108,24672,13113,143,800,230,134,947,225,11559
25510,4888,2501,0,133,130,45,150,24,2387
27816,2578,1391,52,83,24,0,15,43,1187
28056,34401,16204,146,843,449,178,944,501,18197
35071,16181,7848,23,484,204,87,562,238,8333
35954,11818,5621,105,397,174,82,439,186,6197
37076,38957,19208,159,1241,252,182,1704,611,19749
38012,13941,6235,90,384,163,37,572,199,7706
28606,1689,904,0,36,25,0,83,14,785
80642,3842,2210,26,118,88,0,137,58,1632
83210,3533,1825,20,155,39,5,72,83,1708
94518,28428,13904,149,1184,221,123,985,492,14524
97837,58,36,0,0,2,0,0,6,22
99131,138,77,0,1,1,0,1,3,61
92562,64116,30339,186,1814,548,443,2037,635,33777
92603,19650,9645,49,726,262,32,852,114,10005
84731,225,95,10,0,0,0,16,0,130
85912,292,155,31,0,0,0,0,0,137
40157,893,441,0,17,17,0,13,29,452
40258,26937,13501,140,901,307,140,906,234,13436
40801,526,301,0,10,19,0,43,19,225
42211,13373,6636,63,328,196,6,421,310,6737
42332,149,96,0,0,0,0,0,0,53
43221,32913,16054,82,1359,305,87,1475,488,16859
61353,1201,566,8,32,34,14,20,21,635
61562,44,35,0,0,0,0,0,0,9
62220,18302,9182,66,606,157,141,634,316,9120
62983,1411,715,2,61,48,7,66,3,696
63122,38686,18084,76,1248,453,133,1387,623,20602
63866,299,93,0,0,0,0,11,26,206
58038,353,171,0,15,5,0,12,12,182
45801,22688,12164,121,658,302,84,709,318,10524
46816,19219,8907,267,469,190,224,443,292,10312
61334,732,377,0,24,1,2,13,17,355
62016,3674,1826,6,114,25,33,149,50,1848
57703,16294,8384,166,500,397,35,410,206,7910
62972,1039,474,8,7,28,52,7,15,565
72130,835,344,0,40,37,11,14,31,491
703,26320,12779,230,822,234,138,689,342,13541
956,65355,30611,405,1912,616,251,2257,1041,34744
99588,803,429,0,56,3,26,7,3,374
90815,41026,20082,425,1045,351,423,1365,536,20944
40004,30301,14919,232,878,240,60,1021,464,15382
45252,4336,2287,29,119,61,17,29,82,2049
45788,1298,731,0,14,0,0,40,11,567
46765,5472,2864,36,244,29,0,229,91,2608
35564,2112,976,32,33,16,7,19,46,1136
36549,4996,2293,0,166,82,0,181,0,2703
37149,2713,1377,0,103,33,0,151,65,1336
37351,375,161,18,39,0,14,0,0,214
63389,6962,3255,22,111,54,133,153,49,3707
64058,7142,3460,26,329,44,11,200,36,3682
72072,459,237,3,7,5,0,10,8,222
57021,210,131,0,9,7,0,13,6,79
57255,323,174,0,6,7,3,2,5,149
72562,2201,1037,2,30,40,3,73,34,1164
73009,1308,704,15,55,9,3,30,20,604
50232,375,148,0,14,6,0,3,14,227
52318,845,436,0,13,10,5,34,2,409
52320,1251,639,8,34,23,5,61,8,612
44612,5518,2614,19,169,33,23,148,98,2904
45154,8994,4400,14,366,67,6,301,130,4594
46987,978,498,12,4,18,0,51,3,480
47522,470,257,0,9,1,2,3,0,213
47665,3681,1849,3,111,61,2,90,44,1832
49715,3357,1639,20,125,61,28,123,59,1718
50669,2164,1049,9,70,41,7,75,36,1115
37841,8971,4452,0,473,164,32,278,133,4519
56147,195,93,0,10,2,6,4,3,102
56446,1406,698,13,45,20,15,37,16,708
56586,1927,1022,2,61,18,0,81,41,905
47840,1815,888,11,167,8,0,119,18,927
41271,190,105,0,0,0,0,0,0,85
55368,2190,1111,2,77,21,0,44,20,1079
54945,3326,1758,23,56,50,13,93,40,1568
30308,18099,10114,107,1043,102,89,789,168,7985
31003,88,45,0,0,8,0,1,4,43
21632,6065,2719,7,103,38,47,98,137,3346
14082,604,265,0,6,0,24,14,12,339
15539,681,412,0,15,0,0,0,0,269
33165,56133,26817,488,1850,429,351,1622,876,29316
27869,1928,935,49,100,45,0,8,72,993
22603,15921,8129,88,506,180,110,257,149,7792
25638,1025,498,0,14,28,0,49,47,527
2675,6616,2792,0,125,118,0,117,147,3824
3860,4395,2242,9,33,64,26,144,81,2153
5443,6930,3383,0,199,143,87,215,174,3547
58532,267,156,0,4,3,0,9,3,111
60191,14147,7117,66,502,125,109,449,273,7030
64491,1764,925,4,65,35,10,47,25,839
77957,8617,4228,48,241,103,83,322,132,4389
77968,3198,1519,0,77,41,80,96,56,1679
64029,17769,8762,36,724,92,99,508,190,9007
56589,2161,1114,7,38,31,17,68,24,1047
72169,134,79,0,6,0,0,5,2,55
73063,623,275,0,4,9,0,41,5,348
73130,20604,10115,173,490,180,84,467,347,10489
70715,1389,678,0,77,18,0,55,23,711
71853,203,87,0,2,0,0,2,1,116
72005,133,99,4,0,8,0,4,0,34
98552,424,250,0,11,0,0,1,12,174
98832,211,100,0,22,7,2,6,1,111
80829,5794,3028,0,179,62,0,173,22,2766
94801,29958,14906,91,1181,350,323,1035,267,15052
28766,1222,625,0,21,7,0,78,17,597
37148,23982,11554,81,792,171,168,804,188,12428
37683,12930,7139,176,625,170,12,247,180,5791
38047,85,50,0,0,0,0,0,0,35
43906,8643,4276,79,270,75,33,376,176,4367
17213,557,255,0,15,3,0,9,4,302
31406,35457,17225,159,1121,399,181,1385,524,18232
23325,16342,7646,139,473,204,126,598,173,8696
28555,4767,2452,19,93,16,49,57,46,2315
29834,1609,865,0,98,0,10,46,28,744
18828,296,176,0,21,0,0,8,3,120
33867,393,215,0,0,11,0,0,20,178
34949,7429,3465,10,119,210,15,167,199,3964
27541,3718,1808,13,64,57,0,50,51,1910
12816,4269,2062,25,86,97,44,125,70,2207
48631,3965,2126,0,146,116,14,97,11,1839
49115,460,234,0,0,40,0,0,0,226
43311,18946,8868,111,627,249,44,660,278,10078
45167,3700,1898,0,43,89,0,27,49,1802
51341,25,19,0,0,1,0,0,4,6
87575,775,568,0,16,28,4,0,0,207
99563,1144,649,8,52,5,8,38,2,495
84026,1467,650,15,6,0,25,41,18,817
80220,35999,17159,132,1507,292,255,1786,422,18840
80750,285,155,0,10,0,0,0,0,130
95979,430,246,9,6,2,2,2,17,184
96033,500,246,0,10,8,0,16,7,254
40068,2000,967,0,48,6,5,26,28,1033
56536,388,218,0,6,10,0,16,16,170
57117,34,34,0,0,0,0,0,0,0
57386,224,106,0,4,3,1,1,2,118
58852,1584,884,24,51,24,6,33,11,700
59353,1175,561,0,27,9,0,22,22,614
54737,578,307,0,33,4,0,34,0,271
45744,2747,1365,16,134,48,19,72,25,1382
46231,10312,5211,17,507,55,53,268,166,5101
43019,9295,4632,54,273,64,33,436,204,4663
43230,58167,27636,229,2422,633,156,2292,704,30531
43442,1170,624,0,27,41,4,19,18,546
61810,346,162,2,19,7,0,17,9,184
62476,1590,812,8,28,21,4,44,22,778
62951,4535,2278,16,69,10,0,233,36,2257
63849,113,48,0,2,6,0,0,1,65
32508,5381,4237,498,25,0,59,33,0,1144
32735,4673,2418,0,52,73,0,91,40,2255
33131,16715,8071,15,989,80,82,763,193,8644
23115,135,77,0,0,0,0,0,0,58
24946,1448,834,18,66,32,0,10,10,614
35010,20625,9757,160,491,140,77,708,265,10868
35740,3219,1466,0,107,54,9,146,62,1753
27560,32801,16291,232,2172,79,51,1948,305,16510
28543,5153,2828,324,42,0,219,14,0,2325
28613,22233,10818,63,648,229,73,749,209,11415
95422,15550,7760,98,446,232,135,356,172,7790
96114,3316,1652,0,82,35,0,50,50,1664
99139,1339,626,0,75,6,0,57,6,713
99163,34632,17504,1427,784,99,1503,629,196,17128
16728,54,28,0,0,0,0,0,2,26
16950,3291,1653,5,115,50,7,62,77,1638
32601,18579,8948,926,488,88,1040,392,70,9631
33847,171,87,9,0,0,9,0,0,84
33991,22354,10704,78,859,256,248,435,211,11650
35183,1062,521,0,9,13,0,85,15,541
24236,3152,1514,5,163,60,11,118,34,1638
30411,4766,3357,55,302,39,13,56,40,1409
30803,965,411,14,44,13,0,33,36,554
31553,4369,1966,21,116,67,18,119,14,2403
13164,2587,1297,15,113,23,0,138,31,1290
13343,1772,941,5,84,18,11,60,35,831
3748,4864,2303,0,267,80,105,117,74,2561
3812,577,314,2,3,0,1,0,4,263
70634,26058,13092,157,979,259,95,1010,285,12966
71401,257,130,0,22,0,0,19,0,127
71424,917,423,14,68,17,0,20,23,494
74134,16254,8399,105,592,133,166,495,141,7855
51039,2521,1260,4,58,21,18,73,43,1261
81057,512,274,5,14,2,0,17,10,238
83336,5562,2598,19,198,125,0,164,76,2964
92210,5049,2447,0,7,123,0,10,111,2602
93203,22744,11490,161,660,141,328,758,213,11254
87310,1151,582,18,52,14,0,37,15,569
87418,958,556,0,31,10,0,52,9,402
88242,7174,3678,83,208,64,9,275,99,3496
88410,105,40,0,9,0,0,7,0,65
97361,12091,5986,262,252,109,370,245,172,6105
83631,897,442,0,7,51,0,40,15,455
84083,1274,706,0,35,3,27,54,0,568
38633,2128,1151,28,4,41,24,72,25,977
47443,1332,701,6,27,10,7,62,25,631
81415,1506,708,0,42,1,0,45,10,798
81625,12478,6333,83,477,209,34,410,251,6145
85539,4595,2103,30,10,34,0,31,42,2492
56651,630,319,4,6,13,4,18,6,311
57232,288,152,0,21,13,1,10,4,136
58238,184,101,0,1,4,0,9,0,83
79928,57324,27796,605,1903,194,522,2111,574,29528
63540,129,60,1,2,0,0,2,1,69
73753,414,226,0,0,6,5,12,1,188
23113,25076,12111,289,703,419,91,683,269,12965
25287,1309,453,0,18,0,0,115,0,856
15864,1604,822,12,38,45,4,24,24,782
25401,14243,6472,154,440,133,162,293,158,7771
94525,3094,1443,25,131,34,31,77,66,1651
1077,9727,4747,16,302,71,71,196,219,4980
45851,746,371,10,10,5,8,15,0,375
47431,1586,784,0,54,9,17,11,45,802
31075,2677,1236,61,63,59,0,156,18,1441
32346,1769,1017,0,0,45,0,0,14,752
32541,18908,9297,54,538,267,93,573,292,9611
19720,61324,28976,387,1827,521,288,1976,670,32348
60616,54464,25807,296,1674,881,484,1855,719,28657
62081,354,181,0,9,0,0,0,5,173
71209,177,69,12,0,0,6,0,0,108
78342,427,220,0,0,0,0,16,0,207
78661,345,225,5,17,0,0,19,0,120
66047,19928,9660,305,596,187,491,579,281,10268
56208,2062,1057,9,40,28,0,51,54,1005
63953,1759,876,8,75,3,10,54,10,883
73019,0,0,0,0,0,0,0,0,0
82515,500,229,1,10,2,5,16,3,271
83236,2388,1208,14,91,35,48,81,13,1180
83342,1178,621,0,25,13,0,31,19,557
90303,24693,11821,223,649,280,106,667,235,12872
90305,15397,7020,107,348,103,63,477,360,8377
94517,13476,6483,44,319,85,105,378,195,6993
96001,34571,17041,94,1078,489,225,894,574,17530
3470,5126,2373,15,69,51,12,87,82,2753
4038,17307,8531,125,429,305,207,503,277,8776
4289,2259,1087,26,59,23,9,91,90,1172
5059,404,190,0,20,0,0,18,10,214
7203,21582,10247,401,572,133,158,715,405,11335
7720,4223,1962,0,172,46,48,205,0,2261
52037,1070,546,5,22,25,5,28,14,524
54456,5922,2948,17,226,67,17,133,66,2974
54901,38812,20322,770,1573,251,1086,867,290,18490
55376,17261,8902,0,713,57,88,604,116,8359
55786,358,205,2,19,4,0,2,2,153
42442,3131,1413,7,112,56,17,176,52,1718
37748,16860,8372,183,340,277,82,432,259,8488
38851,7853,4151,48,297,164,0,325,90,3702
51645,330,157,1,15,15,0,14,20,173
53562,25621,12610,189,815,269,52,790,403,13011
54104,1178,619,3,17,47,0,17,21,559
49266,3247,1628,13,62,118,8,71,18,1619
58046,615,315,2,13,28,6,3,12,300
59033,289,140,2,5,4,5,14,5,149
59253,92,39,0,7,3,0,11,0,53
72756,41494,20779,168,1410,467,169,969,563,20715
31637,2891,1474,14,73,43,11,92,113,1417
37023,1380,682,0,50,39,0,40,12,698
40310,337,174,1,25,0,0,3,12,163
43907,5760,2794,28,207,94,19,75,102,2966
46031,2336,1155,5,63,18,9,79,19,1181
46151,31810,15703,150,1105,392,136,1029,551,16107
33881,33463,15904,238,481,553,240,901,489,17559
35171,3679,1702,29,86,26,68,106,62,1977
36006,913,394,22,21,24,0,24,9,519
36203,18033,8649,66,702,100,87,879,282,9384
28332,354,148,0,7,0,9,0,0,206
29440,27897,12999,146,879,416,126,1170,554,14898
24225,1995,1140,33,85,0,0,25,13,855
49755,1947,988,8,28,29,7,37,20,959
50311,15740,7514,325,465,147,288,474,154,8226
50477,211,108,1,2,0,8,0,10,103
50650,881,452,0,29,15,0,16,7,429
72623,1054,569,0,46,18,0,55,0,485
75090,24580,12192,171,383,191,200,860,188,12388
48880,9867,6556,134,581,90,33,162,73,3311
12886,258,119,0,0,0,0,0,5,139
12997,1199,603,4,34,8,0,46,18,596
6831,14629,6973,38,317,215,93,447,237,7656
58740,775,401,7,36,10,0,40,8,374
59748,214,127,4,4,8,0,0,0,87
60924,1485,761,7,32,60,2,52,15,724
61059,212,87,0,6,5,4,4,0,125
62236,13757,6630,11,347,181,83,522,271,7127
85339,46251,22518,323,1439,371,202,2150,591,23733
88351,162,92,2,3,11,0,0,11,70
76052,22744,11115,175,979,384,68,931,270,11629
76118,16300,7367,69,491,123,42,605,164,8933
89311,121,57,11,0,9,0,0,0,64
92345,80808,39632,809,2244,666,561,2083,1094,41176
77988,558,229,0,27,0,0,34,10,329
78055,1817,1010,26,18,35,0,29,54,807
97736,104,64,0,6,0,0,0,0,40
98823,11239,5922,11,437,180,0,362,164,5317
99161,1307,671,0,22,27,3,44,22,636
95555,337,161,0,5,0,3,15,15,176
97108,505,178,1,19,33,2,22,16,327
64855,2625,1278,6,108,17,7,152,12,1347
64861,1631,762,33,0,17,0,15,43,869
68037,2714,1214,4,130,11,21,193,38,1500
30528,24761,11897,152,607,269,110,585,234,12864
8009,13097,6340,70,287,125,42,302,210,6757
63769,1391,708,0,48,15,1,19,30,683
49421,5894,2954,24,115,63,32,91,129,2940
49733,2217,1109,6,33,39,16,56,38,1108
56663,161,78,0,14,4,0,4,0,83
20877,38885,19378,231,1679,426,348,1499,490,19507
21861,815,336,7,30,3,5,20,16,479
23420,3856,2122,14,81,23,0,43,19,1734
2885,10464,4932,17,290,190,19,279,150,5532
5903,904,504,2,16,17,0,28,8,400
7823,7834,3779,35,104,181,0,176,150,4055
15552,5899,2850,48,168,66,16,164,72,3049
11975,223,126,0,11,0,0,11,0,97
13033,3801,1953,20,101,37,27,117,111,1848
14504,1873,947,17,57,32,8,54,9,926
10475,43208,18358,328,1076,387,153,1812,653,24850
740,1625,752,11,24,14,0,21,19,873
80549,11342,5782,0,419,89,57,507,197,5560
84117,25240,12485,93,905,195,202,798,388,12755
92056,53845,26545,427,1773,557,242,1677,861,27300
98528,10056,5229,33,308,154,79,420,238,4827
93454,40604,20261,489,1467,254,361,1165,372,20343
95126,35988,18389,179,1679,202,44,1412,357,17599
97456,2684,1411,12,115,51,0,86,64,1273
76016,31318,15334,222,925,451,144,868,428,15984
54422,1402,718,11,64,4,13,54,12,684
55121,8571,4067,40,361,36,25,303,52,4504
65456,1034,520,0,27,11,76,0,36,514
67059,947,454,17,21,7,0,23,10,493
60146,2655,1354,17,49,35,0,67,31,1301
63837,1524,805,15,19,14,7,41,13,719
63874,370,177,0,0,4,8,6,3,193
48728,242,137,0,0,20,0,2,5,105
14560,2142,1124,23,49,63,9,52,21,1018
5403,18695,8959,54,484,210,142,732,281,9736
2119,28199,13453,477,564,385,214,956,471,14746
754,37727,18380,384,1236,542,272,1152,398,19347
28458,7024,3518,88,265,99,7,199,94,3506
12140,1552,766,0,0,55,0,0,0,786
26804,839,487,18,15,21,3,28,8,352
27966,738,424,0,12,10,0,0,11,314
48030,16592,8961,87,728,226,64,614,198,7631
48841,768,390,7,37,7,0,36,4,378
53503,1987,983,9,85,29,16,59,47,1004
55334,2576,1290,20,123,27,17,67,37,1286
56320,8306,3985,113,234,89,24,207,63,4321
57553,97,62,0,4,0,0,4,0,35
44685,27842,13797,200,714,396,191,693,438,14045
45064,3060,1499,12,93,53,31,177,30,1561
35550,5761,2814,24,134,73,14,182,66,2947
38916,5116,2392,23,128,36,51,144,78,2724
46808,19386,9781,199,572,158,299,605,302,9605
49332,2771,1366,6,74,82,3,60,64,1405
44122,33342,15195,112,970,376,43,1215,411,18147
45070,185,90,0,8,2,0,4,0,95
45402,10053,5102,149,334,123,27,358,115,4951
56350,499,266,0,9,6,0,6,0,233
56444,3094,1571,12,74,94,8,56,42,1523
56672,2003,1016,11,27,40,14,26,31,987
57714,810,333,0,14,0,13,33,6,477
51005,1345,669,7,15,31,15,15,38,676
4776,1003,528,3,43,9,0,7,17,475
93241,16834,8649,28,593,32,90,550,113,8185
96107,1450,685,13,24,33,0,0,12,765
96110,161,79,0,5,18,0,0,0,82
97531,1075,575,100,18,40,0,0,0,500
98541,10211,5030,57,402,196,136,446,199,5181
93257,76923,39069,626,2145,656,454,2622,628,37854
93402,16350,8165,70,453,298,65,545,289,8185
94535,3857,1983,105,145,0,56,102,9,1874
79103,10995,5140,91,294,99,33,318,119,5855
92026,49921,25049,472,1489,531,266,1569,950,24872
92130,55316,27583,297,1689,405,57,2507,682,27733
12202,9624,4570,19,286,50,97,345,83,5054
1745,588,177,0,45,0,0,27,9,411
4939,1011,520,0,19,45,8,28,11,491
7662,5613,2625,63,181,70,43,58,33,2988
99625,76,37,0,4,0,0,2,0,39
99738,103,53,0,0,4,0,0,3,50
44134,37533,18475,202,1094,402,315,1276,681,19058
47926,1333,674,5,28,13,0,30,10,659
16726,731,430,5,38,11,0,5,11,301
8210,16413,8247,55,585,270,17,357,236,8166
12017,376,206,0,7,14,0,13,0,170
12134,4186,2042,37,76,136,53,151,49,2144
24139,423,221,0,13,0,0,0,24,202
3218,872,388,0,15,0,0,62,11,484
4965,2068,1029,0,73,42,0,43,40,1039
15062,7397,3450,38,206,122,102,252,72,3947
21639,4639,2069,35,151,6,3,199,45,2570
76110,31825,16562,229,950,272,452,857,356,15263
58401,17107,8785,124,580,224,155,416,262,8322
59933,79,48,0,3,0,0,0,9,31
15478,5851,2876,25,193,57,33,200,51,2975
17361,6511,3174,0,184,48,26,143,122,3337
19382,54460,26943,988,1515,585,1053,1520,782,27517
5488,8239,4100,12,271,19,48,276,116,4139
29550,31952,15515,175,727,463,143,911,456,16437
23316,440,208,0,0,0,0,11,0,232
14094,49170,24443,467,1449,728,208,1431,789,24727
14130,165,95,0,3,4,3,3,0,70
2874,5960,2953,75,143,73,42,146,99,3007
35461,2120,1161,11,110,35,18,39,55,959
36375,6962,3382,69,189,121,48,178,96,3580
44411,2328,1093,0,61,32,20,62,41,1235
39152,1361,665,0,90,0,0,99,15,696
40008,3331,1715,14,98,84,38,50,49,1616
45324,41029,19672,498,1540,383,676,1057,496,21357
45830,5796,2859,47,156,24,70,130,73,2937
28451,33435,15895,180,916,549,97,1238,716,17540
28167,2591,1230,10,50,0,0,173,77,1361
32732,4809,2506,0,113,86,24,79,93,2303
31801,3240,1492,6,62,49,0,33,33,1748
96029,195,108,0,4,4,0,4,7,87
97601,22451,11501,216,664,241,225,648,290,10950
97910,589,305,2,11,8,3,18,12,284
98374,39985,19480,143,1401,520,200,1575,389,20505
98831,2962,1581,2,88,81,0,114,14,1381
82225,2008,813,0,73,19,19,78,16,1195
94586,899,508,0,18,14,0,16,9,391
92103,34878,17354,102,1561,508,36,1548,344,17524
92262,28517,16255,109,783,553,277,489,260,12262
65201,45159,21797,2526,856,227,2560,803,290,23362
56389,115,44,0,0,0,0,0,0,71
57461,336,157,0,10,2,0,11,6,179
58847,418,236,0,43,0,0,42,0,182
67644,259,119,0,7,4,0,0,1,140
67674,72,32,0,0,3,0,0,0,40
67842,464,249,4,14,7,3,5,14,215
60018,30386,15503,278,884,248,176,1140,344,14883
54629,2571,1302,7,52,40,9,47,30,1269
78702,23389,12211,124,1360,242,53,935,123,11178
64689,630,285,0,17,3,1,7,1,345
65330,415,222,0,15,2,0,11,4,193
75633,13553,6777,180,438,92,89,555,283,6776
62667,445,209,0,14,15,3,7,9,236
63471,644,263,0,51,10,12,18,0,381
74112,20892,10313,149,796,191,147,667,256,10579
56475,1687,840,12,64,23,8,58,11,847
90713,29061,14312,204,986,289,262,1116,416,14749
92676,2154,1136,1,103,34,0,63,52,1018
87032,282,24,0,13,0,0,0,0,258
88240,40860,21299,318,1580,322,346,1420,374,19561
33177,58129,28523,544,1638,271,637,1688,714,29606
27504,15182,7751,115,443,193,18,429,116,7431
29335,5939,3595,104,278,76,0,134,60,2344
55372,33286,16796,102,1081,248,113,1058,394,16490
36529,237,119,1,0,0,0,43,0,118
37052,2803,1398,16,110,42,0,148,80,1405
37057,703,344,0,32,53,0,58,14,359
37178,2171,1090,13,30,17,5,39,16,1081
37207,38583,17550,94,1292,421,281,1469,403,21033
8215,13528,7053,44,315,151,122,360,196,6475
15658,8744,4297,7,130,118,32,149,121,4447
16507,9379,4837,44,265,35,190,223,73,4542
17814,4984,2589,24,162,80,20,85,72,2395
2468,5688,2802,9,121,155,0,89,62,2886
4640,2093,936,9,120,43,7,70,27,1157
75495,8564,4302,111,233,18,106,288,120,4262
76270,1834,887,0,28,30,0,44,15,947
66058,277,135,1,6,2,3,5,0,142
67665,4981,2466,44,134,52,0,108,84,2515
68104,36546,17348,167,1096,299,196,1310,350,19198
69043,504,229,0,15,14,1,18,14,275
73118,14087,7037,40,664,96,178,565,204,7050
74003,14194,6961,128,491,130,134,359,166,7233
74753,31,16,0,0,0,0,0,0,15
41642,445,216,0,29,54,0,21,0,229
43822,5115,2517,56,198,56,16,236,154,2598
70769,42887,21304,240,1665,425,312,1968,371,21583
71474,570,308,14,4,2,3,25,6,262
26521,226,104,0,2,3,0,2,1,122
27215,41204,19739,177,1167,375,156,1234,641,21465
54768,6211,3852,14,336,72,13,198,44,2359
54965,1368,692,4,56,15,5,41,27,676
55782,412,221,0,17,4,0,13,8,191
46779,2147,1104,7,90,14,16,85,0,1043
53070,4946,2430,3,141,73,30,119,52,2516
53715,14229,7908,1180,232,98,1100,152,17,6321
80203,20937,11176,19,1141,326,50,792,166,9761
82009,34247,17348,264,959,503,127,941,540,16899
84321,46655,23432,974,1435,255,1137,1211,311,23223
78742,828,385,4,5,5,10,35,5,443
87505,30659,14406,133,743,784,164,900,472,16253
15629,798,408,15,42,27,0,38,0,390
21798,1894,951,16,65,21,4,68,26,943
13160,2055,1015,0,41,18,14,78,11,1040
38637,27109,13012,264,815,127,230,1361,407,14097
44253,3212,1720,34,104,61,27,140,73,1492
46543,3289,1693,21,125,15,14,108,35,1596
47438,4416,1957,33,87,22,28,63,63,2459
34653,35015,16743,233,1172,364,124,1012,627,18272
36445,4713,2316,67,176,17,8,177,122,2397
28342,233,101,2,3,1,0,19,1,132
41230,12328,6119,74,387,196,15,443,148,6209
95819,19659,8926,148,672,194,98,689,235,10733
80821,1066,504,1,19,11,1,12,10,562
81054,4858,3285,42,302,60,6,27,64,1573
82229,1,0,0,0,0,0,0,0,1
84723,830,411,0,5,0,0,18,5,419
76127,2049,425,34,0,0,0,282,43,1624
78001,0,0,0,0,0,0,0,0,0
66754,385,194,3,0,1,1,1,2,191
66839,3739,1878,23,75,69,17,123,61,1861
67056,3098,1409,36,41,17,0,94,46,1689
68814,855,465,0,19,21,0,12,21,390
57363,995,502,3,45,9,0,39,11,493
57766,219,88,0,8,0,0,7,0,131
58784,3324,1980,8,191,38,0,101,35,1344
62548,2514,1178,6,115,53,0,99,29,1336
44870,39597,19450,385,1077,454,166,1209,669,20147
47683,180,88,0,5,0,2,13,20,92
72048,113,73,0,0,0,0,0,8,40
54986,5058,2433,29,130,66,10,119,91,2625
55768,2902,1500,33,43,28,17,57,46,1402
48864,23132,11213,251,792,371,447,577,268,11919
61021,23031,12648,197,1043,300,70,515,227,10383
44613,2012,1022,4,47,12,5,61,57,990
23313,103,57,0,0,0,0,0,0,46
23430,17348,8453,48,344,300,10,628,408,8895
24248,2304,1223,0,17,26,0,59,52,1081
72561,791,388,4,17,6,4,19,14,403
72701,43641,21477,1159,1072,240,1203,941,464,22164
75134,22337,10072,178,841,243,220,917,206,12265
75214,33906,16158,148,1708,274,101,1374,437,17748
80120,31830,15305,154,1138,451,91,952,583,16525
81019,1735,812,67,53,21,0,61,0,923
85333,715,387,0,15,10,0,20,11,328
17098,2307,1175,10,46,27,9,55,32,1132
18069,7789,3948,73,157,134,6,177,189,3841
6331,5074,2459,20,191,70,0,153,122,2615
19124,68965,32749,273,1897,319,773,2740,956,36216
24635,1430,1187,16,114,13,2,15,5,243
23111,36574,17758,220,989,386,116,1013,683,18816
23116,30689,15341,169,1019,267,76,776,501,15348
14172,2978,1399,0,110,52,11,135,90,1579
4448,1455,766,16,48,33,0,54,21,689
74445,2963,1380,20,90,31,11,95,39,1583
81122,8774,4668,7,387,143,24,268,149,4106
84635,732,376,3,18,0,3,10,6,356
85375,28759,13171,6,47,688,14,58,503,15588
78372,6174,2867,0,176,100,36,189,56,3307
80012,53032,26024,361,1837,366,191,1804,573,27008
95653,563,347,1,28,0,0,37,13,216
98208,57306,28531,391,2001,544,259,2009,665,28775
99571,126,81,2,3,2,0,5,2,45
31217,16735,7965,96,414,218,164,669,257,8770
32061,457,207,0,37,0,0,0,0,250
32066,7664,4429,39,345,71,0,219,64,3235
34788,16886,8015,26,321,281,37,243,351,8871
42758,122,58,0,9,0,0,0,0,64
43145,2189,968,0,40,21,5,26,8,1221
43224,44678,21681,131,1756,390,467,1762,448,22997
43901,1984,942,8,59,64,2,56,63,1042
6232,3223,1517,13,75,26,0,53,39,1706
1011,1448,712,10,69,18,3,41,22,736
1053,1702,961,0,41,25,0,49,44,741
2301,62929,29906,410,2244,718,557,2413,902,33023
23027,1090,549,0,0,39,16,34,64,541
25115,93,59,0,0,0,0,0,0,34
26047,6277,3191,9,195,74,52,155,79,3086
19365,7290,3514,19,286,90,4,276,87,3776
7416,5432,2602,34,134,53,28,166,100,2830
92121,4655,2422,189,147,33,108,182,8,2233
92392,58204,27424,406,1819,405,153,1820,886,30780
95387,710,393,0,0,0,0,48,0,317
87311,4021,1907,45,145,18,37,157,26,2114
87936,255,104,0,0,0,0,0,0,151
99691,114,76,2,7,2,0,0,0,38
61720,201,106,0,3,4,0,4,2,95
81143,774,415,0,20,26,0,37,11,359
83440,36202,18226,644,662,125,912,761,168,17976
68852,520,266,0,13,6,0,4,6,254
70373,7122,3689,99,280,32,9,159,53,3433
78076,13184,6475,57,303,92,170,454,105,6709
84063,234,123,2,4,5,0,22,0,111
59069,570,282,23,17,15,0,8,27,288
56239,622,300,1,19,8,0,27,9,322
49125,2275,1065,21,32,32,0,27,57,1210
49458,79,47,0,0,0,5,2,0,32
38676,6271,2858,56,217,52,32,302,107,3413
41821,478,202,0,31,0,0,62,0,276
35212,11896,5763,67,345,78,108,378,306,6133
44826,1803,923,0,57,12,0,76,32,880
62077,240,119,0,15,8,0,7,2,121
71016,1824,847,3,37,28,0,57,26,977
79744,1320,688,11,52,4,0,25,0,632
75081,39309,19123,288,1487,594,112,1385,736,20186
78023,31003,15601,258,942,321,209,1165,254,15402
64867,1124,601,4,36,0,1,41,10,523
65705,3954,1921,26,95,28,28,64,48,2033
65789,1666,938,46,66,32,0,33,44,728
14895,9354,4462,71,213,120,10,178,129,4892
15450,2224,2149,62,331,5,0,0,0,75
35661,16881,7826,81,242,114,102,466,295,9055
37040,50953,25292,369,1926,281,726,1512,500,25661
37150,4906,2335,0,101,48,81,124,51,2571
37861,8710,4307,47,322,209,22,285,159,4403
38450,3039,1491,15,102,38,4,90,29,1548
40350,143,63,15,0,0,0,0,0,80
45859,508,259,7,14,1,12,12,8,249
46943,259,107,0,0,7,0,25,0,152
47385,1319,704,21,33,21,25,76,12,615
47434,0,0,0,0,0,0,0,0,0
48612,9147,4675,67,181,134,24,204,154,4472
51009,154,79,0,14,2,0,1,2,75
41612,160,79,0,9,0,0,0,10,81
15681,4474,2366,38,113,84,31,79,69,2108
17244,2431,1191,0,94,49,16,98,52,1240
20616,6106,3043,37,194,0,0,211,100,3063
21157,36985,18125,358,1007,365,270,954,472,18860
21550,14112,6837,107,306,197,87,312,177,7275
22209,12705,6482,12,876,115,40,521,137,6223
22554,56016,28291,300,2438,380,269,2259,717,27725
23936,8440,4975,110,441,77,75,229,89,3465
4733,224,103,0,3,15,0,5,3,121
10516,5542,2770,18,156,45,20,163,137,2772
11375,73488,33695,151,2690,783,161,3304,1096,39793
29123,8525,4453,21,237,55,77,371,104,4072
18030,757,356,0,49,10,0,32,11,401
18038,2841,1432,0,36,24,8,28,33,1409
19362,5884,3021,32,174,37,4,220,131,2863
80137,1658,1096,0,26,19,9,6,12,562
80651,4316,2149,0,115,27,11,99,77,2167
82222,29,14,0,0,0,0,0,7,15
83452,2260,1293,0,106,2,47,77,0,967
84749,287,147,6,2,12,3,16,7,140
86028,0,0,0,0,0,0,0,0,0
15963,10501,5067,11,291,141,25,293,128,5434
16317,1296,674,15,36,8,9,43,23,622
16342,2270,1190,10,55,41,18,36,20,1080
16350,2580,1308,4,60,18,16,57,41,1272
7514,19044,8872,142,614,69,142,524,275,10172
75433,2614,1256,9,74,41,7,38,40,1358
75493,533,228,5,7,6,8,8,0,305
76401,30324,14483,765,920,269,620,830,241,15841
77057,41503,20943,272,2137,128,310,1667,344,20560
84071,1001,464,0,35,26,14,20,22,537
95920,285,143,0,0,0,11,11,0,142
96760,2917,1505,0,50,32,0,40,46,1412
99344,17999,9206,91,801,158,197,511,142,8793
91702,62348,30168,1046,1641,418,1338,2077,620,32180
91770,63425,31287,311,1578,720,564,1708,994,32138
7933,3231,1571,61,142,78,42,68,50,1660
25130,3306,1686,38,93,49,0,36,46,1620
12443,3378,1667,20,114,74,0,83,75,1711
12937,2045,1122,8,81,10,9,64,25,923
29582,16548,8140,82,499,406,20,309,340,8408
29916,1537,775,0,58,14,0,14,10,762
30076,46442,23123,197,1946,328,42,1812,638,23319
26452,9045,4457,62,213,100,97,254,117,4588
28393,2106,1045,2,50,37,0,89,56,1061
42056,1898,949,0,38,9,2,75,26,949
64683,8090,3980,51,185,48,110,126,70,4110
65529,224,103,0,37,9,0,37,9,121
67008,563,242,0,9,2,0,7,11,321
67023,315,153,0,2,0,7,11,16,162
68465,2248,1105,6,55,15,5,86,34,1143
58490,199,98,0,6,9,0,5,4,101
62012,6426,3366,19,174,45,27,183,92,3060
99589,192,87,2,4,0,0,2,0,105
99758,229,127,1,12,5,2,2,5,102
99786,299,150,3,8,3,3,9,2,149
96772,2472,1151,12,77,9,4,50,44,1321
76302,13083,6181,33,294,102,198,274,130,6902
76474,196,100,0,0,0,0,4,6,96
77047,29693,13930,264,1190,254,74,1305,298,15763
77573,86926,42291,356,3307,741,302,3672,763,44635
79424,46174,22566,258,1352,301,431,1298,589,23608
92105,72848,36049,655,2279,428,558,2473,593,36799
74839,777,380,33,32,11,0,27,10,397
83637,173,93,0,4,9,0,0,3,80
84645,3072,1579,29,75,10,0,98,21,1493
93667,2415,1181,3,46,43,11,104,78,1234
98380,4288,2255,24,24,87,38,68,25,2033
98902,46490,22388,280,1491,392,560,1624,324,24102
66213,29063,14123,78,902,274,135,929,582,14940
45318,5638,2883,0,139,34,13,180,128,2755
52172,5985,2954,22,190,129,48,161,105,3031
53156,2967,1386,7,119,40,12,119,22,1581
58831,736,395,0,21,9,0,12,14,341
15761,178,86,0,15,0,0,0,0,92
16923,1558,804,13,24,37,6,35,30,754
17023,3480,1814,25,90,66,35,84,49,1666
17081,372,135,0,0,0,0,0,0,237
18086,680,316,10,29,30,0,0,9,364
67864,1855,919,0,44,35,21,32,33,936
11237,49310,25382,436,2213,281,347,1806,464,23928
68787,6392,3164,195,80,49,199,258,111,3228
11411,20759,9582,145,564,137,146,664,329,11177
62035,16520,8069,202,273,155,35,403,305,8451
12887,4919,2328,10,162,39,23,92,64,2591
78242,34844,17761,291,1108,217,306,1503,210,17083
78580,14719,8322,204,828,73,215,442,145,6397
86329,1055,504,0,39,0,0,0,36,551
81151,1796,888,8,45,12,12,73,8,908
98020,20322,9805,49,422,144,77,737,188,10517
98814,666,313,0,0,40,0,0,7,353
98847,2267,1021,0,38,23,0,57,54,1246
4084,7766,3750,89,184,108,111,78,53,4016
4102,17494,8449,111,687,108,180,612,219,9045
7648,5819,2617,88,37,21,0,171,67,3202
31302,8139,4007,9,245,110,52,212,139,4132
31645,5053,2452,15,86,28,34,273,112,2601
25826,344,147,0,0,0,0,0,0,197
15346,427,208,0,10,0,5,0,5,219
15631,1238,596,5,38,6,20,26,35,642
17320,7889,3978,28,217,109,44,188,70,3911
11977,2455,1289,26,49,27,10,41,66,1166
23844,519,256,0,0,0,0,22,30,263
12721,6394,3287,96,64,54,58,34,72,3107
8816,46660,22215,219,1284,474,148,1515,877,24445
20607,11234,5330,23,366,104,2,393,129,5904
83842,300,153,0,21,0,0,21,0,147
17872,9178,4392,31,236,98,0,330,131,4786
67757,496,273,5,8,3,0,6,12,223
14422,2333,1105,0,58,27,7,52,17,1228
27012,27478,13161,113,678,428,64,782,390,14317
87006,1324,803,0,8,11,0,0,1,521
99841,155,73,0,7,15,0,7,3,82
90222,32850,16111,319,863,149,305,884,471,16739
97033,46,34,0,0,0,0,0,0,12
66025,7906,3814,0,362,81,56,333,74,4092
74565,706,330,5,25,23,11,20,10,376
75631,3151,1573,41,146,28,6,80,30,1578
92067,8756,4075,73,172,194,0,77,203,4681
92119,23990,11495,54,641,247,26,787,525,12495
92647,62718,31831,359,2078,451,463,2342,691,30887
86343,68,32,0,6,0,0,0,0,36
5757,845,413,0,28,16,0,28,20,432
6419,6414,3118,67,145,93,26,133,184,3296
14112,18,0,0,0,0,0,0,0,18
15072,9,0,0,0,0,0,0,0,9
15730,101,36,0,3,0,0,3,0,65
23960,1287,590,0,8,8,8,67,37,697
24290,1883,894,0,42,8,15,49,56,989
26287,3091,1509,23,77,28,24,81,73,1582
19902,386,314,82,0,0,27,0,0,72
19947,20057,10317,185,723,295,63,586,121,9740
19132,32196,14847,194,702,415,174,1121,556,17349
19148,52594,25803,175,2616,411,187,2209,428,26791
15068,37552,18149,126,1044,529,171,1146,614,19403
3824,16440,7936,1017,156,159,1120,239,98,8504
92060,92,43,0,0,10,0,0,0,49
92630,61304,30495,214,1782,659,235,1875,871,30809
66017,380,204,0,10,15,0,1,4,176
68114,17800,8168,58,495,194,104,480,237,9632
68164,29143,14155,215,1109,187,210,1034,403,14988
83402,24756,12931,108,852,342,202,744,429,11825
83677,0,0,0,0,0,0,0,0,0
85367,22526,11534,101,444,345,43,324,288,10992
76953,100,52,0,0,0,0,1,0,48
79355,1799,938,0,35,13,8,40,42,861
81003,14942,7697,210,673,83,52,532,181,7245
62522,15261,7275,94,223,211,78,430,260,7986
36107,7688,3737,19,215,63,18,213,75,3951
48082,16540,8189,138,570,220,89,481,233,8351
26419,1179,578,7,30,17,24,6,3,601
22152,29599,14563,202,962,227,82,1057,397,15036
22172,10101,4960,18,388,20,73,260,107,5141
22301,13569,6430,7,663,118,24,804,112,7139
7747,31146,15054,89,1063,294,163,1128,356,16092
77568,15571,7514,111,466,181,189,497,236,8057
75759,46,25,0,0,1,0,0,1,21
76645,10459,5243,104,189,110,157,224,93,5216
77702,2762,1443,12,126,0,23,108,33,1319
41663,656,356,0,22,0,0,22,0,300
62694,3038,1477,16,107,37,35,72,46,1561
62998,323,167,0,6,0,0,35,25,156
63131,17627,8694,16,498,247,3,361,269,8933
63826,73,19,0,0,0,0,7,0,54
55419,27109,13060,103,1286,243,120,1109,306,14049
2670,1202,567,0,41,29,18,28,22,635
67147,10537,5311,38,356,183,42,393,178,5226
60647,87509,44327,503,4563,462,486,4137,596,43182
62460,1154,558,1,19,6,4,51,11,596
56479,5146,2558,107,192,79,15,91,99,2588
57745,2240,1202,8,79,48,0,40,35,1038
62923,481,200,0,10,5,0,24,8,281
63352,1136,602,12,26,0,0,52,23,534
72425,427,212,0,5,2,4,2,5,215
71945,1368,714,24,24,32,0,19,30,654
78220,16348,7568,92,452,117,169,459,366,8780
670,8498,4105,93,250,98,106,210,144,4393
98011,33109,16533,152,1339,360,90,1448,387,16576
92545,42248,20663,224,1067,480,154,941,512,21585
94401,35414,17952,206,1638,366,151,1428,409,17462
94506,25258,12128,93,666,243,62,613,323,13130
99667,86,47,0,0,9,0,0,11,39
45883,3877,1981,11,99,58,19,99,87,1896
46502,22,11,0,0,0,0,0,0,11
36036,1796,877,25,100,29,0,20,30,919
33174,34015,15319,426,936,265,552,931,370,18696
62940,340,165,2,14,2,5,8,2,175
70129,10360,5243,80,353,72,65,330,148,5117
71101,6694,3173,4,122,85,34,207,60,3521
56385,786,428,6,16,10,0,14,9,358
57223,1245,635,1,49,19,1,38,3,610
57472,1039,515,0,34,17,0,46,10,524
72538,365,153,0,0,0,0,0,0,212
52030,451,220,0,14,0,0,15,0,231
44615,10312,5011,53,226,185,54,252,130,5301
52077,342,141,0,4,5,0,4,6,201
53012,18259,8960,18,444,268,33,460,250,9299
53926,1686,881,15,41,21,9,17,13,805
37664,26838,12952,79,689,309,94,785,350,13886
60061,27004,13315,102,903,288,100,886,297,13689
38558,8684,4297,0,27,148,0,82,118,4387
48168,22336,10799,106,693,267,110,579,351,11537
48637,3192,1548,20,119,56,9,77,48,1644
30812,394,291,0,7,14,0,0,0,103
15012,15420,7858,72,384,295,83,209,257,7562
15774,2703,1374,22,84,0,39,103,29,1329
17099,1140,608,0,0,15,0,15,13,532
33311,73034,34468,381,2523,852,565,2512,745,38566
26347,2423,1137,0,86,25,5,75,59,1286
27544,5027,2612,32,167,121,10,100,109,2415
27852,3134,1533,56,154,58,0,142,62,1601
4768,359,186,0,6,11,0,8,7,173
5038,1383,690,0,38,24,0,27,8,693
8867,5097,2561,40,155,125,13,145,126,2536
6759,5761,2535,13,144,57,34,93,110,3226
7803,3560,1795,12,102,39,41,101,47,1765
1301,17713,8758,116,543,295,40,605,325,8955
52241,20681,10701,164,911,264,157,630,210,9980
61726,2427,1248,10,82,27,16,98,51,1179
65023,1816,878,13,93,27,3,55,10,938
67952,495,251,4,12,4,0,27,9,244
68014,240,121,0,7,8,0,5,5,119
68071,2163,998,19,31,6,24,80,26,1165
74472,723,343,9,29,8,0,21,3,380
75082,23579,11982,295,891,331,70,749,347,11597
77831,3170,1535,49,1,27,4,70,35,1635
62634,775,394,17,13,18,0,5,7,381
63333,774,405,0,15,1,2,20,24,369
63351,1913,945,0,117,24,6,98,15,968
58081,871,439,5,48,8,0,36,11,432
73437,105,55,0,0,0,0,0,0,50
96080,28487,14436,245,694,310,284,676,344,14051
96765,360,162,0,0,0,0,0,0,198
97217,34813,17392,98,2085,399,73,2179,353,17421
83239,584,254,7,12,4,9,27,1,330
30606,43716,21109,555,1540,342,815,1522,344,22607
47280,934,425,0,0,0,0,20,0,509
31401,20256,9407,347,586,148,510,391,229,10849
13839,1072,564,10,0,69,0,6,49,508
14037,1012,551,0,85,18,0,54,12,461
32730,5991,3178,0,255,24,30,264,85,2813
20732,9664,4586,25,330,109,90,341,103,5078
28717,1640,812,0,69,22,0,31,27,828
18017,38687,18223,71,1085,569,133,1442,560,20464
34429,8272,4239,74,127,26,0,126,120,4033
28391,5984,2967,138,248,130,6,239,82,3017
6023,1247,648,24,24,0,0,24,0,599
10453,79606,36246,858,2304,491,848,2878,819,43360
48336,25897,12465,195,711,277,107,728,342,13432
38725,778,356,3,36,7,4,47,2,422
38852,9090,4491,2,217,191,0,287,179,4599
49935,5791,2829,38,129,137,3,89,116,2962
33920,5993,3008,14,233,72,13,158,151,2985
40143,5936,2913,46,187,54,68,230,46,3023
80452,3091,1513,0,72,40,9,101,86,1578
38059,7763,3941,40,119,74,16,106,143,3822
38833,2717,1421,12,87,53,7,34,10,1296
57658,379,182,3,10,1,2,17,2,197
53561,1800,911,14,56,43,4,48,19,889
43837,1658,855,12,68,18,9,60,28,803
44859,2158,1068,0,33,18,0,62,18,1090
43567,13247,6323,94,409,141,92,326,200,6924
61373,2134,1095,3,27,10,0,51,57,1039
63438,452,251,21,17,0,0,0,24,201
47809,2723,1287,125,8,0,122,0,0,1436
47857,443,205,0,15,0,3,3,3,238
30256,2589,1300,0,63,0,0,88,28,1289
31411,8875,4204,38,86,172,16,85,94,4671
32334,2088,1127,0,144,26,16,0,30,961
33172,43083,21261,169,1629,288,253,1489,447,21822
12186,6047,3056,75,135,60,74,155,165,2991
12193,1828,903,42,9,42,0,21,9,925
12742,90,36,0,0,5,0,0,0,54
24293,9165,4579,85,99,75,122,206,160,4586
25820,464,230,0,0,0,0,22,0,234
26175,3723,1835,61,95,46,36,134,70,1888
37334,22935,11075,85,774,508,113,789,500,11860
27842,1456,702,6,42,72,0,0,22,754
99003,4496,2303,27,73,134,0,82,54,2193
93950,15595,7237,67,280,326,32,391,269,8358
94086,49630,25722,215,2658,349,13,1853,388,23908
94923,846,430,8,0,29,6,0,14,416
95035,77562,39606,325,3408,603,349,2926,886,37956
19006,22367,10668,72,512,267,48,637,299,11699
33770,25688,11772,385,505,384,100,612,308,13916
25301,2562,1277,0,52,47,0,63,44,1285
25547,866,422,0,0,0,0,0,70,444
26767,646,264,0,0,0,0,30,12,382
27284,54413,26400,352,1503,634,267,1902,612,28013
28169,146,81,0,0,2,0,0,1,65
30906,58114,28248,449,1483,540,595,2181,767,29866
12059,1657,866,0,15,24,18,48,36,791
1560,4401,2225,44,179,37,33,97,20,2176
1730,14053,6943,34,352,90,27,448,137,7110
1983,6551,3155,0,150,114,1,135,113,3396
2842,15997,7617,46,553,215,262,431,400,8380
3598,3231,1606,14,62,31,31,136,72,1625
73047,5135,3133,41,327,49,23,103,61,2002
48323,17111,8433,99,312,223,13,459,286,8678
50676,2119,1138,6,51,24,9,104,15,981
50857,243,136,0,0,4,0,11,2,107
81029,247,136,5,3,1,0,7,9,111
93545,1899,935,0,48,32,0,23,44,964
87327,9560,4548,40,305,11,116,311,94,5012
89046,316,159,0,0,4,0,0,19,157
76650,148,77,0,12,2,0,0,0,71
68331,1037,518,2,56,6,0,41,12,519
46562,5295,2566,29,162,69,72,154,26,2729
46979,4716,2429,20,174,49,9,139,71,2287
65332,1406,731,0,31,15,1,36,19,675
75147,7052,3368,145,145,50,27,229,84,3684
75210,8578,4496,102,411,46,69,318,42,4082
77662,26077,12978,116,739,301,75,697,262,13099
83320,921,486,14,28,0,0,19,7,435
84057,40034,20425,392,1456,239,595,1232,260,19609
59830,177,77,0,0,8,0,0,11,100
60459,28908,14464,165,877,352,171,886,393,14444
60510,29533,14540,176,609,358,72,1194,526,14993
61472,517,293,5,0,32,3,14,17,224
57220,745,420,0,17,6,0,13,15,325
78681,56959,28034,334,1931,404,155,2511,591,28925
79505,287,163,0,16,2,0,3,3,124
62695,216,118,0,13,0,0,5,2,98
63016,7532,3789,40,234,111,56,278,144,3743
63334,9064,5494,79,566,72,33,189,155,3570
72353,46,13,0,0,0,0,0,0,33
72501,26228,12610,220,932,354,200,807,400,13618
70807,18253,8809,286,416,195,321,600,132,9444
71480,1404,1078,35,125,9,0,20,9,326
23119,370,153,0,0,39,0,0,0,217
23294,18168,8608,117,787,202,85,638,211,9560
13488,151,109,0,3,0,0,6,2,42
14517,3063,1529,6,63,16,5,121,49,1534
15015,1201,621,8,29,14,6,28,17,580
15378,142,59,0,0,0,0,0,0,83
31314,1635,1519,331,0,0,18,0,0,116
20011,68695,33398,248,2594,566,182,2986,841,35297
8527,56261,27299,409,1683,517,376,1403,895,28962
10594,5215,2512,0,145,20,0,149,51,2703
27576,18104,8637,17,490,294,163,582,234,9467
27805,3761,1802,12,119,41,0,91,79,1959
28128,7056,3530,32,233,60,48,144,125,3526
28421,1585,836,14,31,2,3,38,15,749
17856,3202,1469,0,119,53,18,82,28,1733
13042,2604,1357,3,93,54,3,45,9,1247
53154,35843,17739,131,1137,364,122,1215,563,18104
55711,684,411,2,26,6,9,21,6,273
56026,2054,1032,2,38,21,3,71,37,1022
12964,186,118,0,9,0,0,10,0,68
12976,213,98,3,0,0,18,4,4,115
13040,2434,1257,18,72,34,13,67,38,1177
15613,14049,6872,55,292,213,59,268,263,7177
16851,929,492,0,16,13,74,0,13,437
65786,2266,1191,0,67,37,20,47,64,1075
69341,10614,5084,59,295,72,58,300,166,5530
73950,1408,693,7,45,10,9,37,18,715
41559,198,73,0,0,0,0,0,0,125
43067,1458,784,0,43,17,38,25,22,674
70525,13900,7027,21,519,163,0,421,151,6873
70721,834,373,7,49,0,64,10,0,461
55087,325,194,0,7,6,4,10,1,131
55720,16958,8617,159,651,289,121,581,330,8341
55963,5241,2598,9,206,104,34,169,55,2643
46113,15663,7656,84,464,123,62,743,191,8007
47246,4339,2207,3,155,54,32,120,51,2132
81244,381,185,0,12,11,9,16,6,196
93244,395,227,0,0,13,0,4,18,168
93530,15,10,0,0,0,0,0,0,5
95464,2538,1317,95,117,42,10,41,41,1221
90062,34422,16221,311,869,228,322,1436,491,18201
61548,11950,5873,56,347,69,48,437,148,6077
3451,3966,2080,0,168,57,0,93,39,1886
6355,12432,5987,38,169,131,70,342,297,6445
7044,13622,6217,51,380,188,27,518,253,7405
8232,19403,9245,187,518,221,121,537,251,10158
8859,22312,10947,142,851,266,28,927,354,11365
38108,17894,8478,42,388,56,130,608,176,9416
38760,925,441,7,47,5,39,16,51,484
39108,1871,850,0,24,56,0,15,3,1021
32130,5581,2633,0,166,106,49,147,63,2948
32526,36300,17927,356,932,355,113,1104,748,18373
32750,24389,11990,108,665,367,88,757,354,12399
35136,2076,1006,0,57,5,0,48,2,1070
37097,2254,1112,27,36,15,7,44,12,1142
28083,25540,12471,121,733,207,232,1040,110,13069
24301,14224,6931,59,318,253,73,251,247,7293
43111,289,156,0,0,0,21,6,8,133
97389,1708,807,9,49,11,3,64,23,901
98406,23103,11056,76,565,202,193,709,196,12047
84756,349,166,0,45,0,0,0,27,183
75603,5954,2975,27,241,31,57,136,203,2979
76071,4508,2219,25,148,52,59,99,64,2289
65725,3148,1494,54,41,18,4,73,37,1654
65779,1684,850,0,38,25,0,51,50,834
66945,999,534,0,13,27,6,11,18,465
69101,29231,14451,163,952,350,139,947,399,14780
56159,2819,1398,20,72,42,38,70,61,1421
56701,13019,6467,71,392,198,97,359,215,6552
57006,26315,13517,871,697,208,916,696,180,12798
60468,6044,3186,85,256,133,44,229,105,2858
50440,557,303,3,0,0,3,7,10,254
63625,403,236,0,0,6,0,0,12,167
47574,285,189,54,0,0,5,0,0,96
55014,28039,14482,102,1001,248,91,689,456,13557
55718,3267,1576,14,68,51,16,106,60,1691
55976,7900,3770,25,288,38,5,339,46,4130
41367,182,104,0,0,7,0,0,9,78
43232,45352,21184,284,1611,362,159,1783,463,24168
44255,8223,4033,53,175,37,133,149,61,4190
37756,3151,1464,71,59,32,49,147,22,1687
38067,1166,527,0,33,15,0,4,30,639
38601,2221,1077,0,60,15,2,60,25,1144
38957,517,253,0,9,9,0,20,15,264
23441,122,49,0,0,0,0,0,0,73
24416,8705,3872,79,224,148,43,121,83,4833
72553,52,21,1,0,5,0,0,0,31
75567,5275,2584,61,203,44,26,167,26,2691
83825,273,154,0,3,15,0,2,5,119
85645,2410,1053,11,50,0,70,33,25,1357
93519,22,22,0,0,0,0,0,0,0
94619,24308,11339,83,688,346,130,1123,382,12969
96714,907,485,0,14,24,0,30,6,422
97526,35493,17172,142,830,597,216,983,714,18321
15825,8977,4424,82,310,140,23,221,91,4553
17538,6435,2862,28,89,45,43,209,167,3573
18202,11716,5664,98,279,136,55,234,250,6052
18505,20606,10024,83,630,220,86,639,189,10582
6854,30975,15176,270,912,380,31,1065,363,15799
11778,11641,5797,80,631,149,55,520,197,5844
19383,3139,1306,93,0,0,76,0,0,1833
21541,1354,687,28,24,0,8,35,27,667
25168,2635,1297,43,120,0,53,94,9,1338
13616,2229,1078,13,187,0,95,50,10,1151
14169,94,21,0,0,7,0,0,0,73
14201,11680,5594,89,364,132,78,473,126,6086
15431,4112,1947,0,35,70,9,128,53,2165
3103,37641,18963,234,1368,285,126,1280,419,18678
75007,54701,26785,405,2037,595,305,2299,741,27916
75246,2357,1198,0,99,31,0,77,48,1159
75931,2075,999,44,48,57,0,18,64,1076
77401,19283,9339,71,496,218,83,570,303,9944
80815,731,358,0,18,3,0,31,29,373
81082,11506,5896,132,297,226,71,321,213,5610
84758,585,285,0,3,5,8,2,16,300
78501,63554,31129,354,2204,356,440,2093,575,32425
95636,1087,531,0,0,16,0,64,14,556
97022,3770,1847,19,65,137,21,49,51,1923
97049,1640,905,0,78,7,0,103,9,735
88317,1654,815,0,13,51,0,8,28,839
90211,7969,3752,35,307,70,39,168,99,4217
95252,15703,7716,17,281,206,70,500,453,7987
91020,8720,4245,43,277,141,18,264,122,4475
93103,20353,10650,193,558,267,175,578,318,9703
29670,9297,4982,173,332,95,29,361,118,4315
34134,13977,6795,0,242,338,0,170,362,7182
35758,45736,22979,300,1340,343,133,1383,470,22757
36264,8523,3989,62,191,125,23,284,60,4534
45832,2923,1517,0,125,17,14,98,53,1406
46259,11364,5809,88,462,151,69,404,163,5555
47358,979,440,8,42,28,6,39,9,539
41360,464,313,0,17,0,0,56,0,151
4537,2069,1011,0,41,38,46,29,14,1058
1035,5310,2269,0,128,55,15,67,90,3041
23605,13892,6642,62,402,158,92,387,217,7250
24736,493,261,0,20,0,0,2,27,232
16875,4055,2207,18,106,40,7,109,54,1848
17751,7082,3581,48,223,85,47,199,119,3501
19021,9675,4729,35,235,56,172,290,144,4946
30445,3929,2097,25,141,60,64,64,45,1832
14847,2395,1131,4,61,44,7,62,27,1264
15142,1230,650,0,13,0,0,13,46,580
7647,5412,2750,0,140,140,33,169,89,2662
95313,1225,653,0,26,55,0,42,20,572
97369,215,98,0,0,11,0,18,0,117
97486,558,286,0,65,14,0,10,0,272
98119,25710,12638,184,932,213,348,1125,139,13072
99603,10509,5156,62,300,198,84,323,174,5353
88030,22991,11313,97,451,329,151,665,238,11678
20710,9794,4395,43,352,125,26,380,69,5399
81155,263,118,0,4,0,0,8,0,145
82637,4080,2148,2,137,25,7,205,99,1932
83238,72,39,0,6,0,0,0,0,33
67058,1693,897,12,54,26,0,41,34,796
71467,8018,5438,113,692,133,1,96,36,2580
71722,66,44,0,1,7,0,0,2,22
60013,25827,13124,176,718,214,95,592,433,12703
64504,11121,5821,13,413,94,40,330,193,5300
56292,600,280,2,23,3,5,16,6,320
57367,232,116,2,11,8,0,5,8,116
48154,37581,18592,255,1170,454,304,875,764,18989
50216,2455,1238,34,93,51,8,50,39,1217
51331,1175,622,21,26,18,20,12,19,553
43701,55595,26495,351,1425,616,347,1663,697,29100
36907,1515,649,0,29,35,23,59,34,866
37752,6559,3150,9,251,91,133,162,95,3409
53021,5009,2614,17,168,40,6,157,71,2395
54016,31883,15885,141,984,330,78,966,386,15998
54637,210,108,2,4,4,2,5,3,102
61360,3678,1870,21,93,29,11,50,46,1808
70041,2669,1255,21,42,68,0,102,55,1414
72537,688,389,0,0,18,0,21,16,299
77049,35230,17111,363,1297,172,461,1323,325,18119
60076,31867,15177,202,818,565,88,902,560,16690
69165,1927,914,0,65,17,0,49,7,1013
18970,725,398,0,42,11,0,26,13,327
19111,68263,32308,428,2778,511,330,2566,857,35955
14559,18937,9293,91,499,236,70,621,177,9644
25515,2030,1016,0,48,45,3,78,39,1014
27881,150,46,0,2,1,0,4,0,104
32448,8480,4369,66,388,154,16,382,82,4111
33032,47067,23519,168,1646,300,326,2052,441,23548
33513,12303,7091,150,394,161,32,265,184,5212
33605,17457,8207,58,498,172,251,692,220,9250
35744,2201,1003,0,37,7,100,67,2,1198
39665,1776,964,0,57,33,0,67,15,812
45040,54507,26711,201,1413,357,111,1875,696,27796
47591,25416,12962,188,616,315,73,820,311,12454
47660,4897,2460,4,206,105,29,95,55,2437
54491,1480,752,6,33,30,8,24,38,728
47992,1640,844,0,64,0,0,12,0,796
48553,0,0,0,0,0,0,0,0,0
49961,79,39,0,0,3,0,0,0,40
50605,248,152,0,33,22,0,0,2,96
15624,311,137,0,3,5,0,16,0,174
15921,83,33,0,0,0,0,0,0,50
16056,4613,2128,22,94,113,9,118,102,2485
16631,90,55,0,5,0,0,5,0,35
21643,6015,3088,12,219,65,19,192,38,2927
4360,494,255,2,14,7,0,8,7,239
5733,5933,2797,8,62,49,34,117,105,3136
7081,17398,7887,144,484,202,64,423,399,9511
11547,776,368,0,0,0,0,10,0,408
25076,341,130,0,0,9,0,12,24,211
26055,1421,785,0,99,0,0,43,0,636
28586,7259,3647,0,249,69,67,201,127,3612
29172,9709,4822,34,326,136,45,313,113,4887
30043,90675,44147,647,3692,618,801,3397,1125,46528
13054,1665,820,0,40,0,0,68,0,845
13415,66,27,0,2,0,0,3,0,39
27320,38634,18711,401,1272,464,74,915,593,19923
17603,64494,30807,315,1928,515,413,2003,849,33687
18644,7268,3403,31,239,77,52,160,121,3865
77355,28074,14002,334,715,447,110,990,389,14072
78052,7362,3606,79,260,97,9,220,72,3756
82644,1722,981,24,65,0,0,121,0,741
83214,658,324,0,20,2,2,43,4,334
83337,30,22,0,0,0,0,0,0,8
16248,3122,1572,10,72,51,29,85,49,1550
16641,2457,1194,5,121,42,4,71,23,1263
2919,29254,13970,191,893,349,80,837,532,15284
4487,924,506,5,14,20,0,26,15,418
6484,41155,19789,384,835,632,194,956,652,21366
7021,2180,1000,22,43,31,3,55,28,1180
75062,48629,24544,532,1876,288,564,1548,373,24085
80109,22734,11405,106,901,216,16,1018,209,11329
83868,793,395,0,22,9,0,8,20,398
84088,37435,18398,351,1269,259,218,1383,368,19037
96058,686,377,0,7,0,2,17,0,309
85020,34782,17259,162,1067,435,189,1440,422,17523
87049,1336,657,11,8,25,0,11,0,679
98433,18909,10876,548,579,0,296,577,4,8033
99701,17510,8941,279,603,271,243,431,244,8569
94595,17938,7623,0,559,270,81,359,288,10315
94904,12590,5983,0,190,200,67,334,154,6607
92230,3406,1407,73,141,14,88,94,75,1999
78141,485,239,3,5,15,4,5,8,246
78405,15326,7782,99,448,146,42,490,88,7544
78837,236,137,0,0,0,0,0,7,99
10029,79597,36356,476,2550,542,466,3265,1156,43241
25110,359,115,0,0,0,0,19,0,244
25535,3064,1521,19,161,94,0,175,69,1543
12131,85,47,0,0,1,0,2,0,38
12531,3323,1721,0,107,39,0,92,126,1602
29333,581,327,0,49,8,0,23,24,254
30041,66531,32963,257,2065,587,359,2340,821,33568
27958,10988,5244,18,250,92,39,317,165,5744
28033,3555,2016,85,120,13,23,104,89,1539
43101,285,162,0,5,3,4,4,3,123
43127,240,113,0,0,0,0,0,0,127
59412,1539,768,2,41,20,2,63,17,771
62334,138,75,5,2,1,2,6,2,63
97534,683,397,0,48,110,0,0,0,286
98146,28022,14082,95,1153,337,132,883,490,13940
98640,4465,2074,0,68,180,0,0,226,2391
95675,607,315,0,0,81,0,0,13,292
95936,114,67,0,7,0,0,0,0,47
96860,2203,1923,326,0,0,38,3,0,280
68637,375,179,0,13,9,0,0,8,196
78010,3353,1626,44,0,102,46,117,77,1727
78643,6265,3176,33,122,191,0,132,165,3089
81123,937,476,0,12,11,4,0,15,461
75460,23191,10820,156,725,189,141,376,324,12371
76020,28207,14094,165,780,212,119,726,304,14113
66552,445,224,0,7,2,0,5,6,221
73097,167,70,0,0,0,0,0,0,97
46404,17014,7481,93,357,147,48,492,254,9533
48043,16371,8287,63,631,156,32,477,168,8084
48386,17827,9159,74,499,210,82,541,460,8668
37138,24229,11316,47,1008,267,68,1196,393,12913
37201,1372,1120,48,153,15,0,0,0,252
49891,594,317,0,21,17,0,13,5,277
52066,60,27,0,0,1,0,0,0,33
56594,486,253,3,21,0,0,8,6,233
45340,688,308,0,9,0,12,15,0,380
45378,362,190,0,8,8,2,8,5,172
45746,415,220,0,24,14,0,3,2,195
16848,376,177,0,6,3,8,13,0,199
7882,14468,7035,49,379,153,74,455,226,7433
8006,344,147,0,0,4,3,0,12,197
27837,6463,3216,29,200,67,48,195,90,3247
28396,2620,1355,23,121,53,5,56,54,1265
28444,1962,1084,2,88,29,38,21,99,878
28735,293,178,0,10,0,0,0,0,115
11717,63054,30607,346,2869,304,525,2434,854,32447
21856,913,558,9,70,28,0,0,79,355
22749,243,145,0,6,0,0,7,0,98
23188,43687,21413,220,932,586,301,1198,727,22274
23691,142,62,0,0,0,0,9,5,80
23701,23975,11454,138,740,193,58,811,351,12521
95975,1584,910,39,32,0,0,15,6,674
91750,33836,16602,154,854,385,245,913,525,17234
91754,33058,15562,87,1009,384,148,930,475,17496
92703,70595,36423,625,2558,531,469,2307,676,34172
98682,58178,28863,412,1791,472,295,1810,627,29315
4921,1581,793,1,47,26,6,57,27,788
5041,486,295,0,19,0,0,0,0,191
61232,1229,632,9,19,15,0,15,48,597
61611,24877,12669,122,699,367,81,638,375,12208
78566,18249,8996,131,444,146,126,543,127,9253
78828,81,30,0,0,0,0,0,0,51
80742,209,122,0,4,1,0,4,6,87
85249,39052,19005,89,1118,396,134,1676,306,20047
85371,346,133,0,0,15,11,8,0,213
68050,687,399,0,34,2,0,34,4,288
66550,684,357,4,14,5,0,10,6,327
66701,12452,6080,100,261,98,33,317,57,6372
66771,927,495,1,11,4,3,18,8,432
73165,6720,3353,64,142,112,26,138,115,3367
74857,8911,4503,66,242,94,33,255,132,4408
55605,722,349,1,25,9,3,30,10,373
47552,294,175,0,0,0,0,13,14,119
48371,24737,12360,69,769,233,156,678,501,12377
49282,258,147,0,21,0,0,14,0,111
60129,260,155,0,11,2,3,8,5,105
61362,5585,2706,26,101,46,35,141,93,2879
58009,12,6,0,0,6,0,0,0,6
34449,2966,1518,10,32,54,12,42,75,1448
4462,4618,2154,0,198,87,0,123,140,2464
4853,501,236,0,15,10,4,8,3,265
7675,27044,13346,87,736,257,71,828,299,13698
783,33372,16252,391,1009,308,231,1119,543,17120
1266,1369,670,0,31,42,1,17,11,699
1545,36666,18078,229,1124,363,176,1084,511,18588
30413,1805,799,13,36,15,16,68,24,1006
10044,11682,5498,0,529,88,13,349,216,6184
11415,19372,9253,37,845,235,124,819,300,10119
21034,3475,1755,5,87,36,17,65,30,1720
19119,29391,13355,74,1140,278,28,1043,511,16036
13155,586,318,5,20,13,0,12,4,268
29039,3715,1660,3,17,12,41,50,137,2055
29453,1136,542,0,42,11,26,44,10,594
81045,60,28,0,0,1,0,1,0,32
81049,275,145,0,1,5,0,2,9,130
83254,3760,1834,23,125,43,0,110,36,1926
62924,2948,1457,22,138,54,8,58,29,1491
72835,624,321,0,23,8,0,38,7,303
73145,3277,2182,197,43,0,60,124,0,1095
73456,2113,1103,9,59,42,5,64,41,1010
75418,14376,8180,176,408,174,46,277,182,6196
68836,1750,901,18,50,22,8,43,18,849
85297,33029,16011,190,1424,151,152,1558,328,17018
78260,27696,13631,181,807,197,117,1198,327,14065
99323,3931,2132,0,74,77,27,109,88,1799
96155,0,0,0,0,0,0,0,0,0
43360,1600,856,8,73,31,6,29,33,744
45135,4705,2318,0,145,64,18,142,113,2387
49825,155,73,0,2,0,0,0,3,82
70632,554,316,0,0,0,0,0,23,238
10465,44205,21403,458,1289,458,264,1453,594,22802
15228,17711,8799,28,496,203,39,526,221,8912
78162,404,262,0,22,6,0,17,0,142
79547,741,350,0,20,6,0,33,26,391
60957,5288,2637,63,126,51,18,81,73,2651
63870,974,560,8,69,12,7,24,21,414
65018,7554,3697,36,210,65,28,239,112,3857
73461,784,384,3,23,3,3,21,13,400
82520,13545,6566,28,398,235,91,384,284,6979
14303,5805,2861,23,169,60,25,237,85,2944
14715,2840,1408,19,97,35,11,118,27,1432
15522,11529,5702,103,266,198,37,197,202,5827
37342,4000,1971,26,120,79,9,157,38,2029
39063,3821,1791,34,142,48,12,134,34,2030
59436,2005,980,0,54,12,2,53,21,1025
59701,33646,16974,424,1184,503,163,989,610,16672
60164,21600,10827,81,729,190,86,709,222,10773
64424,4466,2193,0,61,53,25,49,48,2273
55431,18337,8765,87,699,179,59,656,276,9572
55609,276,155,0,0,0,0,0,0,121
49548,33303,16076,100,1079,213,192,1364,329,17227
3595,660,353,0,14,18,7,9,10,307
15004,423,265,0,0,8,27,0,22,158
15670,3345,1645,3,57,118,2,32,98,1700
24315,3546,2160,42,214,29,60,22,32,1386
25560,7979,3933,144,188,97,26,299,57,4046
19733,142,69,0,0,39,0,0,0,73
21217,34487,16084,251,820,407,297,1111,407,18403
27891,5356,2507,30,98,64,54,119,98,2849
18421,5183,2571,36,165,72,0,100,38,2612
28669,2663,1457,35,124,37,21,78,13,1206
29673,29287,14724,225,994,436,88,1086,343,14563
77056,21807,11049,70,1125,202,4,730,289,10758
78407,3078,1665,0,93,91,16,125,34,1413
51523,375,174,3,7,6,2,4,8,201
58301,10256,5199,138,237,123,56,160,145,5057
58651,558,302,13,19,4,0,22,11,256
60606,3101,1502,0,112,94,0,178,54,1599
68982,649,334,0,15,4,2,22,19,315
72014,51,25,0,0,0,0,0,0,26
72051,850,450,27,54,11,0,42,9,400
58103,49344,24274,637,1779,310,586,1314,647,25070
72823,6003,2834,26,135,169,18,117,39,3169
74430,464,231,4,9,6,2,15,8,233
75102,1177,647,13,50,21,0,57,7,530
31308,7114,3666,0,308,148,59,463,65,3448
32117,24602,12263,136,802,307,112,838,403,12339
33572,18998,9302,12,413,234,45,573,268,9696
93623,123,66,0,0,14,0,0,0,57
50310,31877,15618,155,1199,247,175,1005,375,16259
50598,868,460,0,39,15,0,20,15,408
51250,8565,4546,150,284,100,120,360,89,4019
13484,297,142,0,0,0,0,12,0,155
14220,23980,11799,98,863,199,135,820,207,12181
17062,4279,2179,12,141,60,26,114,67,2100
30401,13598,6532,34,422,159,63,450,121,7066
30650,12063,5736,29,283,126,71,241,183,6327
32046,9426,4743,21,176,182,77,172,100,4683
24527,3300,1737,17,107,136,19,122,45,1563
8837,17208,8390,80,824,229,35,615,206,8818
10010,33730,17370,128,1420,295,322,1320,149,16360
18817,231,115,0,8,3,0,10,6,116
19542,0,0,0,0,0,0,0,0,0
36051,2106,1058,0,218,0,0,157,55,1048
25670,5410,2654,31,145,52,0,142,100,2756
42464,1496,732,0,63,2,2,39,22,764
44049,224,101,0,12,2,0,4,4,123
44637,3281,1696,73,134,12,7,72,44,1585
33714,20375,10212,184,585,209,96,618,236,10163
62438,300,148,0,9,0,0,16,0,152
68761,361,169,0,7,4,0,8,13,192
71826,1227,619,7,9,18,7,16,25,608
80014,39243,18416,226,1276,442,183,1357,453,20827
65727,116,56,0,12,13,0,0,0,60
66846,3218,1542,15,151,32,8,64,66,1676
67522,1961,1022,12,33,57,4,83,18,939
67653,316,154,2,4,3,5,6,11,162
57422,249,141,0,20,10,0,9,3,108
63454,926,521,6,39,7,0,40,21,405
75479,1819,936,10,54,25,8,50,27,883
87316,1188,571,0,20,26,14,39,5,617
87746,55,48,0,0,0,0,0,0,7
99689,665,345,6,24,14,7,23,7,320
95842,32269,15400,287,1238,282,182,1223,454,16869
96795,9988,4925,180,274,87,97,248,113,5063
3055,15486,7342,62,592,195,59,605,96,8144
4358,4162,2049,11,157,41,0,194,54,2113
54862,206,109,1,5,4,0,6,14,97
54937,19364,9340,81,446,273,102,630,279,10024
41390,22,16,0,0,5,0,0,0,6
42441,1635,1003,5,84,42,2,69,8,632
37078,421,236,0,19,24,0,0,0,185
37151,381,188,0,0,0,10,10,0,193
52328,2935,1510,18,84,38,16,75,54,1425
53228,14990,7316,69,444,156,71,410,162,7674
53504,1982,1011,7,44,34,5,46,33,971
57018,1455,776,2,43,34,2,50,23,679
57321,456,248,3,14,5,0,9,5,208
49445,21111,10674,113,782,391,61,682,329,10437
71247,984,499,0,31,3,7,20,42,485
30410,1715,895,0,26,37,0,57,5,820
30529,11435,5339,64,350,60,121,216,143,6096
31823,797,395,0,26,8,9,9,11,402
45226,5346,2564,10,195,43,25,165,86,2782
46990,735,380,0,12,0,13,0,0,355
26662,1228,611,39,44,0,0,42,0,617
42328,1331,701,0,47,17,5,26,26,630
43531,308,129,0,0,0,0,9,26,179
28646,308,158,3,0,6,0,40,0,150
29631,15176,8258,973,305,87,888,327,22,6918
26264,567,300,0,30,7,4,20,2,267
56085,5273,2846,23,194,40,11,111,80,2427
49963,968,472,10,15,0,0,46,15,496
50111,13764,7048,11,832,78,42,519,112,6716
50483,652,343,0,11,0,0,10,1,309
50840,512,233,1,18,11,1,16,13,279
51459,64,30,0,0,0,0,0,0,34
53214,35460,17678,130,1534,444,105,1285,624,17782
74574,1264,651,3,26,17,4,5,13,613
48652,1736,894,4,59,23,5,48,40,842
48807,844,445,3,13,6,2,12,2,399
49268,1212,585,30,36,5,0,62,21,627
4570,0,0,0,0,0,0,0,0,0
4911,2171,1154,21,64,25,0,80,12,1017
32327,28319,15784,232,1264,268,115,905,504,12535
23857,658,348,0,67,34,0,75,15,310
23063,4621,1958,0,108,29,0,180,55,2663
14591,1497,803,10,35,31,17,40,20,694
10119,0,0,0,0,0,0,0,0,0
15961,801,409,1,11,19,2,6,36,392
26505,39600,21043,1432,1177,194,1319,765,334,18557
27603,53803,28155,884,1955,372,663,1660,553,25648
28409,34180,16258,65,1003,577,92,1251,560,17922
76934,1160,590,0,25,3,8,38,9,570
51503,37062,18074,209,943,439,195,977,632,18988
77993,186,110,0,38,0,0,24,0,76
53202,24842,12741,198,854,164,283,558,337,12101
55352,9391,4638,34,307,74,43,329,74,4753
38112,17082,8002,229,532,180,190,495,160,9080
68381,214,108,0,4,0,0,2,0,106
16836,1093,563,11,25,10,0,40,14,530
30075,53328,26329,227,1529,418,88,1661,761,26999
11549,2901,1175,261,0,0,209,0,0,1726
11420,48489,23765,371,1508,366,396,1330,1000,24724
12046,1025,544,0,42,5,0,43,5,481
12158,6852,3272,71,287,79,34,248,153,3580
71071,2578,1344,26,109,35,29,108,41,1234
58235,440,258,0,16,6,0,11,10,182
47963,1949,977,3,15,0,4,68,16,972
20701,0,0,0,0,0,0,0,0,0
83716,17076,8456,5,759,168,65,743,178,8620
22579,88,33,0,0,0,0,0,0,55
85004,6552,3338,129,207,42,285,96,31,3214
85360,156,92,0,0,0,0,9,7,64
14756,70,49,0,0,0,0,0,0,21
67629,190,113,6,0,6,0,0,2,77
13367,8617,4330,108,220,74,25,224,114,4287
80745,287,184,0,14,0,0,2,0,103
83313,3789,1954,0,207,84,0,83,97,1835
6524,5504,2637,64,207,134,0,217,120,2867
8640,7753,6412,151,952,77,11,140,0,1341
65548,5654,2615,27,173,69,20,154,29,3039
95527,570,295,0,0,15,0,0,26,275
58736,631,350,1,16,0,0,16,12,281
97330,42614,21225,1171,1177,464,882,1084,575,21389
53515,2238,1155,27,59,45,1,51,40,1083
78951,0,0,0,0,0,0,0,0,0
52335,707,384,3,11,3,6,10,9,323
21046,15988,7823,124,656,131,77,516,250,8165
43755,1983,974,11,31,25,14,38,24,1009
68922,1467,686,0,29,0,10,53,24,781
55716,375,204,9,11,1,0,9,3,171
56224,285,161,0,3,0,0,4,3,124
48036,21638,10271,26,579,192,99,801,205,11367
61542,3628,1818,20,117,59,14,81,100,1810
6375,3767,1895,21,71,11,0,146,36,1872
62320,2324,1155,6,76,10,7,76,40,1169
47932,5001,2599,43,138,73,33,99,70,2402
48050,1677,870,0,54,4,0,87,20,807
35613,25577,13938,117,1102,326,103,611,382,11639
30080,55361,26889,126,2618,314,230,2869,462,28472
13322,902,414,5,22,7,0,23,12,488
97818,4176,2028,50,33,15,61,113,94,2148
8212,188,80,0,2,4,0,2,3,108
98921,627,400,0,0,0,0,42,0,227
48022,2610,1375,11,92,33,0,100,26,1235
94121,43795,21376,224,1609,540,351,1768,670,22419
24484,554,275,0,0,17,0,0,18,279
40486,2489,1294,21,96,0,0,182,28,1195
25634,357,209,0,8,8,0,8,24,148
53047,45,27,0,3,0,0,2,0,18
53126,7215,3605,33,207,64,89,172,102,3610
22542,2279,1178,0,199,18,0,94,0,1101
31083,411,229,2,4,0,2,10,4,182
36750,2538,1347,36,113,37,0,99,45,1191
17737,6378,3204,52,161,65,50,194,158,3174
55407,41671,21481,255,1885,352,179,1949,289,20190
43762,5997,2874,89,161,103,153,186,49,3123
41812,276,151,0,0,0,0,0,0,125
49946,3829,1879,1,79,69,7,71,79,1950
27317,16640,8431,47,547,101,165,622,365,8209
44105,37211,17051,316,901,277,219,1250,503,20160
50677,12327,6152,299,361,111,182,323,202,6175
46408,15728,7419,110,576,113,117,363,299,8309
56176,1074,509,6,33,17,5,34,10,565
60160,25412,13162,106,1074,129,146,1042,247,12250
3845,1056,555,94,31,68,31,0,0,501
45816,330,171,7,0,0,0,10,0,159
6455,3171,1550,10,51,31,18,20,106,1621
46506,9692,4957,61,296,78,16,65,210,4735
2766,19634,9439,214,488,189,265,384,337,10195
66010,762,406,0,43,2,3,24,14,356
94610,31496,14762,26,1473,377,41,1841,363,16734
68947,617,347,5,23,15,4,10,7,270
96750,3370,1653,0,106,34,0,126,51,1717
48091,30031,14885,133,970,184,331,1023,199,15146
99181,1706,874,0,26,17,0,31,41,832
55415,4480,2618,43,296,63,19,225,4,1862
95033,9597,4922,76,328,179,8,216,157,4675
54848,5737,2711,6,159,65,1,174,139,3026
14810,12135,5960,105,348,177,48,353,293,6175
13659,479,241,0,6,11,0,7,15,238
15020,224,122,0,0,0,10,0,0,102
44502,9336,4542,83,192,55,178,163,103,4794
34614,7237,3444,46,167,185,0,220,115,3793
35960,9668,4682,9,448,202,18,237,109,4986
38229,2861,1374,25,111,54,5,122,51,1487
32765,65151,31975,862,2108,422,470,1840,650,33176
56442,2261,1142,11,44,43,0,25,60,1119
57249,831,461,0,35,21,0,27,23,370
33026,31045,14367,88,800,193,342,965,454,16678
59918,650,322,0,11,20,6,21,15,328
79094,51,34,0,0,0,0,0,0,17
99829,800,427,10,31,13,6,11,15,373
49660,14336,7523,127,427,348,66,271,299,6813
57078,19107,9839,115,661,251,84,558,216,9268
58755,88,38,0,6,0,0,0,0,50
4622,1101,521,3,45,23,0,36,7,580
72776,554,259,8,16,0,0,6,0,295
21638,5210,2630,15,76,7,55,122,83,2580
99515,23402,11464,108,693,96,80,754,362,11938
1702,39149,19333,161,1717,299,237,1554,343,19816
24938,1430,615,0,12,72,0,0,13,815
75965,18281,8730,446,522,93,400,357,146,9551
76631,592,311,0,7,9,5,31,2,281
77035,38524,19081,278,1360,279,245,1306,608,19443
77040,48290,24239,257,1924,464,135,1805,833,24051
77389,35349,17550,233,1582,277,46,1756,419,17799
87001,3745,1887,9,92,46,30,125,90,1858
57332,904,467,0,27,52,8,5,11,437
58421,2675,1332,38,57,6,0,65,37,1343
73553,71,22,0,0,0,8,0,0,49
73620,1582,818,0,41,16,0,52,22,764
51014,463,237,3,16,9,0,8,10,226
51648,249,120,0,9,5,0,14,21,129
63359,1403,705,1,14,21,0,38,19,698
66952,386,188,0,10,7,0,5,2,198
68031,1613,849,3,57,38,0,31,15,764
69020,432,218,0,7,2,1,6,1,214
54618,2306,1184,22,56,34,10,54,21,1122
55613,185,78,0,1,1,0,2,6,107
71640,3103,1447,0,83,13,0,118,35,1656
71759,534,265,0,0,0,0,3,10,269
71957,3109,1440,1,58,21,25,78,57,1669
60623,85979,41947,629,2804,509,727,3511,836,44032
83112,439,255,0,0,0,0,0,0,184
84540,146,87,0,0,0,0,0,0,59
78575,12490,6234,56,745,52,63,711,242,6256
78606,5460,2637,22,120,64,46,97,134,2823
79756,9678,4874,142,242,84,72,287,178,4804
80705,1244,624,9,40,13,20,37,5,620
98568,2743,1346,4,77,74,12,83,28,1397
98938,3559,1954,0,61,53,47,93,19,1605
94547,25343,12297,109,817,238,94,805,397,13046
95050,39452,20812,833,1603,355,398,1248,305,18640
76937,30,16,0,0,0,0,0,0,14
77023,29074,14367,327,1456,198,128,1093,266,14707
77356,26753,13372,250,707,420,22,593,260,13381
28775,267,113,0,0,0,0,7,0,154
30810,1906,914,8,48,18,14,72,22,992
37725,17572,8552,52,414,160,70,510,308,9020
38457,786,369,0,57,21,0,18,11,417
45850,3419,1823,9,146,20,23,115,40,1596
45874,2534,1320,8,73,37,0,105,61,1214
46403,13567,6144,15,529,191,101,428,226,7423
41339,10712,5410,89,352,111,90,327,90,5302
42533,735,369,0,55,2,0,22,6,366
95113,1939,1101,32,122,7,0,81,16,838
95470,5719,2930,20,254,115,26,136,112,2789
96118,1808,889,0,60,15,0,150,12,919
97206,51698,25995,143,3077,477,225,3121,525,25703
86432,3735,1913,0,0,104,0,163,163,1822
87083,522,253,4,10,14,0,14,13,269
87544,18356,9353,15,671,222,43,538,357,9003
99583,78,53,0,6,0,0,8,0,25
1747,5951,2757,0,182,63,48,159,98,3194
2141,14052,7367,194,568,105,18,675,124,6685
55105,26729,12779,298,555,217,434,660,504,13950
55409,11674,5588,23,566,122,32,452,92,6086
56278,2642,1350,52,67,23,3,35,61,1292
56288,4850,2402,15,140,55,81,147,154,2448
57657,230,130,0,0,0,0,0,0,100
44076,5022,2345,43,130,36,25,137,54,2677
44112,21909,10145,135,614,269,156,400,350,11764
44251,922,488,0,10,12,7,19,18,434
33463,62043,30233,489,1800,439,237,2480,623,31810
34211,7885,4060,11,154,171,0,144,180,3825
35115,15105,6872,236,263,94,280,411,223,8233
52074,380,181,0,33,4,2,31,1,199
52136,5823,2877,0,180,44,11,126,67,2946
47880,43,16,0,0,0,0,5,0,27
48551,0,0,0,0,0,0,0,0,0
50104,68,31,0,4,5,0,0,1,37
30558,5998,3111,6,174,63,68,165,59,2887
30738,3766,1733,0,66,96,0,86,22,2033
30741,28535,13481,148,716,283,252,806,467,15054
31626,3211,1538,32,58,65,0,73,39,1673
46180,943,461,5,15,10,0,10,29,482
79907,53277,25353,466,1267,403,560,1479,847,27924
80615,7982,4118,15,196,104,0,291,122,3864
72617,59,34,0,2,0,0,0,0,25
68329,626,342,11,25,22,3,26,12,284
70397,810,448,0,1,9,0,18,20,362
21704,16518,8120,72,686,46,78,701,87,8398
5471,709,301,13,33,5,0,34,13,408
14767,2146,1163,12,49,36,16,76,28,983
15332,8112,4003,0,278,147,81,171,218,4109
10455,42283,20172,412,1202,121,616,1686,579,22111
44515,26662,13009,215,915,331,140,644,553,13653
38488,2692,1335,18,29,46,38,70,43,1357
26426,7751,4119,59,224,162,57,120,165,3632
33184,21733,10566,157,272,218,87,453,279,11167
33576,4654,2146,6,78,94,13,52,111,2508
52645,3387,1733,20,119,51,21,105,49,1654
54026,1920,1041,0,80,23,0,43,40,879
54102,815,422,2,13,18,13,5,27,393
68971,309,158,0,1,4,0,3,11,151
64048,4217,2240,21,82,71,2,97,77,1977
59030,1273,644,37,60,42,5,29,27,629
59257,34,25,0,0,0,0,0,0,9
60501,11854,5973,36,402,137,52,461,137,5881
60549,232,121,0,0,0,0,0,0,111
61074,4188,2005,15,65,94,51,163,65,2183
48101,27353,13736,156,1109,344,88,1018,539,13617
49235,2090,1027,0,74,28,19,54,22,1063
70342,4732,2366,0,153,44,0,106,64,2366
54423,2350,1185,10,72,36,21,78,68,1165
54864,1325,692,2,22,22,3,37,7,633
74647,3586,1820,26,72,40,20,93,47,1766
54403,24447,12325,75,703,360,41,843,306,12122
54409,12849,6574,93,449,182,13,370,192,6275
55446,24473,11854,123,1141,132,40,1033,334,12619
55752,347,178,1,3,7,1,0,3,169
56634,1423,722,9,41,19,4,27,14,701
77087,36869,19018,260,1226,326,292,801,342,17851
65711,9212,4514,57,243,98,15,284,144,4698
66091,277,135,0,0,0,0,11,0,142
58737,192,104,0,9,4,0,0,3,88
16699,224,224,0,58,0,0,0,0,0
18453,990,547,11,24,57,0,18,9,443
24273,6366,2955,36,178,45,61,264,90,3411
25871,713,385,18,70,20,15,51,14,328
6065,797,362,5,22,8,13,20,0,435
10916,4361,2124,28,44,57,23,80,86,2237
13036,8798,4412,46,202,95,31,296,172,4386
13103,287,148,0,0,0,0,29,10,139
14098,2905,1488,13,93,56,2,91,75,1417
2809,22258,10853,290,653,294,259,552,226,11405
5251,1440,671,0,46,39,9,60,13,769
35401,37194,17655,1030,778,264,1301,729,512,19539
35622,7879,4064,82,196,177,43,120,182,3815
24925,634,345,0,0,27,0,0,0,289
42718,25597,12711,231,646,156,168,679,434,12886
43215,14440,7847,48,659,171,177,382,224,6593
44052,28576,13835,205,762,406,178,915,455,14741
44274,246,97,0,1,0,0,0,0,149
44850,43,21,0,0,0,0,0,0,22
46950,569,301,0,16,0,0,18,6,268
28649,994,437,0,45,17,0,72,18,557
26710,2129,1117,11,54,59,0,63,13,1012
32336,1373,678,0,46,10,7,56,11,695
98376,1816,850,23,0,33,24,67,18,966
83545,361,185,0,2,6,0,5,9,176
83876,1822,908,1,35,34,9,50,16,914
76002,36209,16772,275,1366,259,200,2035,332,19437
87749,219,174,0,0,0,0,0,0,45
88250,300,179,0,6,0,0,35,0,121
79901,10138,5138,98,285,80,52,209,190,5000
63637,1372,894,74,20,46,0,36,60,478
63869,3456,1620,66,114,57,30,77,65,1836
57552,612,292,5,17,8,0,13,7,320
68117,8658,4099,87,230,18,32,278,142,4559
68856,685,377,0,15,6,5,15,11,308
61466,326,184,0,8,8,0,9,0,142
54635,1714,890,0,47,25,26,24,29,824
5255,4022,1908,25,136,58,26,134,121,2114
20164,41228,21206,414,1504,351,155,1663,392,20022
21734,695,335,9,36,0,0,31,32,360
78596,65885,32478,641,1892,443,683,1786,747,33407
64770,966,508,0,23,21,0,44,12,458
66031,641,613,59,38,0,1,2,0,28
70395,4185,2111,29,247,9,0,138,39,2074
63627,3416,1781,50,82,96,26,129,24,1635
64001,619,308,2,15,5,0,14,24,311
80260,34538,16538,264,1425,303,208,1172,389,18000
72933,5828,2805,81,145,90,63,88,22,3023
57247,295,158,0,4,3,0,0,36,137
95948,11173,5422,207,289,78,126,383,120,5751
50109,3058,1611,5,157,32,0,81,38,1447
50851,2097,1078,0,81,41,0,63,45,1019
68864,1119,536,0,40,16,1,28,9,583
70427,19565,8969,158,570,248,75,513,279,10596
65240,8684,4146,47,43,182,51,172,145,4538
54125,528,251,0,12,8,0,19,11,277
59259,322,159,1,9,5,2,6,4,163
99756,83,44,0,3,0,0,2,5,39
15778,191,115,0,10,3,0,4,6,76
16201,17616,8638,23,503,264,46,579,296,8978
16224,1243,605,9,30,11,0,30,9,638
16640,783,386,14,29,9,2,30,8,397
67643,260,138,0,8,24,0,0,10,122
19102,4937,2505,21,184,93,38,156,46,2432
62999,1794,915,6,37,14,0,61,28,879
11718,3069,1508,29,100,40,15,88,60,1561
63735,835,435,0,26,13,4,36,10,400
12550,54988,26570,340,1603,459,471,1984,708,28418
76666,285,151,3,2,3,0,7,0,134
77598,26473,13512,209,1140,160,346,915,288,12961
61315,213,110,1,9,2,0,1,0,103
72952,2706,1359,39,81,24,0,101,0,1347
73533,27582,13344,195,819,330,141,890,380,14238
73718,602,293,13,17,5,3,7,10,309
85045,7063,3325,43,204,77,9,193,64,3738
64752,776,390,12,18,2,11,16,12,386
66019,380,177,0,58,0,0,0,0,203
54537,493,253,2,14,8,0,16,4,240
55411,31850,16187,286,957,109,180,1290,220,15663
38722,447,195,0,20,3,0,27,19,252
40006,4851,2324,0,168,75,30,161,7,2527
33127,33464,16002,256,1143,155,90,1010,562,17462
33330,15226,7376,156,262,245,177,371,81,7850
46034,6434,3187,80,235,103,0,277,126,3247
46996,6369,3214,2,235,88,34,192,140,3155
47354,1225,653,5,21,11,7,8,10,572
47388,287,145,0,0,2,8,6,4,142
35187,5,3,0,0,0,0,0,0,2
43412,4373,2284,35,112,52,8,155,150,2089
48161,26262,12707,67,804,260,81,912,371,13555
48322,32681,15502,176,857,508,259,1096,537,17179
49031,7346,3650,38,119,128,20,196,193,3696
28594,3697,1807,0,97,49,0,68,67,1890
14625,10122,4870,33,304,170,39,231,175,5252
16633,319,137,0,13,11,0,17,0,182
3461,6106,3065,91,146,93,63,216,74,3041
4087,2171,1088,18,81,0,0,107,0,1083
4240,36097,17240,344,1101,306,406,1132,536,18857
25075,776,291,0,0,38,0,12,0,485
21031,0,0,0,0,0,0,0,0,0
22032,31180,15607,194,828,326,176,1035,514,15573
17581,846,436,4,18,8,0,43,10,410
10588,2808,1275,0,150,31,0,51,32,1533
11738,17352,9091,168,345,168,52,475,211,8261
11949,14863,7718,157,326,135,59,230,192,7145
12856,137,27,0,0,12,9,0,0,110
1504,9246,4487,22,214,54,110,325,116,4759
61911,5071,2455,56,154,30,33,183,47,2616
62098,24,8,0,0,0,0,0,4,16
62244,897,445,2,15,28,0,15,20,452
57217,243,134,0,0,12,0,7,15,109
57579,1318,622,4,26,15,10,20,18,696
32818,55586,26075,287,1716,524,446,2157,556,29511
33912,18402,8895,96,367,396,124,259,341,9507
35254,1574,757,92,0,18,110,0,22,817
42032,234,109,5,9,1,0,8,6,125
43407,729,386,0,2,16,14,38,8,343
46234,27670,13723,115,1225,144,99,1228,236,13947
48213,22795,11194,149,861,277,215,709,285,11601
50319,0,0,0,0,0,0,0,0,0
38622,770,306,2,37,0,4,11,0,464
53549,10450,5184,34,305,128,24,187,113,5266
30060,40705,20753,574,1880,332,436,1542,491,19952
28020,2082,1065,0,88,3,4,82,31,1017
22602,29923,14884,215,932,276,182,1010,435,15039
23231,36657,17599,134,1207,392,211,1322,689,19058
13410,281,148,0,5,7,0,8,1,133
93609,5586,2841,6,157,14,69,199,68,2745
98331,6503,3631,2,439,87,32,191,118,2872
96746,19324,9151,136,621,320,18,687,241,10173
99723,4452,2354,18,122,23,33,162,52,2098
7083,55183,26815,442,1804,556,195,2005,999,28368
8094,40337,20259,131,910,438,179,1296,480,20078
8326,1498,844,27,66,0,0,25,11,654
8880,4550,2273,52,235,39,0,162,27,2277
10988,889,433,0,32,17,0,8,21,456
3070,5621,2775,94,214,38,12,188,171,2846
4951,1019,548,10,10,18,0,41,29,471
25285,564,267,0,40,8,0,14,0,297
25431,319,183,0,0,12,0,11,0,136
26660,362,188,37,0,12,0,9,24,174
35083,3353,1545,26,130,66,0,105,17,1808
37060,2344,1179,0,103,12,0,96,41,1165
30309,24744,12510,20,1094,149,69,1502,121,12234
31533,16499,7655,235,273,197,172,416,166,8844
19971,13216,6525,21,158,248,31,333,216,6691
21239,31133,13305,244,924,364,701,1307,512,17828
80218,19129,9635,7,1062,201,54,730,193,9494
72384,785,467,0,57,8,0,28,25,318
73041,353,162,5,18,12,0,33,7,191
95503,25503,12202,186,959,291,92,942,309,13301
95626,6335,3457,42,207,136,0,170,91,2878
88316,2123,1141,12,5,62,34,35,26,982
98533,359,178,0,0,26,0,0,32,181
74426,9688,4759,33,149,168,41,208,122,4929
6262,642,263,0,8,0,0,32,9,379
19112,0,0,0,0,0,0,0,0,0
6606,47227,22880,443,1544,418,608,1818,543,24347
19610,15439,7279,82,478,179,119,485,261,8160
58372,128,69,0,4,4,0,13,5,59
58716,154,83,0,0,5,0,0,0,71
84772,260,132,0,0,0,0,0,0,128
79603,23064,10822,74,727,168,198,658,499,12242
97478,39440,19699,224,1409,428,246,1250,514,19741
94127,21423,10570,63,699,218,44,860,373,10853
66861,2908,1463,7,40,52,10,100,52,1445
68068,78,32,0,0,1,0,5,2,46
68948,312,152,3,6,4,3,8,4,160
8736,12991,6661,88,205,180,70,199,172,6330
12533,25406,12784,132,764,371,253,709,465,12622
38915,3690,1759,59,31,30,11,44,113,1931
13803,4240,2190,37,111,51,21,70,35,2050
12176,517,249,0,0,0,0,7,9,268
14223,22499,10511,76,670,241,101,744,527,11988
19468,26061,12477,202,829,277,103,967,166,13584
57788,402,213,0,7,11,0,7,19,189
75052,95516,47001,450,3694,663,581,3754,963,48515
48801,12717,6256,154,342,239,186,293,129,6461
76852,206,110,0,4,15,0,0,9,96
20764,4177,2062,28,105,61,69,137,58,2115
4625,77,39,0,3,1,0,0,2,38
17097,842,452,0,25,6,12,16,2,390
18816,147,86,0,0,13,0,9,3,61
71852,9823,4787,88,186,76,45,365,63,5036
4435,1069,498,17,20,17,0,32,26,571
5902,204,106,0,0,0,0,0,0,98
6118,25818,12102,234,894,242,158,1050,357,13716
87015,12889,6188,68,313,92,49,327,296,6701
88419,132,88,4,2,0,0,1,0,44
1033,6333,3172,103,98,55,39,120,19,3161
53130,7594,3893,28,310,72,43,204,112,3701
75840,6627,3079,1,208,26,0,201,44,3548
54124,3463,1902,29,59,65,3,84,40,1561
29154,28666,13661,157,968,236,171,1018,395,15005
21236,38573,19026,114,1430,373,158,1655,412,19547
43917,3380,1586,0,89,76,17,103,65,1794
54495,7610,3761,59,258,113,27,154,76,3849
55043,3682,1774,3,100,44,19,111,69,1908
61422,3164,1651,23,93,45,0,44,48,1513
47862,1508,829,0,101,22,10,20,6,679
57467,302,154,0,0,0,0,19,12,148
3238,125,65,0,0,8,0,0,0,60
47145,2024,1104,23,64,34,21,43,34,920
19530,16151,7551,430,256,122,740,315,181,8600
29720,47797,22235,407,1377,446,171,1587,753,25562
12952,493,258,0,0,0,0,4,0,235
89106,26018,12765,63,964,175,244,706,281,13253
26349,81,51,0,12,0,0,10,0,30
98402,6240,3230,0,322,93,18,247,54,3010
45835,519,237,0,6,12,0,12,0,282
93522,56,32,0,0,0,0,0,0,24
49234,2850,1406,17,66,41,8,35,38,1444
49085,23716,11983,39,731,348,83,753,373,11733
24593,2089,1073,68,50,27,0,62,31,1016
40299,40808,20134,185,1763,523,146,1449,495,20674
22520,6101,3017,43,114,109,10,122,163,3084
53808,1227,611,19,34,0,3,36,3,616
29082,446,211,0,5,8,0,36,7,235
55111,20,15,0,0,0,0,0,0,5
38254,65,36,0,2,0,0,0,0,29
55957,704,348,13,19,5,13,12,11,356
23117,9628,4828,10,311,132,58,192,174,4800
42420,38379,18517,231,924,447,96,1218,608,19862
42649,2514,1290,39,97,71,0,93,21,1224
50702,19300,9556,66,600,257,92,575,222,9744
48063,4024,2105,9,72,61,28,68,93,1919
48334,18975,8590,47,643,206,70,513,296,10385
48380,7573,3895,12,199,157,69,166,160,3678
49315,22744,11093,57,781,269,91,749,311,11651
49903,115,63,0,2,14,0,0,3,52
51022,674,355,7,18,3,2,22,7,319
52069,1495,786,20,66,21,0,35,5,709
43227,24296,11222,79,655,178,126,992,298,13074
58486,247,126,0,1,3,0,15,2,121
50213,6850,3409,15,373,14,24,182,125,3441
7079,16473,7969,174,427,162,324,530,174,8504
47203,27320,13234,170,750,260,214,789,309,14086
68941,791,447,24,8,8,0,14,0,344
96119,59,22,0,1,5,0,0,0,37
62806,3351,1641,0,144,33,0,80,42,1710
99789,469,220,1,6,2,6,36,3,249
54560,549,309,1,15,7,0,2,9,240
78003,9539,4486,105,368,184,0,259,181,5053
60609,61495,30270,600,2156,530,493,1913,750,31225
62463,1242,620,6,61,10,7,65,6,622
86336,11788,5485,80,190,366,0,176,368,6303
99001,6798,4969,46,599,44,6,121,19,1829
33617,45652,22266,458,1580,275,283,1507,424,23386
13673,2260,1146,38,75,23,19,50,57,1114
43836,108,47,0,5,3,0,5,7,61
656,18979,9069,126,434,196,179,568,374,9910
30559,4701,2190,49,65,48,33,155,113,2511
27536,16421,7152,55,359,110,187,536,221,9269
97496,7332,3559,0,310,176,68,197,243,3773
98936,6443,3353,46,359,42,38,278,77,3090
33021,49350,23988,364,1682,439,177,1499,674,25362
58237,5264,2590,11,183,57,2,165,61,2674
33326,32946,15923,167,1163,204,116,1207,387,17023
48191,4102,2054,0,184,91,9,116,26,2048
67109,387,190,0,6,6,6,15,10,197
15692,1146,620,0,0,12,0,15,74,526
53583,5979,2993,11,218,68,12,205,56,2986
7001,18307,10827,137,972,268,63,421,152,7480
56473,3488,1741,10,128,40,7,122,79,1747
11941,2004,948,0,20,41,11,36,13,1056
4471,666,334,0,6,12,0,2,15,332
62692,2122,963,9,33,37,1,54,22,1159
19706,1780,862,0,71,23,5,40,39,918
71832,11238,5664,112,192,62,67,444,114,5574
21718,140,69,3,3,0,0,4,5,71
99574,3111,1642,56,53,176,43,41,157,1469
24823,506,299,0,20,6,0,14,23,207
91934,267,185,0,16,0,0,16,0,82
76250,1017,451,15,21,6,0,7,6,566
63783,122,47,0,0,0,0,15,0,75
74027,1060,526,2,39,9,2,18,10,534
13863,766,393,12,17,1,10,24,9,373
15135,5307,2550,16,117,78,50,103,132,2757
33417,33287,16117,285,989,193,149,815,428,17170
7848,5059,2442,19,195,57,34,197,101,2617
11755,12510,6375,112,492,106,71,490,161,6135
86437,115,61,6,1,0,0,0,2,54
89830,160,117,0,0,0,0,0,0,43
17887,232,109,0,16,0,0,0,0,123
80003,36969,17791,141,1273,382,349,1423,404,19178
91202,23317,10922,97,649,255,136,837,424,12395
646,37494,17864,241,1228,393,139,1361,523,19630
2118,27830,14032,205,1014,251,63,1083,372,13798
98612,2907,1379,35,58,36,26,139,91,1528
93510,7626,3985,39,155,144,12,163,91,3641
7508,22645,10811,188,505,164,108,648,393,11834
52777,1243,614,5,9,19,0,38,21,629
4237,175,69,0,0,3,7,0,3,106
55912,28804,14607,212,1116,383,190,858,246,14197
60966,1626,784,15,62,6,8,54,41,842
22742,1916,992,6,34,19,0,22,28,924
62058,757,384,0,26,10,0,18,9,373
23222,26147,12016,67,713,321,182,820,460,14131
48554,0,0,0,0,0,0,0,0,0
12304,22833,11560,177,690,216,0,775,289,11273
12481,1398,700,0,54,9,23,50,24,698
26440,1248,683,20,14,4,52,23,14,565
27604,47761,23677,217,1918,255,248,2005,355,24084
8081,49836,23924,306,1393,368,288,1598,756,25912
8085,20731,10096,53,741,195,38,1034,284,10635
46128,2000,1102,8,76,29,24,73,28,898
47980,1002,536,7,26,23,3,22,31,466
48906,26086,13399,297,880,218,202,1103,230,12687
40220,33240,15287,71,1095,298,186,1087,613,17953
42045,2221,1118,0,41,24,0,36,30,1103
42214,694,303,0,13,20,7,6,0,391
52209,1046,508,6,25,4,0,44,10,538
52309,394,196,0,17,3,4,5,9,198
54114,5271,2524,5,112,108,24,97,114,2747
36790,312,206,0,0,0,0,0,0,106
37243,0,0,0,0,0,0,0,0,0
37806,2853,1433,27,65,24,83,56,34,1420
38358,11632,5450,95,296,105,15,478,200,6182
49026,2301,1197,7,29,8,25,60,48,1104
49091,19857,9802,210,402,241,113,568,247,10055
45875,11403,5449,10,357,160,31,259,109,5954
46221,26984,13781,237,892,233,80,709,296,13203
46540,11789,6158,96,250,83,222,243,231,5631
43556,1765,851,6,52,20,26,76,52,914
36089,7391,3982,109,378,118,55,213,245,3409
39736,266,113,3,4,6,0,0,4,153
3273,398,240,0,24,17,0,27,0,158
4654,3209,1557,19,85,52,42,94,48,1652
6371,9687,4801,7,194,112,18,187,176,4886
92283,1694,865,0,12,12,20,31,14,829
92394,35365,19112,201,1759,129,334,896,280,16253
92807,35777,17505,191,822,448,243,808,436,18272
93432,1125,444,0,0,10,0,0,65,681
94129,3994,1814,0,245,11,38,136,15,2180
95306,882,471,0,24,42,0,11,33,411
89414,179,113,0,0,0,0,0,4,66
91016,41671,20638,193,1236,414,210,1660,457,21033
83448,2648,1388,42,63,8,6,102,12,1260
83824,282,123,0,7,6,0,3,8,159
78118,4057,2093,9,216,46,0,42,15,1964
80436,517,278,0,0,19,0,24,26,239
93041,24506,12621,350,1059,197,85,801,266,11885
15090,23538,11928,52,841,604,0,786,493,11610
8752,2204,1091,0,26,28,12,86,30,1113
12525,2858,1420,0,142,14,0,27,80,1438
2116,23118,10850,107,570,228,254,737,373,12268
2150,39842,20344,269,1894,209,390,2019,437,19498
5842,567,282,0,4,2,4,25,9,285
6417,4493,2273,15,143,49,19,145,29,2220
16327,3027,1516,10,64,35,21,81,43,1511
1071,1270,582,9,40,29,14,48,35,688
44216,9540,4592,49,218,160,51,221,139,4948
27534,32233,15873,286,843,410,199,892,557,16360
34233,17989,8531,107,399,200,137,318,210,9458
34734,4225,1632,0,86,13,18,139,0,2593
37708,6185,3145,51,136,171,11,152,195,3040
24352,1243,401,0,25,0,0,0,11,842
24592,13393,6055,100,419,75,66,395,123,7338
25608,987,528,0,23,20,17,41,9,459
41528,757,441,0,55,0,0,81,0,316
43540,1358,723,5,49,22,5,24,16,635
44124,37737,17078,71,1147,494,98,1035,692,20659
39180,32526,15787,284,1074,440,162,838,496,16739
31905,18110,12512,571,613,9,62,540,5,5598
95245,1851,913,77,51,20,0,0,0,938
89109,7844,4443,18,369,150,140,312,124,3401
79376,32,17,0,0,0,0,0,0,15
79912,80264,39086,674,2308,630,855,2417,641,41178
92865,20741,10366,147,802,211,155,849,297,10375
69133,463,230,4,4,16,0,8,7,233
60029,560,300,3,12,3,0,14,6,260
54828,710,365,0,6,17,7,11,11,345
32446,11303,5674,25,508,141,65,373,139,5629
49067,4362,2175,28,100,64,24,95,69,2187
38737,2800,1273,35,85,15,21,114,73,1527
16730,60,26,0,0,5,0,0,5,34
17750,164,95,0,0,0,0,0,0,69
7645,8438,3873,25,206,108,112,204,170,4565
8028,20919,10549,819,619,134,401,558,261,10370
12115,127,86,0,0,0,0,0,10,41
12516,1640,641,0,49,16,0,93,53,999
3852,571,230,0,19,0,0,0,14,341
4085,2307,1114,0,79,0,0,36,36,1193
4658,1581,755,5,19,36,20,13,17,826
4785,2264,1084,13,21,46,20,51,55,1180
5053,472,267,0,0,0,0,17,0,205
14035,77,36,0,0,0,0,16,0,41
15131,7944,3777,25,247,87,0,187,172,4167
15345,1367,682,14,29,20,11,60,9,685
18951,34904,16970,29,970,286,106,794,599,17934
20646,20974,10153,58,655,309,55,576,310,10821
983,34798,15469,365,727,278,385,785,406,19329
2767,14326,6583,43,395,177,63,451,214,7743
77534,2303,1131,3,94,10,3,89,54,1172
77701,13889,6791,117,367,158,64,519,171,7098
77857,700,351,0,14,17,0,4,2,349
77879,5582,2529,9,226,35,0,63,89,3053
65334,1001,507,0,28,13,8,58,9,494
66512,2913,1500,11,44,86,35,36,39,1413
59011,3136,1497,51,55,29,17,66,61,1639
15470,786,381,0,0,40,0,2,23,405
19465,17613,8504,37,519,239,136,587,273,9109
25114,394,217,23,14,11,0,30,27,177
25286,1567,851,0,30,49,0,38,9,716
8401,38372,19526,360,985,268,229,1239,377,18846
8638,22294,10709,311,841,196,90,771,324,11585
13101,2301,1143,6,99,26,3,63,53,1158
13439,3518,1748,31,72,58,33,118,59,1770
27822,8459,4075,5,269,186,25,184,238,4384
22973,6009,2963,14,106,84,12,220,103,3046
24053,2699,1368,0,180,30,0,142,41,1331
14135,123,83,6,0,8,0,0,12,40
15003,11327,5500,107,237,126,50,381,108,5827
3770,513,263,0,30,5,6,6,18,250
79501,2710,1146,0,34,68,54,29,47,1564
67570,1321,678,3,40,18,3,34,23,643
74459,85,40,0,6,0,0,2,0,45
71375,1202,600,0,27,19,11,56,3,602
80862,44,25,0,0,0,0,0,2,19
81136,197,109,0,6,3,0,0,7,88
83422,3213,1748,19,154,39,11,140,5,1465
55750,2087,1109,6,45,41,0,75,38,978
55804,14503,7191,113,402,229,98,476,311,7312
46706,18298,9099,32,551,279,69,718,261,9199
18814,210,100,0,6,0,4,2,0,110
57245,176,96,0,17,2,0,13,2,80
53080,5812,2825,28,180,107,72,160,37,2987
82450,128,67,0,0,12,0,0,0,61
83553,1154,640,11,7,18,0,54,25,514
93427,6071,2807,0,125,43,0,209,128,3264
87059,10294,4990,31,238,166,27,176,228,5304
88024,251,156,0,16,0,0,0,0,95
62024,9916,4958,138,246,200,79,288,90,4958
14897,811,396,0,28,9,2,28,6,415
20036,5798,2735,62,244,67,26,387,98,3063
4606,1172,596,0,47,14,0,36,40,576
13069,24511,11920,162,842,241,140,742,370,12591
1850,16267,8882,169,578,160,192,318,94,7385
30217,9144,4421,51,295,111,45,180,171,4723
33838,4178,2202,34,16,43,0,181,71,1976
35151,7516,3718,69,203,141,28,234,160,3798
26617,161,101,0,0,6,0,0,0,60
25311,10614,5165,76,203,91,140,364,217,5449
26257,1260,637,42,0,5,51,13,0,623
43142,102,52,0,6,6,0,2,0,50
95536,2898,1523,0,54,53,16,90,60,1375
95629,795,305,0,48,0,0,22,0,490
98253,1711,935,0,42,42,0,15,73,776
98950,139,48,0,0,0,0,24,0,91
84104,26016,13012,386,841,274,165,892,214,13004
85540,3176,1695,15,120,12,7,140,20,1481
78253,44036,21183,399,1642,343,505,1783,355,22853
65728,0,0,0,0,0,0,0,0,0
66776,1432,760,6,36,13,2,12,55,672
56240,1065,470,5,36,13,0,49,24,595
57501,16876,8209,33,624,292,70,586,276,8667
54009,2699,1444,6,94,24,12,99,20,1255
54174,3120,1620,15,106,43,3,94,40,1500
65284,2004,1016,3,72,21,0,63,69,988
70508,40495,19603,316,1627,418,244,1539,540,20892
71724,444,175,2,12,6,0,12,11,269
42541,590,260,0,31,0,0,73,0,330
44072,4420,2081,0,73,92,21,52,121,2339
34104,24121,11349,115,501,507,68,640,308,12772
36047,1150,483,0,18,46,0,83,33,667
36082,1271,625,70,0,0,116,9,0,646
36605,26306,12136,98,478,367,72,853,524,14170
38008,8773,3927,90,180,135,91,361,89,4846
27986,2339,1674,8,221,20,0,37,16,665
32833,9697,4846,0,234,49,74,333,159,4851
75216,54150,25756,376,1654,299,378,1748,439,28394
83327,767,360,0,24,21,9,36,27,407
84775,301,113,4,0,0,7,6,0,188
97350,223,92,0,9,4,0,10,0,131
18519,4754,2357,26,133,55,18,138,161,2397
8097,3213,1618,21,113,23,20,108,42,1595
22205,19162,9505,27,852,181,20,682,322,9657
22969,1639,864,0,121,22,10,114,0,775
23226,16071,7679,64,527,117,200,559,138,8392
76888,129,66,0,3,0,0,0,3,63
77477,36563,18269,197,1022,326,375,1338,502,18294
78332,28953,13674,253,800,196,120,1040,384,15279
78852,56838,28208,825,1694,415,628,1603,461,28630
79119,16394,7915,49,628,106,80,584,346,8479
98027,30250,14837,137,1148,263,139,1204,408,15413
90262,70936,34586,688,1998,483,607,2628,794,36350
91203,15000,7391,104,568,135,81,675,183,7609
28602,29105,13855,64,1003,451,209,1128,310,15250
28677,34545,17175,279,1024,360,75,1007,307,17370
29341,20482,10093,177,585,186,0,714,316,10389
29682,3669,1855,10,151,29,20,206,11,1814
30818,622,273,0,16,10,25,38,0,349
31513,16247,8172,82,545,119,120,382,231,8075
33983,14422,6664,80,256,304,140,310,208,7758
36312,6030,2886,25,165,52,46,125,37,3144
37892,1973,1039,0,70,2,10,61,17,934
38462,10042,4843,10,244,100,83,311,83,5199
45363,1698,945,3,52,4,5,30,32,753
45506,13868,6437,87,513,95,167,504,160,7431
41174,1032,531,0,32,12,0,32,9,501
41721,531,274,4,2,2,0,1,2,257
42452,2485,1274,20,151,4,17,112,32,1211
3038,33826,17054,141,1022,327,182,1001,543,16772
4614,2663,1195,0,47,52,82,50,74,1468
4777,427,221,8,5,3,0,8,9,206
2155,59793,28632,469,1828,572,485,2285,897,31161
2461,7404,3482,29,158,93,0,229,95,3922
2713,40,25,0,7,3,0,0,2,15
18336,3779,1733,21,149,10,8,126,38,2046
19550,574,430,0,29,8,0,0,0,144
31315,7640,3939,103,162,0,120,151,0,3701
15904,15812,7496,122,262,245,199,323,216,8316
8046,31525,14554,384,781,301,262,967,650,16971
10579,8483,4321,0,280,160,58,230,124,4162
95367,25162,11989,99,1045,141,131,988,374,13173
97231,4019,2074,16,99,67,11,105,115,1945
98158,0,0,0,0,0,0,0,0,0
99333,29,22,0,0,0,0,0,0,7
20111,35797,18310,369,1735,168,209,1517,364,17487
20129,618,418,26,0,0,0,0,54,200
20405,0,0,0,0,0,0,0,0,0
37174,34873,17219,235,1302,285,104,1292,353,17654
61425,375,181,0,7,9,0,2,15,194
62832,8848,4398,32,186,61,2,305,103,4450
62839,6397,2922,28,154,93,36,242,135,3475
79015,22193,10800,420,663,240,562,626,192,11393
79780,250,81,0,19,13,0,18,26,169
68760,1338,629,1,32,10,15,36,15,709
70584,7968,4000,28,90,79,46,329,95,3968
71061,1786,848,8,60,9,17,56,53,938
72332,50,26,0,0,0,0,5,0,24
76483,1065,472,0,6,12,0,22,21,593
78073,8893,4525,61,236,27,88,244,137,4368
84022,595,338,12,28,0,13,3,5,257
84726,864,400,0,15,18,14,12,16,464
60439,23422,11452,253,725,299,43,614,232,11970
64633,4719,2331,0,160,40,29,149,61,2388
64836,24108,12024,78,765,165,186,729,229,12084
65231,3246,1511,23,57,55,4,133,59,1735
55088,1722,914,10,47,25,13,80,15,808
55358,5117,2628,5,170,82,16,198,89,2489
55945,1208,664,1,43,22,3,24,28,544
49410,2019,1055,6,45,29,2,72,30,964
49418,28383,13819,133,850,243,147,687,466,14564
49457,10270,5060,72,329,133,12,291,143,5210
33187,19286,10209,50,439,268,155,548,118,9077
35477,171,121,16,9,0,0,0,0,50
45673,367,146,0,0,0,0,0,0,221
47272,2136,1040,33,47,43,57,24,13,1096
62819,408,215,0,11,15,5,3,4,193
63366,49621,25033,306,1755,391,217,1685,652,24588
64037,5943,3084,48,142,95,20,92,89,2859
70534,945,424,10,44,9,0,25,5,521
72560,8979,4417,35,254,129,19,213,137,4562
74079,4248,2089,13,182,77,22,135,30,2159
78666,79276,39537,2013,2054,301,2834,1953,433,39739
79845,4689,2233,0,136,69,42,120,22,2456
79848,802,389,0,63,0,0,17,19,413
75979,11852,6817,244,566,178,20,228,195,5035
65054,664,375,0,9,0,0,0,0,289
14065,1763,830,8,38,25,14,57,48,933
26060,2012,1156,17,36,23,10,19,29,856
32628,5040,3255,47,260,81,68,91,51,1785
33321,47974,22309,268,1532,632,166,1480,922,25665
35543,1285,694,0,24,6,4,46,6,591
37072,32033,15812,262,823,493,97,898,535,16221
38723,83,42,0,0,0,0,0,9,41
54721,1269,671,10,37,27,7,40,26,598
47982,195,98,0,6,0,0,6,1,97
48124,28891,14082,130,942,314,126,1027,406,14809
43458,521,254,3,30,4,1,26,7,267
14616,27616,12832,186,895,442,254,990,414,14784
4429,4545,2129,14,117,54,35,79,90,2416
95490,12914,6530,61,541,165,91,418,183,6384
65560,14361,7132,74,515,157,97,375,174,7229
44109,40246,19966,279,1416,301,240,1148,429,20280
59640,67,31,0,0,0,0,0,3,36
99668,83,38,0,3,0,2,1,0,45
17343,19,19,0,0,0,0,0,0,0
10519,220,99,0,44,0,0,0,0,121
11793,31238,15021,118,923,303,161,992,627,16217
7481,17047,8180,131,441,296,99,576,269,8867
8551,5157,2433,14,145,57,21,95,96,2724
77304,30785,15312,172,965,244,83,1059,350,15473
78602,27958,14754,219,1077,489,178,750,372,13204
60803,22390,11245,146,733,235,80,836,161,11145
61359,338,152,0,15,5,0,6,11,186
85723,0,0,0,0,0,0,0,0,0
83251,1320,654,0,13,19,9,26,19,666
66227,6192,2896,61,340,47,3,336,120,3296
76082,18951,9291,30,653,177,113,698,486,9660
88340,3730,1760,19,135,19,54,123,36,1970
89149,39372,20050,132,1379,301,193,1441,503,19322
95776,23375,11623,89,706,162,400,634,240,11752
4106,25823,12202,99,686,311,229,1007,433,13621
5262,2308,1295,0,113,16,0,172,30,1013
31042,1477,766,0,46,25,12,21,13,711
15847,300,140,0,3,7,0,9,3,160
25635,1464,744,0,24,13,15,32,13,720
20166,11304,5780,67,567,79,34,608,124,5524
17512,17701,8499,65,557,232,42,658,250,9202
4226,197,99,0,7,6,0,6,8,98
95446,5100,2620,0,171,103,10,125,63,2480
89448,1442,783,0,20,44,0,6,66,659
99551,567,295,5,12,2,2,16,3,272
72086,10253,5251,36,311,114,38,321,78,5002
74730,4800,2197,18,177,91,59,163,89,2603
66538,3351,1671,32,108,30,18,66,55,1680
61460,322,133,3,2,8,0,24,0,189
36322,9201,4308,35,420,55,81,275,69,4893
22938,1349,504,0,7,21,0,108,0,845
22963,16014,7403,74,532,177,28,541,259,8611
2835,5496,2739,21,109,70,0,105,104,2757
4344,2916,1380,0,0,15,0,92,59,1536
4943,1665,854,9,50,16,10,72,43,811
7604,12091,5998,74,421,33,115,591,121,6093
78223,55088,27781,450,1890,376,314,1972,580,27307
78957,9704,4422,68,275,88,141,229,196,5282
58563,2191,1106,4,61,31,3,19,41,1085
62874,415,237,1,19,6,2,14,0,178
63936,948,450,0,30,3,4,33,1,498
71677,192,72,0,2,4,0,8,0,120
65072,1278,629,5,4,22,1,14,16,649
87319,1831,896,24,40,12,9,26,41,935
75662,25702,12849,230,651,240,278,1208,237,12853
73139,17563,8353,151,623,257,184,376,118,9210
82727,1003,477,0,84,0,0,38,0,526
14534,31303,15397,188,813,395,79,999,523,15906
15827,352,144,5,13,0,0,0,0,208
16057,14621,6847,400,234,124,651,270,142,7774
30629,4735,2524,0,149,20,21,79,35,2211
26178,377,192,0,0,0,0,20,0,185
20794,16601,10092,125,1206,143,153,564,171,6509
10953,96,22,0,0,0,0,0,0,74
11102,30800,15375,210,1511,292,154,1265,273,15425
29046,143,41,0,0,0,0,0,16,102
12155,1809,878,3,37,27,32,20,32,931
26588,2576,1281,17,101,26,29,118,28,1295
53597,18985,9399,89,554,197,54,679,284,9586
54539,1218,632,6,38,41,0,24,27,586
54902,22110,11009,267,671,275,207,549,268,11101
37140,1330,1303,0,153,12,0,0,0,27
37315,1566,672,151,0,0,140,0,0,894
16254,3238,1549,16,127,46,4,62,32,1689
16262,2849,1394,49,46,30,48,87,27,1455
18621,6771,3961,23,364,71,15,115,70,2810
12582,6272,4190,9,242,138,0,44,42,2082
18036,13558,6824,111,330,227,36,346,154,6734
76518,1880,850,5,23,6,0,13,7,1030
74937,5492,2795,50,223,71,35,191,77,2697
80737,1682,799,0,56,12,9,86,11,883
76119,50213,25829,445,1690,310,356,1200,440,24384
68878,421,211,2,19,8,0,18,2,210
73057,2282,1134,15,50,10,3,55,51,1148
15754,641,355,0,0,0,0,0,0,286
3855,2699,1350,0,82,29,12,40,53,1349
4649,1295,615,1,48,23,0,51,18,680
78125,78,38,0,0,8,0,0,0,40
83702,22378,10903,83,891,340,126,892,271,11475
78717,30218,15060,119,1431,183,74,1566,205,15158
66949,707,355,7,16,0,0,11,12,352
8886,7285,3523,3,213,75,41,268,151,3762
54141,2291,1190,0,57,15,12,13,46,1101
11024,8101,4481,167,93,84,45,150,68,3620
38125,37519,17985,192,1774,293,217,1277,871,19534
19963,20783,10170,139,723,255,81,535,228,10613
44142,18674,8897,154,446,181,70,470,311,9777
99664,4575,2670,23,187,34,45,61,67,1905
29009,2068,857,2,105,34,1,86,33,1211
30103,16138,7844,243,522,61,163,534,201,8294
62237,2435,1314,20,85,76,0,77,40,1121
41075,16525,8001,65,495,181,18,715,282,8524
42275,678,339,0,0,3,0,6,6,339
42715,212,113,11,0,0,0,0,23,99
65787,1551,787,0,26,25,0,22,51,764
46346,1319,654,9,30,20,30,14,4,665
96123,38,18,0,0,0,0,0,0,20
49503,37255,18949,491,1261,226,411,945,333,18306
40070,672,386,19,35,9,0,41,0,286
94609,22811,11192,68,1043,84,130,1055,123,11619
95135,22358,10647,83,444,316,81,832,293,11711
95558,423,217,0,7,8,0,16,4,206
83434,1490,682,0,24,7,3,45,20,808
74946,136,65,3,6,0,3,3,0,71
5468,13694,6643,98,399,280,70,448,315,7051
5486,1666,808,2,33,33,0,36,43,858
87552,3963,1768,0,183,15,50,111,202,2195
1550,16894,8365,144,358,230,85,484,267,8529
90032,47627,23068,437,1429,441,441,1385,528,24559
99737,4821,2745,13,204,80,30,102,61,2076
29456,30609,14622,238,1488,248,168,1610,411,15987
74020,7371,3654,63,174,66,10,205,130,3717
42462,1183,558,14,67,13,4,26,5,625
59486,1360,653,0,15,33,0,32,27,707
23314,8593,4225,39,336,53,147,246,95,4368
28572,7477,3702,86,194,157,129,126,130,3775
57238,534,287,0,2,9,0,9,6,247
28643,3521,1768,0,162,120,40,62,82,1753
54556,1188,571,2,25,19,5,47,8,617
49873,97,50,0,8,0,0,8,3,47
50632,1045,559,0,13,14,0,17,15,486
18938,14057,6958,96,256,143,36,271,194,7099
3754,267,217,0,99,0,35,15,0,50
4675,187,97,0,5,0,6,0,0,90
23219,4435,2339,117,147,19,99,53,71,2096
6878,8081,3753,10,192,53,8,267,125,4328
14627,2360,1272,136,0,0,100,0,0,1088
15729,1416,696,9,37,32,0,52,21,720
41766,217,80,0,16,0,0,15,0,137
17083,51,30,0,0,0,0,0,6,21
23847,15334,8785,100,834,166,102,283,110,6549
33020,44578,22878,192,1882,605,301,1452,819,21700
10011,50472,26058,275,2697,716,272,1599,606,24414
50147,286,150,0,11,1,1,3,2,136
57033,5467,2810,10,213,53,20,216,49,2657
53946,4371,2247,21,119,80,7,104,47,2124
54765,2,2,0,2,0,0,0,0,0
60440,52246,25822,499,1973,530,183,1637,699,26424
62223,16309,7795,205,484,181,89,484,363,8514
65667,3192,1537,6,110,29,10,63,92,1655
45373,35989,17496,269,1200,376,176,934,398,18493
68122,11873,5547,18,518,83,60,671,178,6326
68780,1074,545,0,21,0,0,30,8,529
63128,29823,14418,257,651,404,47,580,386,15405
66956,1162,556,3,22,7,0,30,24,606
62538,359,150,0,9,0,0,12,14,209
49648,2242,1093,16,43,55,6,74,34,1149
57051,260,141,7,5,2,0,12,6,119
49007,10463,5316,255,266,103,320,222,78,5147
38551,4065,1971,73,68,71,0,70,93,2094
61356,10680,4917,58,305,143,49,204,130,5763
32955,39127,18964,103,1329,339,141,1443,531,20163
62268,712,362,21,36,0,0,15,6,350
48157,1236,562,0,22,45,3,23,61,674
54810,2229,1149,11,70,66,0,64,61,1080
5301,16341,7816,129,481,207,186,414,352,8525
6877,25092,12430,99,765,347,44,736,370,12662
7017,35731,16442,352,1105,461,311,1282,462,19289
28114,7139,3625,14,74,121,31,163,83,3514
72955,270,151,0,18,22,0,0,0,119
75672,15970,7723,99,588,266,61,586,292,8247
96747,874,457,19,25,17,5,19,7,417
14561,3021,1481,7,96,19,63,101,87,1540
14842,832,419,0,0,8,0,20,0,413
15410,1223,646,0,23,48,15,20,29,577
15430,378,192,0,7,4,0,0,0,186
94551,45753,22862,219,1748,313,232,1816,585,22891
97430,347,174,0,22,11,0,16,7,173
93560,20929,10920,67,699,79,75,760,103,10009
99320,9644,4969,108,273,185,79,217,178,4675
86504,7003,3415,43,306,97,71,249,113,3588
56576,829,469,5,25,16,7,21,15,360
3263,4084,1983,33,142,30,18,223,21,2101
63039,555,203,0,0,0,0,12,11,352
64036,343,187,2,20,3,5,15,0,156
90255,75560,37709,554,2646,614,649,2770,583,37851
72730,8116,3816,99,333,102,49,279,45,4300
64746,1352,648,6,23,33,38,40,64,704
84755,47,20,0,3,0,0,2,0,27
66615,3262,1765,0,87,61,0,104,76,1497
68770,1417,750,11,30,15,7,40,20,667
68003,4527,2178,38,160,35,48,122,46,2349
75948,6269,3036,60,64,92,30,145,139,3233
76528,16825,7283,46,653,162,49,1043,237,9542
60930,925,430,0,20,5,0,43,7,495
49656,1616,794,7,53,17,0,43,8,822
56089,148,96,2,4,3,0,2,2,52
50148,392,186,0,5,2,2,16,8,206
38644,211,107,0,4,3,3,0,7,104
39556,8271,4248,137,232,83,93,257,74,4023
98370,31206,15206,255,1148,378,141,1054,456,16000
49440,983,402,0,19,0,0,26,8,581
51521,1895,929,3,55,7,0,77,15,966
35611,25744,11860,141,1027,184,239,599,390,13884
3253,6322,3240,37,88,173,15,85,88,3082
7821,9156,4667,21,161,156,21,326,145,4489
58564,75,47,0,0,0,0,0,2,28
14841,529,214,0,15,43,0,0,71,315
59829,2308,1148,11,85,27,23,58,45,1160
15351,640,296,0,0,0,0,0,0,344
73116,9205,4393,33,334,138,54,318,136,4812
16131,970,514,2,25,19,4,37,13,456
50460,361,213,0,18,9,0,12,0,148
53221,40209,19578,120,1374,497,267,1596,687,20631
63353,4504,2237,48,133,30,14,188,66,2267
8077,19197,9516,67,521,249,91,563,330,9681
65771,1328,745,0,57,29,0,50,17,583
19345,689,102,6,0,0,47,0,0,587
67029,1038,546,0,70,17,0,37,31,492
67072,196,107,3,2,2,0,0,0,89
83669,10270,4909,0,412,120,20,510,57,5361
54740,1856,930,7,42,36,38,43,26,926
55307,3310,1710,5,53,55,21,93,46,1600
63770,136,65,6,0,2,0,4,1,71
56065,2748,1329,13,117,36,5,98,47,1419
45172,191,91,0,2,0,0,9,1,100
62063,1082,518,0,42,15,9,5,24,564
62205,8007,3819,29,196,89,37,230,122,4188
62217,748,421,2,22,23,2,6,2,327
75861,9153,8223,31,1356,72,0,55,0,930
68057,1450,736,8,86,30,0,70,22,714
80819,779,413,4,9,11,0,13,18,366
68976,425,242,0,23,9,0,15,11,183
95607,327,180,0,0,38,0,0,8,147
11955,3785,1627,0,50,61,23,164,93,2158
89142,35376,16974,269,1132,233,114,1449,282,18402
92231,40019,18614,558,1129,487,387,1575,526,21405
25102,194,77,0,18,4,0,18,5,117
97344,1349,684,8,16,12,7,29,33,665
77586,22527,11136,111,584,267,171,741,254,11391
27501,21299,10552,130,775,135,75,578,195,10747
43843,1062,536,7,27,16,23,48,6,526
31328,3583,1845,0,74,62,16,165,74,1738
58479,227,112,0,8,4,1,3,14,115
59840,13690,6659,0,420,221,13,405,309,7031
61933,901,453,2,9,8,3,43,14,448
68622,274,165,14,11,2,0,12,6,109
72854,770,450,0,63,10,0,0,21,320
647,5643,2844,34,167,151,91,89,12,2799
36766,18,9,0,0,2,0,0,0,9
7495,0,0,0,0,0,0,0,0,0
52555,382,207,0,3,3,0,11,4,175
36861,2817,1518,0,41,86,15,85,86,1299
45819,265,111,0,12,2,0,18,3,154
61491,1927,929,18,39,20,6,67,29,998
35116,4372,2074,14,48,43,10,89,48,2298
27889,26576,12652,299,751,443,120,715,393,13924
42463,55,13,0,0,0,0,0,0,42
74343,3067,1513,23,52,39,27,98,49,1554
29588,45385,22518,367,1577,567,89,1350,882,22867
45659,2574,1290,0,103,42,6,58,46,1284
26146,927,432,0,95,2,0,0,49,495
56368,4578,2275,26,96,115,27,116,86,2303
56097,3720,1851,7,129,52,0,106,72,1869
37938,17163,8596,75,432,263,148,600,328,8567
70124,20639,10156,33,758,194,11,801,300,10483
30656,16129,7842,100,620,112,42,365,189,8287
36117,53841,25396,236,1500,516,433,2313,599,28445
36360,19117,8961,101,329,346,58,712,403,10156
22624,2777,1505,26,88,50,86,114,7,1272
42261,10769,5405,23,408,102,69,352,152,5364
28719,8025,3721,87,266,121,53,277,108,4304
16926,962,481,6,21,16,7,19,9,481
15044,27814,13753,53,824,247,62,797,468,14061
12468,1069,563,19,3,14,4,17,15,506
4927,3355,1655,33,73,59,24,63,87,1700
12503,520,290,3,9,8,2,6,14,230
20240,0,0,0,0,0,0,0,0,0
13643,36,13,0,0,0,0,0,0,23
18370,1019,519,0,12,15,0,18,0,500
1450,11301,5528,34,303,151,78,226,188,5773
8804,2540,1361,10,82,24,31,69,30,1179
2467,21864,9965,677,294,162,1032,514,113,11899
12410,471,250,0,56,27,0,27,13,221
17929,1563,759,10,28,14,0,71,18,804
26342,184,100,22,7,0,0,5,0,84
58327,345,180,0,19,8,0,15,4,165
92704,90340,46059,820,3139,643,729,3030,871,44281
58632,182,89,0,9,0,0,6,2,93
85224,44333,21398,327,1954,322,323,1694,693,22935
61436,650,301,18,4,11,0,21,19,349
88004,819,819,2,95,15,0,0,0,0
57623,1066,519,11,23,14,18,32,9,547
93610,23607,10531,83,868,116,286,1191,163,13076
95242,26235,12561,127,761,265,153,763,423,13674
47357,884,438,0,14,6,50,31,22,446
96780,700,381,0,0,45,0,17,0,319
49014,21590,10932,55,757,311,101,687,380,10658
52233,7154,3651,169,142,26,11,258,56,3503
17313,11110,5697,57,406,106,49,421,174,5413
11705,7565,3764,0,158,90,37,242,118,3801
66534,3678,1853,18,88,32,37,64,43,1825
12062,1730,911,12,97,43,0,23,28,819
1079,658,371,0,0,0,0,49,0,287
29706,19419,9272,137,459,243,113,584,299,10147
26547,2632,1385,20,53,62,8,53,28,1247
27928,1771,896,14,28,14,0,37,110,875
31698,731,335,4,0,0,4,0,0,396
24092,2450,1112,0,103,0,10,26,50,1338
28640,4759,2309,8,91,36,17,140,60,2450
21539,2807,1359,26,113,25,26,85,43,1448
21624,207,81,0,0,0,0,5,5,126
21779,1062,558,0,45,31,14,41,0,504
86443,0,0,0,0,0,0,0,0,0
83714,21763,10471,19,824,344,120,673,271,11292
84028,793,373,0,5,3,0,13,0,420
84103,21914,11017,131,840,204,298,981,228,10897
98321,15788,7741,62,579,205,54,734,229,8047
99037,14672,7063,282,483,182,214,302,235,7609
99615,12971,6979,113,392,152,60,398,165,5992
11451,0,0,0,0,0,0,0,0,0
26719,2912,1544,0,50,48,0,21,57,1368
35213,13516,6456,0,493,146,0,444,62,7060
36455,250,109,0,13,7,0,12,3,141
36544,11396,5698,10,386,182,25,341,175,5698
38475,627,332,0,0,9,0,50,0,295
22974,5600,2388,40,254,40,39,346,51,3212
30548,18630,9489,97,679,212,35,534,248,9141
31825,2358,1100,0,47,29,0,54,41,1258
29605,37130,17374,305,1271,254,175,1176,521,19756
29638,3225,1530,46,97,27,7,30,45,1695
81059,541,499,0,107,17,0,0,9,42
81126,194,97,0,0,19,0,0,0,97
83014,3351,1820,23,147,68,1,49,115,1531
83334,2114,1015,33,73,6,2,58,11,1099
71403,4628,2298,7,146,44,51,115,80,2330
71450,1212,572,0,24,19,27,46,38,640
72824,1998,1130,4,77,16,1,33,13,868
73069,24416,12167,537,1009,143,408,692,254,12249
73747,475,204,0,23,0,0,15,0,271
95682,30141,15217,281,950,346,148,895,649,14924
90247,47531,23161,309,1809,399,214,1823,639,24370
98037,29402,14316,170,839,286,216,1052,476,15086
98843,1809,1067,27,38,15,0,64,20,742
99180,1266,636,0,26,12,0,49,25,630
91764,54825,27189,469,1903,308,444,2421,488,27636
85635,33767,16231,295,722,358,218,1203,453,17536
77084,107700,53232,870,4295,748,896,4508,1381,54468
39534,2651,1973,234,8,0,75,25,0,678
40330,19912,9738,89,647,266,46,674,342,10174
42051,3855,2021,0,116,0,0,128,57,1834
62240,1727,927,2,77,29,4,39,20,800
62557,7118,3635,44,201,116,78,178,133,3483
56741,0,0,0,0,0,0,0,0,0
46105,1877,1075,22,94,33,18,97,69,802
47270,498,267,0,40,0,0,32,11,231
47865,317,145,0,0,0,21,35,0,172
48466,1463,727,7,34,32,10,37,24,736
2171,18170,8920,138,623,250,24,634,357,9250
60546,15685,7653,43,428,145,14,388,199,8032
61545,700,361,0,16,9,0,30,16,339
56122,628,329,7,32,11,0,13,10,299
57543,883,395,0,17,9,0,25,22,488
58441,437,235,0,14,5,0,11,1,202
64463,1647,888,0,37,23,6,40,13,759
72117,14393,6798,103,325,214,156,675,167,7595
72611,1762,854,2,48,73,0,116,35,908
70112,2791,1607,17,242,8,75,103,13,1184
70783,2594,1299,0,102,20,0,95,26,1295
78233,48507,24217,432,1837,412,397,1703,767,24290
78539,35321,17096,299,1146,174,282,987,296,18225
669,25653,12611,98,653,300,217,684,341,13042
1864,15642,7950,157,474,216,77,554,372,7692
95550,71,37,0,0,4,0,0,0,34
97360,2181,960,19,41,14,0,48,51,1221
97436,921,474,0,24,31,6,4,10,447
92688,45178,22034,307,1613,322,158,1770,504,23144
88252,2115,1052,0,92,28,12,34,12,1063
99753,271,142,3,7,3,2,6,2,129
64086,23177,11458,195,698,138,80,868,268,11719
19046,17478,8151,91,337,200,123,425,313,9327
70570,40006,18488,277,1180,302,124,1173,551,21518
70772,843,413,15,18,5,16,58,7,430
56111,378,222,0,15,4,0,17,2,156
74078,2329,1339,123,4,0,45,0,0,990
49705,933,459,0,29,6,12,25,11,474
50003,7118,3554,52,330,92,10,346,76,3564
52317,19769,9030,100,812,89,279,798,226,10739
53184,4213,2104,22,82,78,43,122,48,2109
53713,23029,11910,260,916,185,124,844,196,11119
44281,32161,15197,152,1346,363,110,1130,390,16964
46544,31359,15327,201,991,305,172,821,392,16032
46932,3219,1572,4,56,90,48,84,66,1647
49902,146,68,0,5,0,0,0,1,78
49958,840,416,2,30,25,5,49,5,424
50644,8849,4239,94,230,111,62,321,173,4610
52766,824,417,0,34,21,0,45,18,407
53225,26840,12524,211,860,216,123,1071,306,14316
37912,22815,10675,315,637,141,73,730,224,12140
38878,2801,1439,33,78,3,26,85,32,1362
40456,9852,4758,94,252,102,69,312,73,5094
40737,916,477,0,51,0,0,73,0,439
40744,18151,8554,173,615,233,206,651,363,9597
41311,6507,3366,8,253,52,33,138,92,3141
41314,4759,2073,19,145,114,14,150,126,2686
55932,2081,1044,27,44,30,34,39,45,1037
55975,4184,2090,7,136,66,24,144,41,2094
30236,49694,23996,457,1599,415,284,1262,634,25698
30521,5042,2586,12,248,24,18,138,46,2456
19023,22146,10132,116,704,91,88,706,305,12014
19505,3461,1736,0,124,73,0,89,39,1725
12910,2006,1263,7,135,8,0,61,11,743
13206,16360,7785,171,509,221,177,442,210,8575
13752,771,354,0,3,11,0,19,13,417
16066,30380,15387,173,1179,372,72,1176,478,14993
16922,1893,884,0,47,23,11,70,42,1009
17073,5639,2874,17,136,52,8,208,58,2765
26814,429,214,10,9,0,7,0,5,215
27941,494,252,0,9,19,0,9,0,242
23123,1874,810,13,59,0,3,92,21,1064
25571,2114,991,0,87,39,70,30,4,1123
1720,22684,11060,61,590,198,11,631,230,11624
4426,4546,2234,17,173,64,17,119,73,2312
4760,677,361,14,13,22,3,14,22,316
11710,34237,16718,162,774,475,205,986,524,17519
622,6578,2951,66,87,153,87,201,18,3627
54014,2080,1102,7,63,45,6,60,41,978
54416,1893,1005,5,52,28,8,55,20,888
54849,1835,982,3,32,34,0,36,35,853
55814,644,644,0,69,0,0,0,0,0
14589,7426,3562,46,120,54,58,157,98,3864
15045,4391,2168,19,162,15,12,140,66,2223
15734,467,175,0,8,9,0,10,0,292
31324,25643,12773,126,1099,223,132,1095,278,12870
33611,31791,15806,88,1320,392,110,1189,500,15985
24281,2498,1256,0,49,0,0,81,22,1242
30132,40441,19617,184,1412,175,126,1079,447,20824
18417,1044,480,0,38,16,1,18,9,564
10595,8341,4614,37,305,78,80,165,82,3727
1092,1425,613,0,0,0,0,24,0,812
2356,12962,6285,70,257,151,106,328,193,6677
48105,36366,18645,573,899,271,600,977,502,17721
42330,8960,4320,88,254,101,18,175,82,4640
42458,1119,540,19,16,19,0,13,20,579
43517,4134,1986,25,127,51,10,155,33,2148
38841,2878,1386,2,67,25,3,98,27,1492
39149,1997,1014,114,0,0,0,33,57,983
34950,17027,8190,72,332,209,139,486,158,8837
94025,42788,20405,287,1544,347,172,1361,424,22383
53007,1835,991,17,55,24,6,44,31,844
55960,3185,1557,16,91,35,17,97,70,1628
58416,388,197,0,9,4,0,8,6,191
62226,28666,13553,310,648,298,190,664,542,15113
65663,2814,1332,12,103,24,0,129,15,1482
66208,21294,10043,77,760,366,29,829,300,11251
68528,6630,3409,124,204,55,121,186,54,3221
75439,1087,518,0,27,2,14,31,9,569
75949,7501,3617,23,142,37,0,233,152,3884
78028,40447,19421,258,1029,497,222,949,423,21026
73114,18312,8706,48,496,96,132,559,206,9606
70558,0,0,0,0,0,0,0,0,0
71652,929,483,0,20,20,0,28,10,446
83808,131,71,0,5,0,0,0,0,60
84535,3170,1658,54,94,18,49,63,87,1512
97885,1310,662,0,18,62,0,33,33,648
99125,603,339,0,3,1,0,7,25,264
96779,2708,1315,19,79,41,26,142,35,1393
97408,13069,6253,78,372,116,151,251,187,6816
80925,10836,5457,33,382,26,49,384,69,5379
89705,5381,2536,21,136,50,10,238,139,2845
91732,63572,31558,394,2020,562,675,1908,848,32014
91759,374,178,0,11,4,0,20,18,196
95320,13094,6557,46,273,254,81,456,126,6537
28692,3941,2055,12,97,47,0,150,97,1886
29567,534,210,3,10,0,3,35,4,324
29687,41209,20130,122,1320,383,193,1532,456,21079
30110,13190,6343,66,357,140,58,312,294,6847
30222,4116,1802,6,73,37,8,108,30,2314
38736,467,194,8,10,10,0,30,0,273
44243,4721,1811,169,0,0,213,13,0,2910
45771,3433,1667,4,125,24,1,51,51,1766
46312,28448,13435,235,860,211,186,1005,191,15013
47129,19669,9053,182,510,146,112,616,306,10616
47470,1724,917,0,48,26,0,47,9,807
31602,36304,18306,521,1274,296,782,763,388,17998
32514,44759,21701,575,1143,454,441,1272,376,23058
99610,1899,1053,41,44,44,0,37,79,846
99641,869,432,7,10,3,4,13,27,437
80830,181,85,0,0,19,0,0,14,96
95427,222,111,0,0,0,0,0,8,111
96047,851,482,10,20,16,0,14,4,369
97114,5092,2503,45,227,86,9,112,36,2589
56382,1442,774,10,68,30,2,36,24,668
58541,490,239,2,6,4,0,9,34,251
58730,1299,584,0,19,56,0,11,0,715
55968,88,48,0,0,1,0,0,1,40
45612,4793,2376,75,137,56,9,58,147,2417
47036,959,416,0,27,3,0,15,3,543
52040,5718,3040,12,167,42,45,110,40,2678
63730,3047,1479,17,78,28,76,101,52,1568
49093,18381,8930,145,497,130,97,551,314,9451
31207,1107,449,62,0,0,50,0,0,658
31815,3677,2839,121,314,19,0,39,56,838
23084,1472,710,0,15,19,0,14,0,762
16053,4710,2483,18,165,49,21,162,90,2227
16301,15931,7875,62,496,222,176,454,287,8056
12451,1536,894,16,136,10,0,27,27,642
12901,32846,16099,457,934,401,469,946,473,16747
13304,1593,794,2,65,25,0,44,8,799
18106,7091,3202,17,123,106,0,196,100,3889
18510,13443,6373,230,281,196,377,248,131,7070
27242,2170,1231,44,83,33,28,43,34,939
29532,20775,9884,115,567,258,83,546,367,10891
97140,25422,12538,108,788,280,104,1251,349,12884
16115,3139,1545,17,124,50,44,113,66,1594
18254,938,464,4,20,29,31,3,10,474
19363,17119,8561,120,395,212,35,453,182,8558
24910,5200,1949,44,128,132,0,169,101,3251
27516,41551,20433,1076,1093,465,933,1077,575,21118
28371,7249,3710,1,273,101,16,190,44,3539
31639,10237,5019,49,391,111,58,373,93,5218
6778,1359,765,11,0,21,0,14,44,594
3774,2115,1021,0,25,33,0,100,22,1094
71326,1021,548,39,18,15,4,27,7,473
73439,7610,3667,63,196,120,40,244,144,3943
47866,593,331,0,92,0,0,38,15,262
49863,165,92,0,5,7,0,2,0,73
50546,244,124,0,0,8,3,2,8,120
78368,9725,5082,57,197,107,26,189,127,4643
80824,235,119,2,15,4,0,12,0,116
89074,49397,24684,270,1575,483,133,1497,654,24713
89406,23972,12115,168,806,277,194,712,447,11857
75238,33220,16447,212,1256,230,188,1379,444,16773
76273,9575,4485,80,147,151,127,218,151,5090
77070,53239,25250,386,1732,277,264,2315,655,27989
67544,2998,1454,24,116,60,0,87,54,1544
85630,1995,964,0,21,38,0,19,61,1031
39042,38440,18098,140,1655,442,193,1518,390,20342
40076,2625,1344,0,122,69,13,68,48,1281
40504,28079,14229,350,879,281,408,835,197,13850
45812,1973,958,0,60,26,10,68,32,1015
46290,190,103,0,53,16,0,53,0,87
64484,1055,513,0,39,10,1,55,25,542
65710,1116,518,6,28,6,8,26,17,598
66415,926,460,5,42,22,2,38,9,466
66865,1213,615,4,64,25,0,54,3,598
68315,85,47,0,0,0,0,0,2,38
68532,471,259,0,0,0,0,0,29,212
75115,52833,24041,266,1507,664,153,2146,873,28792
80122,33103,16153,78,1032,560,40,956,703,16950
80812,269,153,0,17,4,0,14,15,116
80817,30350,15260,93,1029,291,31,1504,259,15090
78573,38839,18198,420,1125,182,387,1174,308,20641
62690,3991,1967,58,124,22,9,214,57,2024
72401,58553,27851,411,1799,338,483,2124,565,30702
71635,12075,5600,76,414,153,26,521,136,6475
24450,15936,8426,483,162,253,393,293,195,7510
13618,1563,712,2,21,30,15,18,24,851
14886,7130,3637,10,231,76,21,282,133,3493
15960,474,259,0,19,6,0,23,9,215
16034,1885,932,6,45,5,27,80,15,953
23064,258,113,0,0,0,0,0,0,145
26330,15075,7111,79,427,188,30,564,212,7964
12093,1632,852,12,38,31,10,44,30,780
12424,276,144,0,0,24,0,0,7,132
54111,2259,1151,7,66,33,23,55,24,1108
10468,78647,37011,583,2488,528,690,3046,735,41636
17078,21391,10339,187,583,228,48,527,281,11052
17532,2848,1352,49,77,21,30,76,15,1496
75491,4913,2176,29,110,19,45,149,80,2737
77029,18090,8755,109,402,160,231,469,139,9335
67204,21783,10793,231,598,303,99,564,318,10990
73093,3054,1570,26,143,24,18,120,31,1484
73667,526,275,0,8,4,2,11,8,251
41033,1890,986,0,37,0,0,47,31,904
43939,439,202,0,13,3,2,15,4,237
44254,4960,2432,14,141,68,13,186,140,2528
44451,2817,1435,9,105,93,3,85,49,1382
44510,2601,1215,5,110,10,5,79,10,1386
62994,625,312,2,8,3,0,4,3,313
64017,520,235,4,21,6,2,24,2,285
70507,16484,7935,83,549,106,88,343,290,8549
70583,12416,6368,24,549,129,62,555,181,6048
71655,15192,7478,291,279,119,165,335,172,7714
28137,3248,1771,30,133,46,12,80,22,1477
73743,119,70,0,5,0,2,0,1,49
19730,1064,600,0,131,2,0,120,6,464
24977,550,327,0,0,9,0,43,22,223
10801,41759,20310,350,1486,356,227,1534,399,21449
12419,540,226,0,21,0,0,21,27,314
12564,6995,3403,78,216,105,55,182,38,3592
95301,38707,20125,377,985,229,267,1049,379,18582
76445,165,96,0,0,0,0,7,0,69
77659,4773,2312,7,71,48,28,234,42,2461
68002,2745,1378,42,53,20,22,105,20,1367
78046,70320,35471,599,2224,388,682,2405,393,34849
78225,13915,6504,89,331,60,75,502,266,7411
13677,112,68,0,0,0,0,0,0,44
15617,342,188,2,5,3,1,7,4,154
75473,3672,1897,0,105,21,7,142,41,1775
5778,602,328,0,18,21,4,18,12,274
8057,20705,10036,130,351,185,88,517,218,10669
8820,38796,18875,106,1284,543,82,1716,763,19921
95472,30762,15005,148,891,713,79,696,675,15757
66773,840,384,16,14,8,0,30,34,456
8618,39731,18948,700,1238,307,689,1069,474,20783
60084,16612,8157,50,676,164,86,586,203,8455
37405,16163,7558,112,657,99,86,554,178,8605
25108,403,141,0,25,12,0,0,0,262
12838,530,274,0,7,11,0,6,10,256
21111,4995,2559,0,96,60,19,139,64,2436
1970,43155,19651,499,1394,384,582,1467,631,23504
44709,19217,9746,121,584,235,206,550,232,9471
2536,19370,9697,78,568,343,68,537,484,9673
56575,801,417,3,15,17,0,17,59,384
60526,13546,6437,32,476,73,60,531,114,7109
60537,647,379,10,31,18,4,9,12,268
62638,1364,728,6,38,2,4,56,21,636
64146,1506,654,0,16,0,6,23,45,852
47355,2875,1493,13,113,18,44,100,65,1382
48412,5036,2738,59,135,113,13,134,48,2298
64740,1676,759,0,41,25,0,7,33,917
44428,3045,1555,15,94,69,7,83,24,1490
66033,737,383,0,2,3,2,11,4,354
46998,167,73,0,0,0,0,10,0,94
76502,40622,19157,268,1236,397,319,1363,401,21465
50262,421,203,4,2,22,9,19,16,218
78834,8549,4172,153,383,29,0,463,34,4377
50554,1536,742,1,36,18,0,64,21,794
43420,30133,14700,130,915,275,173,843,447,15433
91786,53849,25661,262,1438,590,563,1803,698,28188
81132,2994,1519,15,129,59,13,77,66,1475
3257,4696,2051,55,63,78,142,34,80,2645
75472,3685,1921,14,109,100,31,116,133,1764
75693,7122,3580,38,263,120,84,270,53,3542
1222,810,397,0,34,42,0,33,0,413
89143,13159,6357,35,502,214,53,509,142,6802
2115,29108,14410,1263,393,61,1057,373,42,14698
73527,5284,2913,13,247,71,34,158,59,2371
48875,10482,5287,54,397,78,40,368,159,5195
40047,20180,10370,99,807,216,244,919,153,9810
39094,3988,1929,35,52,21,26,80,22,2059
64067,5547,2749,53,157,116,21,153,144,2798
23460,2029,1615,214,0,0,48,0,0,414
55779,3945,2138,26,136,61,18,91,58,1807
31307,908,566,0,22,0,0,12,0,342
38474,8617,4040,138,142,134,17,336,28,4577
17778,82,43,0,0,0,3,0,1,39
18018,31933,15573,109,1108,289,282,949,443,16360
43910,3208,1569,37,41,16,0,41,49,1639
6415,16639,8339,115,375,209,26,422,179,8300
24520,2245,993,0,56,8,25,102,22,1252
14610,14050,6662,45,347,92,71,325,152,7388
25422,1631,834,0,39,0,0,27,0,797
41572,3423,1551,9,108,0,19,123,43,1872
16920,2046,1062,8,95,18,6,51,10,984
43532,3972,2057,7,101,66,8,89,98,1915
24529,2143,1077,0,28,60,0,38,32,1066
38611,14874,7597,94,527,147,38,440,255,7277
50150,1015,571,0,47,13,2,22,23,444
78838,156,91,0,0,0,0,0,7,65
57059,1243,634,2,30,16,0,31,6,609
54616,2723,1380,10,125,31,6,94,25,1343
57456,816,373,0,35,13,0,10,3,443
59075,265,133,0,16,6,0,21,10,132
60203,4188,1855,42,90,61,0,170,62,2333
43728,1602,805,2,52,34,28,76,14,797
66102,31664,15995,333,1049,202,205,1064,373,15669
66547,8572,4212,163,366,72,20,256,121,4360
57468,390,210,0,5,5,0,5,0,180
66937,691,312,3,7,9,10,29,12,379
73159,33816,16741,106,1148,317,178,1292,433,17075
56657,328,167,0,6,10,0,3,0,161
42408,6608,3084,23,200,62,23,230,141,3524
30429,210,67,0,0,0,0,8,0,143
18080,10984,5655,36,214,129,29,340,211,5329
18102,49583,24354,312,1580,210,323,1620,323,25229
55113,41608,19573,269,1396,440,372,920,477,22035
72354,2475,1255,4,98,60,26,100,50,1220
29148,6910,3095,38,79,187,112,61,134,3815
11378,37279,18168,262,1560,292,175,1481,626,19111
25537,1319,563,0,18,18,12,41,35,756
5739,1423,675,0,26,18,2,43,12,748
26003,41053,19841,369,1074,679,273,1143,672,21212
1247,15573,7606,199,396,179,165,403,224,7967
30164,0,0,0,0,0,0,0,0,0
97442,1878,871,11,34,13,4,68,32,1007
99208,53961,26050,357,1612,433,223,1645,675,27911
98101,12792,7069,74,801,97,21,389,136,5723
2481,16447,6954,34,317,194,457,520,201,9493
1506,3431,1758,17,93,60,11,75,39,1673
94613,861,26,0,2,0,111,5,0,835
86338,464,220,0,0,21,8,4,3,244
64024,16972,8145,84,418,185,165,424,212,8827
89135,27654,13576,81,973,338,50,908,379,14078
78582,42582,21314,608,1445,199,190,1359,414,21268
83463,97,33,0,0,0,0,0,0,64
59086,879,399,0,29,22,0,40,48,480
68007,10451,4991,57,401,64,8,464,114,5460
60190,11143,5620,23,249,158,65,287,206,5523
38392,593,316,0,0,8,0,0,18,277
54624,1489,790,2,32,34,2,45,22,699
46926,1471,818,29,92,20,0,38,14,653
48435,2150,1058,12,79,25,27,22,38,1092
78617,28558,15062,370,1178,107,96,1380,233,13496
50129,4906,2248,22,123,92,25,99,47,2658
92507,57886,29272,1359,1786,421,1420,1051,290,28614
76430,2318,1217,0,44,16,0,20,32,1101
56566,528,243,3,14,3,3,23,8,285
13473,642,328,0,25,11,0,17,12,314
13811,4313,2290,95,188,80,27,137,46,2023
15120,18544,8978,102,554,251,133,584,311,9566
15455,513,227,0,13,31,0,0,9,286
15956,2423,1202,3,83,25,3,95,47,1221
16228,474,236,0,13,7,2,24,8,238
23958,3693,1786,18,65,16,14,118,36,1907
25235,1208,636,0,72,7,0,0,0,572
25564,1252,638,35,82,29,8,75,28,614
64652,439,232,9,17,7,3,13,3,207
30044,88040,43681,723,3791,807,582,3625,968,44359
80645,4465,2233,58,169,43,17,166,32,2232
83867,547,279,0,27,0,0,14,30,268
43783,4731,2440,5,120,72,0,140,73,2291
49424,48386,23905,294,1578,383,385,1549,518,24481
35610,1702,860,0,36,9,1,41,31,842
77984,4028,2051,14,151,60,11,100,65,1977
15427,1132,600,12,41,10,9,34,44,532
81069,2037,1054,3,90,69,0,68,33,983
23842,6784,3463,54,127,82,38,168,84,3321
68624,1025,540,5,30,14,2,26,21,485
22841,2840,1468,39,45,20,5,76,93,1372
79057,1368,658,0,36,22,0,30,13,710
27846,3228,1684,17,47,49,47,72,95,1544
42566,600,288,0,9,0,0,0,0,312
26443,392,211,0,12,22,0,0,7,181
27203,21684,10477,124,561,181,136,808,247,11207
29841,32470,15360,69,894,349,233,1361,480,17110
46340,815,377,0,8,28,0,10,21,438
47117,4363,2456,16,185,52,43,140,81,1907
37203,14232,7025,233,356,133,227,543,71,7207
39702,22963,10820,66,673,204,254,958,300,12143
44704,3490,1515,11,112,26,55,185,37,1975
45211,37201,18140,283,1182,204,229,1203,354,19061
69361,17595,8430,63,503,284,37,504,209,9165
45697,4759,2422,24,81,63,8,76,112,2337
62997,598,314,9,37,0,0,32,11,284
41063,3055,1549,38,111,19,0,162,28,1506
42762,196,70,0,0,0,40,0,8,126
75833,3144,1701,4,39,89,0,73,32,1443
95648,52394,25281,300,1557,643,140,1519,741,27113
92008,27330,13676,261,800,347,120,658,377,13654
92116,33767,16957,73,1856,200,212,1714,451,16810
93524,168,159,47,5,0,2,0,0,9
98074,28395,14240,114,1085,170,115,1407,213,14155
93645,344,117,0,0,0,0,0,15,227
3781,1902,970,11,53,36,0,58,38,932
951,0,0,0,0,0,0,0,0,0
98264,20780,10030,107,561,279,123,730,230,10750
38477,2708,1316,0,85,56,24,30,83,1392
38575,1054,595,0,31,0,0,26,18,459
2324,27397,14451,526,779,251,755,804,266,12946
56376,343,169,0,19,2,0,15,7,174
60422,9768,4608,116,228,35,21,270,245,5160
61759,1529,760,3,20,21,8,39,22,769
84759,2098,1108,0,83,54,1,73,7,990
86023,2485,1212,38,162,61,44,118,0,1273
74957,1198,602,8,48,11,0,27,21,596
80740,112,58,0,2,3,0,6,0,54
91024,11006,5331,38,350,95,54,336,190,5675
98188,24935,13021,368,747,253,221,831,409,11914
99741,510,253,9,19,2,0,14,6,257
72431,417,241,0,7,14,0,0,4,176
72745,13618,6827,116,411,68,111,614,198,6791
73562,585,318,2,10,2,0,22,9,267
93235,4198,2127,75,69,106,21,64,44,2071
67055,138,76,0,0,5,0,0,14,62
29458,3195,1634,63,55,62,13,29,36,1561
30274,35347,16177,289,1231,149,315,1207,405,19170
12475,315,163,0,8,0,0,12,0,152
13472,66,66,0,0,0,0,0,0,0
57385,1086,569,2,24,22,0,40,14,517
55731,5912,3049,5,144,141,40,82,116,2863
56668,151,61,0,0,0,0,0,0,90
58318,3886,1960,50,119,71,9,130,63,1926
58452,39,31,0,5,0,0,0,0,8
72719,12144,5834,28,527,24,155,729,145,6310
73142,14302,6676,0,507,119,41,601,85,7626
74015,8834,4363,55,259,82,74,285,110,4471
74130,2030,1061,10,64,7,16,69,49,969
70712,3822,3469,22,471,66,0,41,0,353
57752,1755,808,0,66,46,22,53,11,947
41074,5458,2710,31,138,54,7,233,55,2748
41080,2207,1230,13,48,7,0,17,120,977
43125,13551,6543,108,334,197,57,586,135,7008
43570,3195,1554,24,130,24,27,76,31,1641
44443,1672,820,0,21,0,0,91,25,852
44505,17985,9055,69,745,214,109,541,309,8930
44691,45048,21886,384,994,560,281,1440,525,23162
53125,1740,858,0,23,41,0,21,23,882
49441,35802,17456,265,1030,481,163,1039,654,18346
49808,234,137,0,19,0,0,0,0,97
31084,43,27,0,0,0,0,0,0,16
39346,2299,1109,6,32,39,2,127,79,1190
40119,1930,995,13,44,37,0,55,38,935
45869,4811,2461,30,131,26,8,162,112,2350
46058,2248,1179,8,49,25,6,65,17,1069
47235,1516,748,0,54,0,0,84,0,768
47616,282,152,0,3,1,30,7,1,130
78151,1538,839,14,10,19,3,23,20,699
78645,11254,5486,47,385,155,18,117,194,5768
80828,3583,2550,49,367,14,0,83,16,1033
61816,458,229,2,12,7,0,13,4,229
62021,920,462,0,15,0,12,9,0,458
64473,1453,740,10,69,45,0,23,18,713
72718,3038,1547,10,173,32,8,154,20,1491
72938,1201,553,32,28,39,11,60,39,648
73855,86,49,0,16,3,0,4,0,37
74084,526,271,7,7,7,0,7,5,255
75164,643,352,0,20,15,0,31,5,291
89704,3782,2025,0,50,107,10,63,119,1757
4020,1278,617,0,33,18,0,27,9,661
12941,1345,699,0,28,38,0,51,49,646
13847,84,41,0,8,0,4,0,0,43
14051,20198,9693,87,473,248,56,570,353,10505
14708,223,111,0,10,0,0,26,0,112
15034,1779,762,7,28,16,0,58,44,1017
15314,3618,1651,12,59,31,46,93,26,1967
40336,12597,6190,146,259,208,132,351,158,6407
26755,711,381,0,19,0,13,24,0,330
27315,1659,844,36,56,43,0,33,10,815
33602,14409,7557,148,701,65,57,547,99,6852
50056,1435,720,2,54,18,12,29,34,715
50426,49,28,0,0,0,0,0,0,21
51447,222,148,0,0,17,0,1,1,74
30275,0,0,0,0,0,0,0,0,0
32580,4364,1964,24,143,58,33,153,79,2400
54153,6999,3515,97,152,90,4,235,145,3484
37087,46846,22561,222,1486,335,282,1664,709,24285
62467,4281,2138,51,145,50,17,158,86,2143
45346,1938,957,9,62,6,7,33,24,981
45686,3699,1790,28,60,22,63,35,92,1909
61014,1289,626,0,20,2,6,6,28,663
46146,308,156,0,0,0,0,0,0,152
48740,2353,1145,4,71,25,8,61,36,1208
71638,3671,2008,19,93,42,15,111,20,1663
72045,1237,533,0,0,0,0,87,38,704
41203,875,434,0,26,7,0,19,15,441
72227,11877,5896,0,375,103,76,476,176,5981
28478,5114,2397,4,158,55,0,145,196,2717
30052,65959,32266,451,2251,740,288,2467,908,33693
56087,2988,1524,11,69,36,2,88,46,1464
55905,0,0,0,0,0,0,0,0,0
55424,9948,5046,8,234,82,50,301,139,4902
74082,67,28,0,0,1,0,0,2,39
39629,6990,3405,45,122,63,79,269,159,3585
11713,9710,4752,16,253,138,116,320,91,4958
32159,30135,13878,62,335,450,93,365,376,16257
36052,308,141,0,17,13,0,15,4,167
41042,51892,25023,331,1734,463,248,1637,655,26869
23841,3281,1599,0,37,69,14,87,56,1682
43013,809,451,27,44,16,6,24,5,358
17401,17766,9008,198,534,83,224,428,167,8758
15417,8159,3717,81,162,82,64,201,192,4442
17033,17568,7812,31,332,254,102,507,1165,9756
3840,3941,1955,9,139,71,0,82,65,1986
12501,2719,1305,1,26,9,48,94,27,1414
5032,2308,1144,7,37,25,0,36,41,1164
5826,960,485,4,32,7,3,22,0,475
13340,8075,3930,32,215,46,37,140,88,4145
13797,2194,1024,40,54,20,37,41,31,1170
17777,7320,3383,14,212,88,21,149,102,3937
26339,212,116,0,0,0,0,0,0,96
80124,21384,10814,206,702,125,100,654,226,10570
92316,28783,14329,159,1015,147,171,997,295,14454
58384,460,264,0,11,7,1,2,8,196
60660,43242,21537,401,2004,344,355,1386,400,21705
85610,978,530,0,12,3,3,17,25,448
57454,618,359,20,11,9,0,12,3,259
98385,301,136,0,6,0,4,0,0,165
32438,3473,1659,0,29,91,44,107,106,1814
95127,65686,34324,634,2118,550,356,2032,711,31362
35971,5428,2767,26,116,63,57,198,36,2661
95930,191,94,0,0,0,0,0,0,97
75441,122,82,0,0,0,0,0,0,40
49130,1665,798,6,6,36,8,15,11,867
50157,807,434,15,5,4,0,1,6,373
11935,3199,1507,25,21,24,0,111,32,1692
63539,221,127,0,5,2,0,10,0,94
39051,16890,8318,126,557,188,95,595,184,8572
4648,765,391,0,9,15,0,20,22,374
6335,6428,3157,21,401,74,0,258,106,3271
10459,48351,23004,453,1437,148,213,1868,413,25347
12444,486,235,0,0,12,0,1,8,251
12749,331,174,0,0,0,0,5,0,157
32804,17653,8643,26,736,135,107,436,261,9010
33803,29675,14119,177,550,277,171,876,399,15556
33990,32901,15350,108,841,387,140,1232,664,17551
42784,2189,1130,0,148,32,3,70,32,1059
43457,1536,784,8,23,28,11,47,4,752
46615,12919,6128,113,512,194,67,506,136,6791
47630,36245,17713,286,1272,347,152,1190,461,18532
49302,8875,4601,67,257,67,23,259,95,4274
50516,598,277,0,21,10,2,32,0,321
52542,402,216,0,10,4,0,6,6,186
52574,728,383,14,18,39,0,10,23,345
28722,6477,2978,13,114,51,24,115,84,3499
30635,14964,6992,27,343,200,193,370,205,7972
22937,2220,1038,43,52,20,8,27,48,1182
23966,2432,1368,2,101,15,26,63,28,1064
24127,3600,1693,0,0,18,2,36,89,1907
11771,9500,4622,77,217,132,33,353,157,4878
28615,1767,829,35,43,22,16,61,45,938
30102,41642,20790,398,1446,475,238,1856,651,20852
20707,32556,15600,292,832,297,183,1235,369,16956
20871,20008,10124,77,883,99,37,1136,170,9884
21769,11189,5513,75,382,140,45,434,268,5676
24553,1430,755,27,73,28,0,36,34,675
93249,2088,1122,8,84,10,39,79,7,966
93551,51085,25055,218,1427,467,319,1289,619,26030
93664,408,227,0,3,10,0,0,7,181
87548,1341,474,0,0,0,0,288,39,867
95121,38102,18939,271,1406,633,354,1184,609,19163
95348,34241,16759,474,1002,319,956,947,257,17482
95563,604,274,1,0,75,1,13,54,330
95652,667,289,0,22,0,2,38,0,378
85552,6572,3323,109,254,99,88,215,64,3249
98542,560,277,0,0,10,0,11,11,283
10018,9687,5144,27,791,83,59,436,112,4543
3835,6884,3633,140,175,104,85,74,89,3251
4732,1694,921,4,50,20,13,49,24,773
6268,10695,5260,993,175,75,1276,137,36,5435
25209,1367,747,0,14,30,9,29,11,620
26056,106,51,0,0,0,0,0,0,55
32550,8490,4121,5,256,50,51,137,130,4369
33314,26188,13434,472,835,167,273,662,194,12754
37391,1321,664,0,51,26,0,45,35,657
38131,0,0,0,0,0,0,0,0,0
23894,481,251,0,18,0,0,0,0,230
31629,732,294,0,4,11,0,0,0,438
21723,893,439,0,29,0,0,12,27,454
29651,47493,23804,421,1456,471,278,1480,632,23689
79938,80143,40367,669,3579,219,560,3453,613,39776
80434,41,20,0,0,0,0,0,3,21
94306,27549,13359,118,934,244,53,1002,249,14190
97149,866,474,0,0,14,0,10,12,392
87061,373,166,0,0,0,0,0,0,207
87531,510,365,0,206,0,0,0,0,145
88337,2139,1026,0,32,9,0,54,33,1113
93550,77006,37405,598,1916,369,654,2160,815,39601
74552,1183,614,10,51,10,12,20,19,569
84652,809,407,0,19,28,0,47,19,402
76689,3359,1619,10,109,71,21,133,50,1740
78107,409,212,0,0,0,0,0,15,197
41052,80,47,0,0,13,0,0,0,33
41514,3200,1420,13,45,32,0,67,45,1780
62365,620,362,2,20,4,0,10,2,258
63381,694,362,0,0,0,0,36,7,332
63847,195,56,0,6,0,17,0,7,139
55751,1582,855,13,43,32,3,41,39,727
56285,1128,568,2,34,13,0,31,13,560
57039,3561,1812,7,162,37,0,105,16,1749
49098,5944,2790,4,162,106,8,260,77,3154
2366,198,198,0,20,0,0,0,0,0
69145,3189,1603,18,117,32,10,90,44,1586
56249,283,157,3,11,8,0,5,5,126
57239,226,117,0,6,7,0,7,7,109
58759,783,413,3,21,2,4,20,8,370
62827,1175,534,3,55,18,0,38,24,641
62895,2028,1024,4,29,18,27,54,22,1004
63558,704,343,0,2,8,0,20,21,361
73538,6016,3163,0,194,96,29,225,76,2853
74085,2223,1052,4,57,23,0,79,54,1171
70582,19546,9370,63,525,267,226,828,284,10176
71069,692,387,0,29,4,0,21,0,305
71962,526,224,0,0,26,3,8,10,302
79403,18147,8791,101,648,152,120,618,280,9356
2645,9487,4592,19,138,217,13,260,171,4895
98926,33572,16549,664,1031,340,1013,823,483,17023
91761,61124,29998,933,1842,531,596,1840,596,31126
39771,89,40,0,2,2,0,0,3,49
44035,63318,30759,225,1592,692,439,1759,1233,32559
44055,19943,9554,327,538,139,314,707,273,10389
44314,19113,9399,97,683,192,63,628,257,9714
45382,1287,735,25,32,7,18,27,22,552
35773,12775,6186,131,465,137,68,474,207,6589
31806,5180,2523,37,119,49,36,171,28,2657
32461,34,23,0,0,0,0,0,0,11
62670,2883,1440,10,103,14,5,114,31,1443
18508,13182,6205,215,432,151,79,443,109,6977
72141,768,355,0,0,7,0,23,0,413
73131,3823,2052,47,137,41,0,138,66,1771
51001,2329,1094,0,56,21,11,67,27,1235
52101,13580,6560,293,290,181,356,426,285,7020
53560,3769,1900,27,95,54,18,136,60,1869
50155,300,153,0,0,1,0,4,3,147
34105,17248,8141,44,540,290,58,353,351,9107
56386,622,310,1,26,11,0,38,17,312
59803,17881,8722,96,626,237,146,697,314,9159
41754,403,185,0,14,0,0,0,0,218
42081,1708,867,0,93,33,52,57,7,841
32058,4585,2777,46,237,20,111,100,96,1808
19964,1152,552,0,27,0,0,23,14,600
21131,7456,3657,24,130,81,34,199,126,3799
12549,11235,5385,80,281,115,75,214,214,5850
14136,4551,2130,14,101,73,32,113,58,2421
16226,7633,3531,24,185,170,42,140,89,4102
17055,36034,17518,190,1018,356,125,1000,525,18516
17235,980,442,0,44,0,0,65,30,538
33175,55334,25745,423,1835,653,254,1435,947,29589
33614,48029,24425,274,1672,345,336,2154,849,23604
2125,34358,17211,290,1440,187,429,1191,358,17147
4093,8202,4027,31,183,69,34,207,55,4175
8329,248,117,0,11,0,0,17,12,131
11228,44994,22024,282,1398,421,197,1440,533,22970
6020,0,0,0,0,0,0,0,0,0
772,20055,9387,136,534,229,147,575,234,10668
52729,829,454,5,44,23,6,27,18,375
55732,1440,781,5,37,32,0,43,36,659
67127,613,304,0,15,13,15,15,2,309
68940,645,368,7,41,8,2,22,9,277
69120,1184,633,0,11,12,6,12,14,551
78737,16160,8086,47,439,116,72,725,211,8074
63127,4986,2439,12,122,71,21,157,42,2547
83821,219,92,0,0,0,0,11,0,127
98544,59,33,0,0,0,0,12,0,26
98846,1263,626,5,45,2,11,36,7,637
93309,59378,29144,478,1986,518,745,1791,596,30234
28510,1503,717,1,33,51,4,22,28,786
38618,12177,5696,17,245,166,102,281,164,6481
38643,2096,987,8,128,7,14,64,6,1109
14718,1988,1070,43,41,34,23,23,9,918
30253,55176,26061,284,1817,444,438,2150,723,29115
23452,59324,28850,301,1963,543,404,1792,811,30474
24528,3347,1531,0,61,45,0,108,30,1816
25430,8514,4329,9,262,121,44,218,123,4185
18628,211,114,0,5,3,0,11,7,97
13315,1543,788,0,47,12,5,39,19,755
4917,2840,1358,46,81,55,23,101,37,1482
7935,420,173,0,0,0,0,0,0,247
10457,74554,35086,745,2283,478,609,3047,756,39468
48729,1457,734,4,19,17,4,36,14,723
49074,135,24,0,0,0,0,0,0,111
49272,2352,1120,13,64,59,0,93,58,1232
40003,1791,900,0,119,54,17,42,69,891
40914,195,63,0,0,0,0,0,0,132
42079,1555,823,0,25,0,0,17,8,732
42274,2193,1201,0,116,19,0,49,26,992
43749,2376,1136,0,62,44,20,49,77,1240
46107,12914,5906,73,323,185,59,492,215,7008
50012,4817,2727,158,0,0,113,0,0,2090
51010,389,164,0,8,3,0,3,21,225
51030,1670,800,5,52,12,3,62,19,870
35466,5567,2937,10,142,62,9,171,53,2630
93245,38606,20140,647,1261,225,328,1375,201,18466
81620,10842,5784,42,749,41,8,685,57,5058
97327,3341,1597,0,114,35,13,90,79,1744
976,58893,27435,527,2028,736,351,2487,953,31458
56669,341,203,0,4,7,0,2,0,138
55738,537,291,5,17,14,2,6,18,246
46365,793,401,0,14,0,0,0,49,392
51562,434,195,0,24,5,1,27,4,239
52324,2136,1081,3,115,13,5,90,33,1055
42519,3638,1995,40,126,32,34,114,133,1643
61050,445,241,10,25,22,0,16,5,204
32348,12673,7783,72,663,111,31,271,154,4890
14803,831,465,4,33,8,3,19,11,366
12067,1635,827,26,31,15,0,40,21,808
13755,1148,565,0,24,9,23,42,25,583
24740,30672,14493,122,805,383,132,955,478,16179
17948,4777,2205,49,81,44,72,81,80,2572
18195,0,0,0,0,0,0,0,0,0
95409,27312,12427,28,548,396,156,603,387,14885
96741,6284,3207,40,105,100,67,181,138,3077
97906,309,144,0,10,7,0,5,6,165
94134,42471,21008,190,1656,620,229,1492,699,21463
34205,32534,14902,174,873,354,186,833,534,17632
35673,7720,4220,35,322,48,10,188,112,3500
24269,413,167,0,17,0,0,0,0,246
5649,356,179,0,2,3,2,7,12,177
71747,1088,505,0,43,11,0,80,12,583
72635,3918,2019,0,143,47,60,117,42,1899
50068,341,147,0,21,2,7,4,0,194
50227,22,7,0,0,0,0,0,0,15
80860,610,341,0,8,8,14,7,14,269
83464,444,222,2,17,9,0,19,0,222
92649,34406,17247,183,1227,426,81,1183,663,17159
95956,290,138,0,10,0,8,9,22,152
75446,3398,1673,46,82,48,68,76,47,1725
75469,276,135,2,9,0,0,1,0,141
83645,826,396,0,39,22,0,44,23,430
84302,25492,12726,215,778,341,182,890,322,12766
46601,6004,3330,80,215,36,27,266,100,2674
68359,1676,887,4,64,23,2,50,34,789
68430,1518,799,0,43,22,56,47,70,719
80611,1154,536,0,90,15,0,19,33,618
82732,1823,949,16,67,46,0,35,24,874
82923,341,214,0,25,0,0,44,0,127
83709,58541,28895,317,2502,1005,239,2288,680,29646
84522,295,178,7,10,7,0,11,5,117
60195,5568,2476,0,337,23,9,150,41,3092
60551,5500,3754,75,278,108,3,61,26,1746
61071,13997,6945,106,330,165,35,468,188,7052
57537,105,58,0,0,0,0,0,0,47
78567,495,194,0,12,12,9,37,8,301
62512,446,238,13,10,12,14,0,0,208
62959,28201,14573,149,1027,234,149,759,340,13628
63350,484,253,0,7,10,0,7,2,231
73901,185,88,0,10,0,12,21,0,97
69360,1426,698,3,28,4,0,38,24,728
71346,2689,1327,0,79,22,0,104,63,1362
23139,24199,11834,203,567,230,107,693,456,12365
23238,25979,12330,106,630,357,163,949,511,13649
25111,616,392,28,10,4,13,47,8,224
15350,392,201,0,0,0,6,0,7,191
15420,328,209,0,0,0,0,3,0,119
16161,680,304,5,0,8,8,21,9,376
16847,263,86,0,0,0,0,0,0,177
17368,7395,3718,21,234,93,11,127,215,3677
31210,34305,16102,10,727,316,222,1007,558,18203
33309,40926,20719,78,1559,386,168,1877,441,20207
20144,964,542,0,34,21,0,38,9,422
10016,51057,24165,165,1907,445,415,1741,565,26892
26722,757,382,0,14,19,0,0,0,375
45102,22397,10811,49,728,239,41,731,428,11586
24442,98,43,0,11,0,0,0,12,55
45714,9388,4540,0,262,120,97,224,166,4848
17925,417,209,0,37,16,9,7,15,208
51237,1652,769,0,43,19,8,57,15,883
29530,2325,1145,31,55,31,13,86,27,1180
36020,999,412,10,36,4,0,32,6,587
62675,5869,2806,50,124,83,5,134,112,3063
74128,13005,6667,105,432,134,106,527,112,6338
30542,37056,18770,235,1102,368,206,960,441,18286
68741,675,374,0,28,11,0,9,15,301
33629,25999,12804,64,1025,220,25,983,425,13195
78583,7322,3316,0,203,93,24,197,90,4006
24089,2575,1315,43,102,0,19,27,67,1260
78728,21480,10957,88,1177,187,81,1110,200,10523
70050,84,53,0,0,0,0,0,0,31
8559,5110,2557,94,72,96,47,172,101,2553
28139,20900,9968,134,344,280,152,575,251,10932
18626,521,259,9,18,16,0,0,9,262
29541,9601,4723,81,415,135,128,464,139,4878
13411,3189,1541,21,59,43,28,106,37,1648
51601,5664,2722,29,193,84,75,174,124,2942
37846,4651,2089,24,65,41,56,79,65,2562
19970,8347,4068,19,33,249,11,125,254,4279
21403,30855,14831,164,1143,344,105,975,432,16024
11747,18922,8762,37,431,134,93,564,295,10160
12064,380,183,0,0,8,0,27,5,197
16344,487,238,0,1,4,0,10,4,249
50420,328,150,0,15,17,0,13,9,178
4933,24,19,0,0,0,0,0,0,5
58331,81,29,0,0,0,0,0,1,52
67301,12559,6348,133,331,165,117,383,241,6211
28303,29414,13958,303,1035,233,162,863,424,15456
69032,561,294,4,14,2,0,23,17,267
58423,36,17,0,0,0,0,0,0,19
73942,13454,7431,107,558,40,80,468,145,6023
3752,772,399,0,15,14,0,17,10,373
41655,905,563,16,0,0,23,0,0,342
58487,419,204,0,2,15,0,12,14,215
64674,395,181,3,11,5,3,14,8,214
92322,686,310,0,29,0,0,0,15,376
84003,48791,24866,305,1893,267,265,1584,362,23925
55324,1218,656,2,34,33,7,27,18,562
85350,22306,12165,449,976,154,99,652,245,10141
79044,701,334,0,6,0,7,36,3,367
87933,138,104,0,0,0,0,0,0,34
61776,1348,643,4,26,35,0,44,6,705
91207,11371,5364,131,219,79,17,307,143,6007
21865,504,248,0,0,0,24,36,0,256
6782,2391,1006,0,58,26,0,62,23,1385
7504,11498,5350,188,424,65,30,417,116,6148
11740,9070,4208,34,206,133,45,174,122,4862
12529,2730,1463,4,88,24,5,55,12,1267
13361,813,444,5,24,22,0,33,2,369
8105,28534,13926,211,1222,188,185,1203,311,14608
2346,24463,12566,184,579,244,64,714,377,11897
38034,2785,1336,10,83,52,19,115,4,1449
31092,7133,3460,45,263,113,85,62,140,3673
32606,23766,11710,283,869,76,126,886,232,12056
32819,27442,13608,255,753,252,183,872,359,13834
33031,7387,3829,78,133,38,167,138,52,3558
44081,7104,3474,24,219,99,19,214,117,3630
34223,17370,8501,0,386,351,21,210,426,8869
26851,1765,891,1,20,11,2,33,4,874
41064,1848,1017,6,83,12,18,80,6,831
28445,7278,4000,0,158,79,22,198,69,3278
28681,25636,13235,62,766,363,136,543,436,12401
48755,2985,1491,20,93,43,6,91,63,1494
95488,251,132,0,26,0,0,0,0,119
95934,341,226,0,21,0,0,31,0,115
97411,7572,3806,0,82,68,72,132,191,3766
97867,723,339,0,33,19,0,36,9,384
98118,48436,23940,227,1656,512,230,1851,602,24496
83836,778,415,0,2,39,12,15,37,363
66845,1195,625,25,22,9,3,20,15,570
68018,432,245,0,7,1,8,8,4,187
68633,1307,603,0,53,16,0,28,11,704
68943,257,119,2,0,13,0,13,22,138
49601,21529,10672,60,674,305,49,521,304,10857
51232,718,348,4,33,3,2,28,22,370
52305,586,297,0,31,4,1,57,15,289
64138,26032,12321,262,636,163,129,872,328,13711
45805,23285,12023,222,664,319,181,693,146,11262
71355,2639,1294,13,142,45,5,129,47,1345
54467,14067,6981,64,358,239,186,358,133,7086
48035,34519,16486,205,1013,286,137,1019,633,18033
48072,15360,7551,23,820,219,89,647,236,7809
48122,10419,5075,0,130,95,100,467,81,5344
48304,16094,7805,50,270,341,77,475,251,8289
29696,5386,2624,16,92,84,3,80,87,2762
30460,2079,902,165,0,0,47,0,0,1177
43229,53693,25194,232,2199,363,433,1660,413,28499
34117,15794,8248,102,677,85,173,379,151,7546
39772,1690,917,5,9,80,0,30,22,773
40062,218,106,8,0,0,4,6,0,112
24538,5031,2677,52,141,53,11,136,62,2354
72126,3645,1850,50,132,51,34,157,54,1795
74881,5282,2589,60,125,51,37,194,73,2693
82620,246,144,0,0,10,0,0,18,102
93251,229,131,2,7,2,0,1,3,98
95466,993,590,0,29,0,0,63,0,403
15483,404,219,2,4,13,0,6,8,185
5341,388,189,0,0,8,0,8,0,199
12590,34711,17730,331,1044,433,193,1093,595,16981
20735,39323,18825,288,1265,378,273,1375,758,20498
22737,3046,1511,0,113,37,0,200,25,1535
14620,24542,12499,173,846,139,268,589,183,12043
15046,2593,1264,13,62,30,22,85,30,1329
75247,730,557,12,14,9,0,0,0,173
76458,6025,3467,153,290,74,35,179,40,2558
77354,36679,18018,74,1115,337,88,1025,365,18661
85256,5862,2893,69,164,23,32,234,100,2969
95462,1265,667,0,45,19,0,28,26,598
96701,40439,20815,385,1485,439,318,1093,552,19624
97343,203,96,0,7,0,0,8,0,107
98092,45739,22431,289,1436,363,179,1888,688,23308
98102,25448,13718,39,1228,180,59,1151,299,11730
93534,39088,18108,251,1009,406,416,1524,445,20980
94937,816,402,0,6,6,0,6,25,414
95248,189,98,0,0,26,0,0,0,91
90720,22389,10779,183,564,272,82,764,301,11610
98811,102,51,0,0,0,0,17,23,51
34219,23792,11189,80,737,271,20,669,400,12603
34667,33960,16009,206,480,779,142,553,514,17951
35444,3962,1859,42,139,21,15,225,81,2103
35630,33172,15535,328,890,277,526,943,551,17637
37128,51021,25551,522,1863,231,381,1719,329,25470
37694,1968,1011,32,31,58,11,98,25,957
45634,1926,949,16,34,24,8,81,24,977
45693,8691,4324,32,141,156,102,184,115,4367
46574,9369,4484,97,331,155,88,212,206,4885
43110,38817,18270,256,1200,346,148,1233,636,20547
4766,395,202,0,15,4,9,4,3,193
4858,1365,706,4,45,20,0,30,30,659
5068,3192,1515,26,87,14,0,77,67,1677
6231,3952,1933,14,126,61,0,143,92,2019
1607,8583,4303,55,328,19,60,277,142,4280
22407,58526,28568,289,1725,534,291,1964,728,29958
25567,693,259,0,20,0,0,0,36,434
18632,524,279,0,30,3,0,11,6,245
18833,1970,1023,11,26,15,8,43,27,947
15001,30945,14971,107,963,432,40,826,575,15974
10566,23951,11385,110,1126,175,24,1055,472,12566
94612,16062,8490,67,882,266,10,722,168,7572
97801,20940,10950,122,832,185,113,477,233,9990
90077,8993,4417,38,189,107,43,331,138,4576
21211,16299,7856,29,795,163,39,938,78,8443
36446,472,234,0,0,12,4,2,17,238
99820,527,297,0,29,7,0,32,7,230
60942,5871,3027,25,197,75,11,123,37,2844
62062,8008,4033,32,270,36,30,313,105,3975
62338,1316,721,11,66,0,0,22,20,595
67632,207,102,0,0,2,1,7,1,105
71323,1038,449,0,81,0,10,45,0,589
59022,2359,1096,21,18,25,0,23,6,1263
59843,275,117,0,4,0,0,5,4,158
66604,22656,11108,225,771,229,169,620,268,11548
55398,15891,8210,117,670,124,0,526,246,7681
57759,527,284,42,0,0,16,9,0,243
48187,49686,24607,298,1388,481,250,1711,543,25079
49748,190,95,0,1,1,0,2,11,95
41848,0,0,0,0,0,0,0,0,0
34747,19413,9191,145,707,275,109,428,173,10222
43547,179,87,14,0,0,0,10,0,92
44074,11376,5353,325,168,105,326,161,196,6023
32444,21730,10190,105,806,207,84,442,237,11540
46321,22840,11383,158,696,240,99,548,408,11457
33813,37211,17993,93,917,595,271,1237,696,19218
36862,5882,2737,0,204,77,17,176,85,3145
38104,23517,11568,167,937,306,247,599,463,11949
54082,1500,851,0,30,20,0,15,50,649
61561,2469,1251,28,64,34,7,41,41,1218
62824,1711,860,13,54,9,12,42,23,851
73572,3633,1761,26,80,68,6,98,89,1872
79905,22447,10540,96,412,187,113,709,381,11907
80031,35509,17707,136,1192,346,297,1019,448,17802
75207,7813,6008,140,684,49,18,196,49,1805
64506,24304,12379,279,1038,244,207,785,274,11925
25906,457,224,0,13,22,0,0,30,233
58722,1786,1014,9,49,26,0,43,19,772
64734,1970,1059,12,17,34,30,69,42,911
17350,12876,6006,174,296,148,77,300,183,6870
15534,1048,513,6,10,22,11,4,14,535
28315,13700,6448,145,494,89,48,417,228,7252
32176,14629,6880,56,205,228,5,220,257,7749
7748,27396,13873,100,792,303,135,773,289,13523
33558,22843,11289,24,795,297,86,763,321,11554
56029,759,410,1,17,12,11,17,8,349
29678,22658,11097,47,745,317,65,820,348,11561
41643,73,29,0,0,0,0,0,0,44
2912,1360,644,113,0,0,89,0,0,716
15458,2313,1233,53,31,60,20,35,25,1080
24868,1147,582,26,41,18,0,52,38,565
17315,26000,12791,145,894,293,179,725,329,13209
20705,27873,13386,118,1075,304,244,962,259,14487
38829,18965,9233,194,778,148,75,396,125,9732
4057,63,32,16,0,0,0,0,0,31
45647,2579,1331,14,63,41,26,40,43,1248
7009,12531,5555,55,417,60,157,459,141,6976
27574,14489,7447,76,227,312,54,423,180,7042
7631,28238,13489,203,844,325,81,1064,483,14749
10975,257,155,0,10,0,0,0,0,102
11795,24982,11907,109,554,285,263,599,488,13075
99503,13221,6912,89,449,111,83,511,151,6309
19152,37067,18100,302,978,376,108,1139,797,18967
83642,45030,22305,365,1396,466,167,1360,503,22725
93512,313,144,0,45,0,0,10,24,169
3865,7677,3613,17,240,111,43,432,99,4064
5454,5051,2503,42,273,53,0,163,84,2548
22835,11636,5750,34,282,194,47,419,172,5886
81220,134,79,0,0,7,0,0,0,55
83335,1905,1002,11,71,8,26,61,12,903
83338,20867,10561,28,775,197,109,755,244,10306
88339,518,214,0,41,10,0,27,35,304
58065,48,35,0,10,0,0,0,0,13
89436,42038,20853,175,1610,474,126,1486,552,21185
68881,20,10,0,0,0,0,0,0,10
55075,20274,9910,199,678,194,48,696,265,10364
94030,22710,11137,38,724,192,70,811,365,11573
78344,353,170,0,6,0,0,20,4,183
78204,12211,5969,34,460,214,169,389,159,6242
8109,22385,10607,128,682,258,78,866,370,11778
24588,9982,5003,61,342,100,40,264,165,4979
71639,5807,2692,63,141,67,21,182,104,3115
12934,967,490,0,36,13,12,21,12,477
73481,1010,447,2,39,9,2,35,38,563
64625,450,227,6,12,6,8,11,24,223
83656,619,301,17,18,9,14,35,19,318
61240,6138,3085,87,197,61,33,164,88,3053
86327,9010,4094,48,190,266,51,99,292,4916
37877,8921,4320,29,340,81,61,257,152,4601
93640,12727,6723,106,662,63,55,553,82,6004
99824,2224,1143,46,55,17,16,61,23,1081
96754,3112,1554,28,96,64,46,111,52,1558
97426,9635,4627,9,450,168,37,265,127,5008
49827,947,477,0,26,16,0,34,12,470
67675,160,98,0,1,15,0,4,1,62
68102,7869,4507,197,482,80,151,135,13,3362
68403,151,70,2,2,2,2,1,3,81
65612,1041,512,0,29,13,0,0,13,529
60123,48952,24727,432,1697,357,377,1554,735,24225
16256,2248,1162,10,17,10,30,41,8,1086
17606,416,126,0,0,0,0,0,0,290
11545,12390,6363,86,292,117,49,317,152,6027
12070,1860,1018,3,41,22,10,79,6,842
12833,4182,2161,11,94,44,18,107,129,2021
13126,36335,18079,589,705,325,609,942,559,18256
70442,365,141,0,53,0,0,0,0,224
70454,29440,14551,111,1058,331,104,1027,604,14889
61937,2132,1105,18,73,15,15,53,43,1027
63820,122,52,0,1,2,0,0,0,70
78624,21945,10780,91,404,366,104,512,415,11165
72579,1470,751,8,45,10,0,49,37,719
86034,1927,1020,17,45,22,4,65,46,907
74423,981,488,6,42,15,0,45,13,493
97386,14119,6822,55,579,129,2,491,194,7297
7757,5667,2903,58,100,118,37,134,81,2764
31709,15659,7337,243,309,103,204,361,217,8322
15757,1553,824,20,70,22,3,48,24,729
15760,162,69,0,0,10,0,0,6,93
16635,12289,5920,155,297,291,30,273,194,6369
16930,1250,629,0,29,13,8,35,31,621
23234,45201,21260,255,1276,420,294,1541,790,23941
94123,25941,12409,19,1330,207,9,1294,188,13532
95110,20203,11257,185,1206,190,140,797,189,8946
86351,6323,3083,0,181,152,4,64,125,3240
97461,810,446,15,40,16,0,0,0,364
98643,385,151,24,0,11,0,13,5,234
66852,592,281,2,8,12,2,11,10,311
67432,5625,2806,0,176,49,0,159,127,2819
67560,1715,869,0,37,13,0,35,10,846
64622,481,255,0,2,8,0,7,0,226
83864,18035,8759,77,378,266,91,497,241,9276
85633,45,28,0,0,0,0,0,0,17
61774,1120,653,11,47,6,0,44,29,467
49436,1509,777,8,24,45,0,51,23,732
50242,562,276,0,23,5,8,5,5,286
50468,1366,680,2,41,29,0,40,18,686
50660,1372,724,0,79,16,6,41,4,648
47942,666,342,9,20,6,0,15,11,324
48083,22981,11558,88,740,324,156,751,226,11423
49042,4733,2419,34,141,102,15,113,63,2314
49055,6329,3226,10,154,107,22,140,151,3103
42280,412,220,13,0,0,0,9,0,192
78202,11433,5521,43,361,119,102,445,180,5912
21051,330,154,0,10,25,0,21,0,176
62876,159,74,0,3,2,0,6,1,85
14836,834,420,8,8,9,2,32,28,414
65682,1978,1066,24,86,16,0,62,35,912
87053,1331,657,15,46,5,7,30,12,674
74547,3437,1726,8,75,14,50,101,26,1711
75167,11662,5876,123,530,139,73,343,165,5786
73566,1862,950,0,57,18,0,21,7,912
25864,314,193,0,10,0,0,0,9,121
27302,31331,14847,66,887,336,78,1195,453,16484
28433,5375,2545,0,164,8,0,115,13,2830
53114,2983,1534,7,130,37,5,96,24,1449
54641,4,2,0,0,0,0,0,0,2
55031,2099,1079,13,71,16,2,74,34,1020
55316,24478,11836,77,600,277,74,753,354,12642
8045,2806,1236,13,6,19,10,27,49,1570
8090,8020,4115,27,128,64,41,214,81,3905
10456,94218,43844,667,2576,632,1020,3387,1149,50374
24540,30646,14115,217,777,448,76,904,523,16531
24844,1193,594,0,9,22,0,7,50,599
19425,15630,7727,49,422,111,32,697,218,7903
75790,4154,1998,7,180,52,0,183,123,2156
88115,94,41,0,2,0,5,0,0,53
79720,35357,20064,301,1720,317,170,1075,207,15293
70658,791,408,10,11,1,16,41,0,383
5086,699,344,0,12,3,4,23,12,355
8003,29849,14987,177,770,226,204,790,451,14862
778,46675,22126,123,1501,420,213,2442,589,24549
51448,477,250,2,10,10,0,6,7,227
52551,481,233,0,10,9,0,36,0,248
37064,56641,26891,195,1956,740,168,1826,793,29750
13679,1989,943,3,87,16,14,79,21,1046
14224,40590,19514,171,999,472,168,879,637,21076
22610,1756,933,16,49,33,0,47,15,823
44840,2594,1279,17,94,13,7,92,78,1315
98024,6658,3387,56,138,60,0,139,96,3271
99577,28308,14500,283,1328,298,125,1000,408,13808
54911,26928,13297,377,979,250,446,819,428,13631
56431,8834,4439,59,219,154,9,202,218,4395
57465,319,166,0,12,7,0,5,0,153
58243,619,346,3,21,11,0,27,9,273
61048,3876,1966,19,124,59,21,118,93,1910
61256,1962,1006,8,28,21,6,56,26,956
62086,1263,606,4,33,11,0,40,10,657
62284,549,268,2,6,9,2,6,2,281
48367,4683,2447,19,140,27,58,85,60,2236
43948,586,261,0,14,3,5,6,8,325
45669,10040,4752,79,367,128,12,313,177,5288
46545,24871,12006,88,752,325,192,682,631,12865
49411,1482,768,6,45,11,3,35,31,714
50078,171,79,0,6,1,0,0,1,92
87522,2637,1354,56,33,0,0,8,25,1283
98947,3298,1543,41,40,4,3,53,51,1755
99343,3352,1770,50,96,0,5,100,17,1582
91390,19053,9953,181,474,161,76,608,252,9100
96091,578,307,0,4,11,12,8,18,271
7465,6824,3344,78,146,94,29,205,114,3480
920,16809,7725,131,351,199,184,502,275,9084
2718,6383,3101,65,154,68,50,189,35,3282
47917,568,293,0,18,7,5,5,3,275
24565,964,452,4,3,14,13,24,15,512
25154,582,262,0,8,0,0,78,11,320
39574,13318,6924,68,592,180,89,381,64,6394
22815,9300,4498,40,306,79,3,248,135,4802
29054,9260,4732,20,228,100,50,329,150,4528
29145,1075,484,0,29,23,0,44,10,591
29671,17642,8714,188,373,179,88,397,209,8928
34293,37969,18199,192,680,609,127,677,744,19770
35618,1851,962,26,32,32,4,56,41,889
37146,7551,3590,0,313,116,79,234,109,3961
37403,7199,2998,306,74,17,453,120,76,4201
38260,3656,1777,40,109,28,14,125,49,1879
21037,21524,10902,299,669,266,194,618,354,10622
22460,1495,715,13,113,11,16,64,19,780
24136,3159,1721,0,103,59,3,61,70,1438
25180,100,36,0,0,0,0,21,7,64
26105,11601,5447,60,341,80,33,308,170,6154
41166,1211,629,34,16,8,0,17,33,582
33435,36423,17900,314,906,282,284,1151,414,18523
27555,672,275,0,5,5,0,12,20,397
27943,511,258,0,0,22,0,0,24,253
51543,466,226,0,5,8,2,14,9,240
53817,158,80,1,6,1,0,2,5,78
56373,3155,1633,7,132,31,15,109,31,1522
44622,17895,8797,97,809,219,128,453,270,9098
45409,15593,8248,874,179,100,721,212,79,7345
49053,7473,3520,63,242,67,4,234,62,3953
54730,4994,2526,15,162,71,11,149,88,2468
55615,190,92,0,7,4,0,7,4,98
75686,13132,6303,13,306,212,183,409,284,6829
97413,955,440,17,15,25,13,7,6,515
98841,9322,4512,29,213,141,4,323,55,4810
33811,21739,10665,112,660,117,210,663,367,11074
13903,18496,9377,218,572,170,46,510,258,9119
6109,26267,11978,124,693,198,82,924,440,14289
35068,8072,3849,36,520,114,98,411,83,4223
98005,18765,9612,82,1085,143,38,645,191,9153
98023,50283,25428,405,1613,534,187,1695,523,24855
95043,732,376,0,15,15,8,23,13,356
93003,52272,25677,334,1781,598,282,1685,846,26595
66002,13245,6303,107,297,150,231,361,164,6942
67122,174,105,0,0,0,0,0,0,69
68414,234,125,0,20,14,0,6,1,109
76579,4732,2289,93,92,34,5,121,89,2443
31512,2131,1010,0,45,7,5,13,61,1121
36804,18582,8909,110,638,124,32,641,174,9673
37101,6772,3334,8,334,102,54,157,160,3438
37221,40425,19136,111,1286,424,286,1300,492,21289
40845,547,257,0,11,17,0,22,10,290
95205,38544,19916,647,1634,178,388,1328,292,18628
95567,2066,978,0,95,31,26,95,27,1088
93271,2432,1292,8,47,72,0,74,70,1140
88349,14,0,0,0,0,0,0,0,14
89833,108,72,0,0,7,0,0,0,36
55946,3403,1758,31,108,25,17,96,57,1645
56574,184,98,2,4,5,0,7,3,86
41804,424,218,0,7,0,8,0,16,206
45680,12977,6489,118,326,71,41,380,159,6488
34285,18069,8478,51,81,302,29,93,233,9591
35640,24570,12065,127,584,319,160,635,232,12505
35980,5154,2670,139,176,66,33,181,57,2484
36436,372,243,0,4,13,0,4,0,129
47906,75899,40568,3504,1391,384,2751,1783,701,35331
48878,1478,693,1,50,15,1,50,21,785
30188,63171,30461,153,2186,1051,291,2456,727,32710
30265,34690,16449,185,960,226,167,1247,416,18241
78872,1647,890,31,77,29,25,5,53,757
79105,0,0,0,0,0,0,0,0,0
80229,54946,27635,804,2128,392,240,2221,595,27311
63738,31,31,0,0,0,0,0,0,0
68134,29070,13634,350,1085,323,181,870,517,15436
18079,811,482,24,71,12,0,69,0,329
4041,1739,845,33,34,23,8,24,26,894
4064,8327,3947,0,174,122,9,118,218,4380
6226,19870,9468,455,454,151,533,514,216,10402
7047,61970,31351,367,2771,564,378,2176,1019,30619
13302,1722,953,2,73,17,0,48,22,769
10583,40013,19214,134,1146,505,222,1214,548,20799
11721,6086,2835,6,103,74,51,124,132,3251
16249,1887,1005,2,56,35,6,32,20,882
16638,32,15,0,0,0,0,2,0,17
16822,2115,989,6,35,28,11,49,44,1126
39422,4793,2184,27,125,19,38,170,110,2609
28075,18621,8912,132,585,164,36,483,228,9709
33432,19578,9704,195,481,561,217,383,433,9874
49616,2274,1080,11,81,39,18,29,23,1194
68142,3968,2098,7,150,59,35,50,89,1870
62898,2285,1107,9,50,13,20,86,46,1178
57522,552,293,0,18,6,0,8,1,259
60913,1409,726,14,41,25,21,47,22,683
61850,418,212,10,6,5,1,19,7,206
48721,463,221,0,6,5,0,11,7,242
61465,1161,629,14,35,14,1,31,21,532
55601,75,45,0,3,5,0,0,1,30
61925,670,334,0,8,12,0,29,0,336
49449,2578,1228,15,31,88,6,82,84,1350
75155,2815,1419,25,75,19,0,98,23,1396
54210,862,424,0,12,15,2,8,12,438
44907,14885,6865,290,201,156,31,402,220,8020
55607,167,99,0,12,5,0,0,4,68
52054,908,475,4,9,14,8,13,12,433
57214,48,29,1,1,0,0,0,0,19
58061,360,186,2,4,3,0,8,3,174
72455,12279,6087,43,336,90,8,360,173,6192
73119,32119,15683,266,938,158,301,998,197,16436
63501,21202,10208,414,436,181,836,419,274,10994
37891,2850,1348,0,12,68,0,57,0,1502
72655,347,173,0,17,5,0,7,0,174
39662,1467,744,0,25,111,0,24,0,723
91739,39803,20166,531,1164,418,190,1298,497,19637
45166,69,55,0,0,0,0,0,0,14
92563,68128,33670,539,2230,252,413,2921,392,34458
30022,68807,33927,536,2782,814,174,2760,1331,34880
49404,8738,4353,57,275,55,54,311,86,4385
49777,1712,854,0,18,65,3,28,77,858
14760,18163,8976,39,456,197,20,466,251,9187
3576,2807,1384,0,66,72,0,77,51,1423
98585,638,197,0,0,0,0,0,46,441
67203,29540,15225,245,841,264,274,936,451,14315
67213,23117,11700,341,884,77,189,654,296,11417
67354,821,404,10,36,1,15,40,18,417
68444,70,35,0,1,0,0,1,0,35
68820,346,199,3,7,8,0,16,7,147
71223,360,219,6,0,2,0,6,3,141
77531,16141,8176,75,540,57,106,475,92,7965
78401,5402,3043,59,246,85,33,217,32,2359
78412,40268,19984,399,1022,385,688,1129,386,20284
78672,1173,588,0,8,10,0,56,7,585
91752,33135,16731,324,1293,197,257,1294,411,16404
91910,74297,36775,527,2214,680,367,2141,954,37522
80210,36296,17930,332,1527,265,511,1399,354,18366
80755,117,64,0,3,5,0,15,0,53
75093,47411,22968,315,1356,701,128,1697,896,24443
65634,641,277,0,11,12,0,20,34,364
72443,3203,1581,22,118,39,10,98,62,1622
45768,1449,761,0,30,0,0,92,15,688
46975,14615,6922,17,239,210,64,570,275,7693
43609,21936,10986,160,694,113,258,858,150,10950
38357,2772,1352,1,86,44,3,90,39,1420
58718,841,438,0,16,18,2,20,1,403
61442,708,326,0,7,26,0,11,10,382
62325,466,242,3,21,1,0,12,0,224
62880,706,382,1,14,4,2,20,5,324
63957,5904,2709,14,113,102,28,131,127,3195
57621,370,206,2,19,0,0,8,4,164
52349,7554,3647,61,178,125,27,200,98,3907
53205,9510,3938,40,188,119,64,414,114,5572
50616,10504,5043,43,260,80,74,209,149,5461
44408,10043,4885,48,175,285,28,324,187,5158
3053,25270,12245,167,709,238,124,798,366,13025
3887,2097,1073,14,71,33,0,48,38,1024
14889,1659,826,13,94,15,10,46,26,833
15728,3399,1759,8,75,42,10,128,70,1640
24319,7194,3476,52,232,76,42,248,68,3718
26181,6280,3122,10,197,59,16,136,154,3158
8317,1579,708,8,17,5,8,67,0,871
22630,32392,15795,152,1039,339,241,770,454,16597
19333,6575,3227,0,146,58,16,176,108,3348
19454,29237,14726,96,786,270,94,752,311,14511
28605,3428,1752,0,96,54,5,128,52,1676
28683,1135,575,0,10,74,8,52,23,560
28741,3748,1876,13,81,41,9,39,87,1872
13209,12940,5978,95,409,102,43,307,260,6962
77904,28135,13717,41,860,412,132,988,363,14418
53069,633,325,0,38,52,0,9,15,308
59841,945,440,5,23,0,16,45,4,505
62351,1879,979,23,21,8,0,31,6,900
69201,3951,1878,1,139,56,7,142,105,2073
57780,46,26,0,0,4,0,0,0,20
73737,3521,1716,11,151,34,22,129,36,1805
74035,4223,2678,40,231,42,0,64,55,1545
75150,62452,29884,497,1777,341,378,2241,760,32568
33305,12425,7763,0,467,136,11,328,195,4662
49544,10239,4602,48,315,116,112,315,123,5637
50436,5845,2905,43,174,71,4,178,135,2940
56568,188,89,2,4,2,5,0,2,99
42337,2396,1123,21,32,33,49,63,13,1273
45164,241,118,0,4,1,7,0,3,123
45640,16079,7934,56,433,203,45,422,263,8145
40387,1968,1106,0,14,50,0,48,21,862
46133,742,401,36,4,9,0,27,29,341
47273,1737,848,1,76,16,0,122,46,889
49057,6545,3280,76,179,32,90,188,63,3265
16866,9959,5662,39,701,85,22,216,112,4297
18210,7468,3692,14,188,120,13,169,145,3776
7202,41235,20101,435,1610,354,452,1792,438,21134
29536,16012,7520,91,579,106,220,468,176,8492
12786,271,138,0,0,0,0,0,0,133
21617,10741,5552,90,278,121,22,314,136,5189
94806,64410,32316,568,2104,486,577,2216,681,32094
94963,498,210,0,51,17,0,0,35,288
90602,25981,12659,238,880,229,275,902,324,13322
91765,47139,23430,329,1394,665,162,1492,687,23709
92241,7904,4086,15,245,136,11,153,77,3818
97493,330,181,1,17,0,0,9,20,149
98121,18140,10832,57,944,172,128,888,86,7308
98856,2724,1267,0,32,46,0,43,45,1457
2648,6638,3187,54,148,147,0,216,170,3451
61070,1503,768,11,10,14,2,24,14,735
61471,60,28,0,1,2,0,0,0,32
79019,1779,875,11,58,35,7,42,28,904
71861,1844,984,0,33,16,0,35,19,860
58504,27101,13732,178,830,209,240,785,319,13369
67123,718,343,0,14,3,3,12,22,375
67529,296,139,0,0,0,0,1,9,157
66014,123,83,9,0,0,0,0,0,40
66409,3417,1798,0,71,15,10,88,56,1619
76060,8198,4020,23,317,129,17,207,100,4178
76570,2723,1406,3,158,78,0,60,67,1317
76640,3157,1550,19,71,0,30,149,124,1607
52660,125,68,0,0,10,0,0,7,57
53913,20528,9988,155,575,298,62,588,382,10540
54736,4133,2117,9,135,45,1,103,72,2016
37066,50328,24973,322,1926,725,201,1713,578,25355
40171,173,56,0,13,0,0,0,10,117
40460,1311,708,0,31,0,26,27,37,603
62454,11088,6200,67,515,78,7,317,141,4888
58601,26769,13762,101,827,243,283,807,242,13007
13476,3736,1856,36,43,17,8,137,26,1880
13746,2000,973,0,29,43,26,60,25,1027
16748,2680,1241,16,31,32,28,40,42,1439
43331,4507,2388,26,56,119,12,59,116,2119
48430,36926,18507,254,1172,610,109,1118,445,18419
10520,13152,6172,48,306,173,85,442,171,6980
51234,1329,718,11,25,6,4,50,11,611
35074,0,0,0,0,0,0,0,0,0
80101,492,271,3,13,3,0,7,6,221
36442,2985,1509,6,32,44,0,32,29,1476
64842,816,436,1,5,2,0,29,4,380
39452,27551,14103,193,960,244,51,956,505,13448
75946,3543,1736,6,145,31,9,148,37,1807
17319,11943,5936,27,333,109,43,544,129,6007
67642,1810,903,3,34,15,3,41,33,907
85937,7793,3817,17,227,47,18,207,98,3976
25265,1541,764,31,29,32,14,29,6,777
79079,2593,1415,38,51,37,7,52,23,1178
25979,820,348,0,38,0,10,33,0,472
10278,0,0,0,0,0,0,0,0,0
98375,30972,15485,110,1012,181,150,1206,297,15487
95960,825,471,0,16,15,28,27,2,354
22433,390,134,0,11,0,64,9,10,256
97144,76,43,0,0,0,0,0,0,33
12809,3493,1586,18,165,70,24,150,87,1907
49274,3499,1817,18,105,47,14,57,51,1682
36518,2468,1443,0,54,22,0,61,23,1025
43356,1388,600,4,16,24,9,56,49,788
18437,164,87,0,2,8,0,0,3,77
18631,1257,607,0,71,21,0,66,19,650
47227,2308,1148,0,51,14,0,49,83,1160
33313,62405,29213,438,1689,388,342,2189,830,33192
58460,209,122,0,9,6,0,4,5,87
59474,3634,2077,16,226,56,27,109,55,1557
59919,575,273,0,20,0,0,21,0,302
60514,10109,4929,55,375,57,15,355,153,5180
61415,1889,945,12,50,25,2,103,17,944
68332,122,66,0,2,5,0,1,2,56
70340,19,0,0,0,0,0,19,0,19
70812,11503,5268,24,295,160,191,456,101,6235
71958,2459,1164,6,48,34,47,41,43,1295
76670,1598,855,3,33,16,7,27,4,743
79098,516,294,3,13,1,1,12,8,222
64105,4679,2611,20,185,41,4,196,19,2068
82301,9176,5099,97,436,88,4,241,181,4077
90006,61698,30450,371,2448,442,301,2299,639,31248
93277,53015,25571,280,1939,462,491,1534,496,27444
94951,4571,2157,0,110,67,0,88,80,2414
98047,7023,3233,68,122,66,48,193,105,3790
97141,13816,6914,69,467,256,31,423,196,6902
6783,2093,1100,7,29,65,0,27,71,993
1244,74,43,0,0,0,0,0,0,31
56022,42,28,0,4,5,0,0,0,14
40830,125,52,0,0,0,0,0,0,73
42629,5410,2862,89,232,68,41,76,95,2548
36569,648,277,0,0,0,0,14,13,371
38258,1394,776,14,11,4,6,32,8,618
38589,297,176,0,8,0,0,0,8,121
47102,6970,3573,85,151,118,42,310,164,3397
47335,647,319,0,8,0,8,9,13,328
54129,2969,1549,7,76,32,15,85,51,1420
54857,46,28,0,0,0,0,0,0,18
58278,1903,956,13,69,31,14,84,30,947
58650,376,196,0,0,5,0,13,4,180
73655,827,409,2,24,29,0,38,21,418
50044,913,419,8,17,9,5,21,5,494
50603,581,285,0,12,1,4,25,1,296
71720,2320,960,0,11,13,5,118,120,1360
30149,1935,561,47,0,10,275,0,11,1374
33540,8737,4060,36,290,97,39,174,81,4677
38701,22311,10296,109,574,242,247,834,278,12015
39056,26106,11949,141,725,269,183,702,408,14157
44306,21165,10034,122,527,280,320,598,473,11131
44320,19419,8733,27,330,144,45,703,380,10686
45898,873,398,8,9,3,1,15,28,475
34465,17603,7871,0,372,195,17,271,218,9732
28436,1975,1004,26,66,34,0,29,35,971
2878,15816,7941,52,311,202,86,385,283,7875
55923,4533,2274,29,165,52,30,154,68,2259
4428,2963,1489,21,78,30,6,71,15,1474
52175,3522,1763,13,99,44,22,121,30,1759
7642,10395,5009,89,237,89,30,262,117,5386
52501,29650,14668,184,958,287,163,935,464,14982
15225,1035,470,13,47,7,0,37,15,565
15779,765,529,13,16,31,0,16,0,236
70462,4907,2246,78,134,41,8,211,82,2661
12815,1072,514,0,28,3,18,29,24,558
60527,27903,13561,107,685,446,147,825,607,14342
61539,206,114,1,17,3,1,1,1,92
62046,769,402,0,21,0,7,23,11,367
62088,6569,3399,10,192,93,0,199,150,3170
84629,2638,1140,37,31,33,86,52,48,1498
86515,4672,2222,22,117,18,20,119,69,2450
81506,11799,5458,58,350,123,135,188,327,6341
82321,585,288,0,21,7,0,20,8,297
77468,42,22,0,0,0,0,0,0,20
78520,62414,29855,765,1770,471,473,2225,609,32559
98116,26448,12687,0,1164,273,17,1083,337,13761
93615,6513,3578,165,426,40,24,201,60,2935
96777,2061,934,27,46,51,0,38,0,1127
65453,8643,4212,74,299,48,10,252,115,4431
67464,1050,492,0,31,33,4,30,37,558
8102,7790,3845,173,203,47,186,264,145,3945
37931,28444,14008,67,1093,328,90,1292,305,14436
38865,5060,2664,72,176,66,51,109,44,2396
14549,71,43,0,0,0,0,0,0,28
62707,6924,3344,3,125,69,38,227,147,3580
62881,10842,5346,45,280,124,47,340,149,5496
63878,109,61,0,0,0,0,5,4,48
50435,615,332,0,8,5,6,4,10,283
19944,647,277,0,2,8,0,11,13,370
20748,38011,17687,199,1352,337,190,1108,701,20324
22124,18216,8864,61,537,199,47,573,285,9352
23124,4339,2089,0,114,104,15,20,68,2250
7607,9654,4408,81,293,116,35,205,141,5246
16939,302,139,0,6,0,5,19,2,163
17090,5662,2880,0,155,105,48,232,116,2782
11758,53424,25846,291,1629,439,230,1288,794,27578
11798,15033,7140,42,377,87,84,566,135,7893
12194,121,55,0,5,0,0,0,0,66
12922,39,22,0,3,0,0,0,0,17
13825,3193,1545,16,45,73,46,16,95,1648
1039,1042,475,0,11,26,0,35,34,567
2189,15603,7060,139,253,109,97,488,226,8543
92401,1929,883,6,106,7,0,64,29,1046
94561,41911,20882,170,1608,212,392,1664,482,21029
96111,94,75,0,7,0,0,0,0,19
76272,4130,2062,47,114,79,0,185,151,2068
78732,17849,8648,137,436,115,0,480,183,9201
80013,72887,35464,489,2735,588,493,2518,975,37423
52220,255,123,0,0,0,10,11,24,132
52346,1390,737,3,66,2,19,71,11,653
53215,60938,30654,815,2534,454,548,2622,539,30284
53594,5050,2717,30,148,75,3,205,82,2333
56062,3547,1699,9,99,49,5,107,29,1848
67857,146,86,0,0,0,0,14,0,60
68354,952,440,12,28,17,3,18,19,512
68810,962,484,3,86,11,1,33,8,478
61081,21129,10250,99,460,193,71,543,269,10879
14075,42471,19884,362,1377,584,233,1180,838,22587
6438,2860,1456,14,92,18,0,72,65,1404
6510,2586,1260,50,100,14,37,120,8,1326
6787,7815,3960,98,267,111,0,207,152,3855
3444,1479,724,30,7,18,4,18,28,755
3446,5940,2999,0,92,42,35,224,125,2941
16345,3459,1749,18,74,89,24,102,81,1710
8540,48968,23975,356,1145,330,476,1496,533,24993
8628,9315,4694,39,304,73,15,224,269,4621
1096,2695,1376,15,42,39,7,45,44,1319
29168,3973,1930,13,63,14,57,184,56,2043
29718,4308,2138,14,103,64,0,143,57,2170
30108,7351,3813,47,201,122,80,180,88,3538
28420,3845,2089,0,108,78,37,64,32,1756
8558,7598,3744,43,250,109,49,255,90,3854
45880,2690,1357,9,73,47,17,69,22,1333
47928,2129,1078,3,30,18,19,81,37,1051
48182,21735,10593,198,551,128,192,450,319,11142
49229,3373,1610,41,115,55,23,84,27,1763
42223,20501,13152,1356,686,0,180,425,7,7349
42347,6244,3122,86,145,60,61,163,53,3122
43465,5273,2369,21,127,130,54,81,68,2904
53931,253,160,6,5,2,0,1,0,93
54977,1560,855,2,37,15,7,45,15,705
39096,1887,811,16,34,51,65,72,0,1076
55760,3047,1545,2,71,66,40,41,36,1502
44653,673,276,0,4,8,40,28,16,397
39360,3217,1434,0,78,73,32,137,165,1783
47468,1539,752,15,33,40,0,16,41,787
48895,11418,5611,77,350,144,52,452,258,5807
49127,10968,5277,86,387,146,35,226,183,5691
46510,3997,2020,19,111,24,11,74,58,1977
56338,1627,819,5,41,30,15,27,27,808
41746,416,208,0,12,0,0,0,13,208
40058,83,44,0,0,0,0,0,0,39
40868,928,446,0,0,0,0,6,14,482
7440,4169,2051,0,103,60,0,41,90,2118
99607,222,111,0,6,2,0,10,0,111
99517,16405,8054,114,578,229,88,703,159,8351
82221,459,236,11,14,4,2,5,8,223
82720,834,464,0,63,8,0,0,20,370
75783,7917,3981,24,180,124,42,230,134,3936
76120,18820,8545,79,692,228,106,903,314,10275
95715,91,47,0,0,3,0,0,0,44
80456,715,335,0,0,19,0,0,22,380
87116,3940,2150,97,190,14,61,153,0,1790
89007,1122,555,11,18,0,0,64,0,567
70460,23465,11317,75,854,404,55,985,281,12148
71405,6253,3128,93,245,102,43,225,23,3125
11230,89075,42716,463,2727,788,690,2384,1036,46359
11932,1138,559,0,33,37,0,21,46,579
2872,278,112,0,0,0,13,0,15,166
4774,548,272,0,11,18,0,13,7,276
44427,1406,672,0,15,45,9,26,31,734
53540,205,94,2,1,8,0,0,0,111
11106,38363,18799,99,2370,237,97,1875,378,19564
38361,977,416,0,12,0,0,70,0,561
10960,15684,7504,127,491,100,108,514,271,8180
29683,205,116,0,0,0,0,0,0,89
12423,1089,564,0,0,28,19,20,5,525
25177,23228,10953,83,479,327,56,497,432,12275
17840,463,231,16,0,11,0,11,12,232
4852,38,20,0,0,0,0,0,0,18
4926,96,45,0,0,0,0,12,0,51
76433,1517,730,0,25,39,0,39,29,787
65752,352,194,0,0,0,0,1,29,158
72069,1148,536,18,8,34,0,55,19,612
59024,387,222,0,5,6,4,5,0,165
68635,452,235,0,9,4,0,2,6,217
59842,17,4,0,0,0,0,0,0,13
74646,228,111,0,12,2,0,9,0,117
70656,3936,1997,66,210,66,81,52,58,1939
43406,1920,876,5,46,40,3,52,33,1044
74604,12597,6118,40,333,222,48,349,144,6479
63543,365,174,0,19,5,2,0,7,191
62671,487,216,0,7,3,5,22,5,271
65084,6592,3190,26,132,103,10,149,70,3402
68124,16015,7476,80,416,178,119,510,193,8539
83116,672,308,0,19,4,7,35,5,364
84739,543,302,0,8,14,0,3,4,241
46033,38569,18721,91,1100,527,91,1358,586,19848
86321,2217,1287,0,173,41,0,88,20,930
51449,2160,1047,13,49,29,20,42,44,1113
79084,2274,1232,18,75,26,17,84,30,1042
85296,43643,21853,153,1524,209,205,1892,434,21790
97056,11434,5982,107,384,82,123,449,111,5452
99021,9627,4884,51,188,182,44,334,84,4743
93536,72383,38678,368,2730,529,243,2182,874,33705
78839,9223,4696,56,266,134,127,118,77,4527
91710,90582,53315,1035,4571,1022,469,3121,842,37267
14880,1561,754,4,40,7,3,71,25,807
23223,51334,24039,411,1275,516,256,1724,442,27295
76209,24838,11851,283,510,215,455,563,214,12987
45174,2350,1216,7,66,8,0,106,30,1134
36562,1463,707,20,93,0,0,90,30,756
17509,5068,2531,33,72,36,29,108,42,2537
38041,4816,3291,12,412,23,11,145,62,1525
61112,66,7,0,0,0,0,0,0,59
61533,2509,1274,2,113,26,0,136,21,1235
21035,8423,4312,85,209,106,40,249,84,4111
80516,26323,13107,75,1198,164,107,1451,344,13216
21154,5911,2986,57,87,103,37,150,77,2925
1609,21142,10862,589,758,176,414,335,303,10280
24348,4409,2426,12,234,96,0,146,44,1983
65046,1363,691,5,33,36,0,48,10,672
69153,5524,2699,9,194,87,14,116,80,2825
58849,790,437,2,21,23,0,20,18,353
15676,713,331,0,19,28,0,0,0,382
31206,26526,12114,168,901,229,334,1085,477,14412
32579,10187,4668,29,285,116,105,198,161,5519
7842,93,46,0,9,0,0,14,0,47
43964,8642,4312,36,228,136,69,287,163,4330
11976,1996,913,0,31,14,0,19,45,1083
49261,215,109,0,0,20,0,0,0,106
14877,465,261,0,12,12,0,5,3,204
15367,9376,4621,37,257,131,35,334,99,4755
4761,524,223,2,3,4,0,11,16,301
16724,107,56,0,0,6,2,0,0,51
43109,82,35,0,1,3,0,3,0,47
44432,13279,7850,52,620,157,84,284,82,5429
20763,2113,922,29,22,0,0,65,49,1191
40351,21302,10143,429,444,258,395,465,323,11159
44820,17522,8625,51,539,195,68,484,187,8897
4430,1767,858,0,45,26,3,39,41,909
30625,2140,1069,24,31,59,21,60,30,1071
7206,27660,13749,295,1146,183,258,1197,118,13911
32548,21315,10661,93,598,370,163,586,259,10654
11520,43408,20283,243,1371,391,251,1626,685,23125
31630,560,265,0,10,4,0,8,13,295
18460,133,64,0,0,11,0,0,0,69
76870,230,97,0,0,0,0,9,0,133
75457,6464,3135,31,177,73,65,163,37,3329
3241,752,388,7,15,13,3,7,15,364
4276,5705,2913,0,122,135,29,94,107,2792
4481,497,252,4,9,16,0,17,11,245
20850,51568,23986,100,1753,494,121,2018,802,27582
78943,283,113,0,0,0,0,39,15,170
77346,65967,32067,223,2605,438,259,2662,599,33900
91784,25567,12464,150,531,398,88,743,428,13103
81230,9718,5192,188,308,74,348,293,183,4526
64062,5913,3187,61,160,72,88,82,86,2726
65652,4158,2423,26,184,85,32,80,78,1735
57325,3112,1553,3,128,38,29,95,61,1559
88353,152,43,0,0,5,0,0,2,109
68863,1234,670,18,38,4,0,55,21,564
60109,568,255,7,12,3,25,13,9,313
92673,30927,15466,162,1152,375,60,1090,627,15461
78636,3722,1973,14,90,18,26,80,79,1749
78632,955,560,0,14,20,0,33,43,395
78870,847,428,12,23,3,0,5,11,419
80027,33830,16580,114,985,355,191,1028,568,17250
65685,706,326,16,7,24,6,23,0,380
24945,304,182,26,0,0,0,0,0,122
63023,5817,2755,46,231,145,9,148,76,3062
80461,7426,4089,44,364,75,34,314,46,3337
28679,1740,862,14,29,0,0,32,54,878
57568,665,394,13,7,13,0,0,10,271
83837,3170,1557,6,135,39,0,55,57,1613
61814,1074,531,14,28,18,3,28,15,543
93449,8116,3827,1,186,63,94,230,263,4289
97843,621,299,0,16,13,0,27,16,322
68766,466,226,0,18,26,0,2,6,240
60541,3660,1878,0,150,69,54,147,57,1782
60945,175,87,0,7,0,0,5,0,88
54876,1450,704,5,23,37,7,21,21,746
61473,1509,740,7,48,27,0,73,12,769
74363,2879,1426,14,95,29,11,87,36,1453
74457,463,237,0,0,1,4,15,9,226
49736,454,251,5,19,9,6,20,3,203
75470,434,290,0,68,0,0,0,7,144
44483,24836,11326,127,491,210,116,680,433,13510
54241,14165,7038,40,407,225,52,433,200,7127
56343,957,472,0,25,17,2,18,17,485
56547,2738,1465,50,98,26,6,126,21,1273
55069,5279,3197,53,249,41,12,77,65,2082
58225,924,467,0,24,6,0,11,10,457
55412,23200,11475,246,993,174,37,926,159,11725
56063,2800,1428,3,53,35,9,75,44,1372
37870,4823,2386,66,120,95,0,173,83,2437
75656,4204,2037,8,104,133,70,102,26,2167
39054,261,125,0,12,5,0,13,0,136
65681,1614,802,20,5,37,0,13,0,812
44070,31847,15723,183,1010,513,154,826,491,16124
36037,13306,6128,88,287,112,68,452,269,7178
28454,2503,1247,62,63,9,0,69,11,1256
1093,283,142,10,7,6,0,3,4,141
12110,22041,10784,456,617,323,213,631,412,11257
27830,4841,2424,61,55,9,5,101,95,2417
32535,5694,3557,72,270,99,10,79,72,2137
80231,37241,17961,259,1395,354,199,1492,445,19280
35603,31468,14954,445,908,302,266,1215,463,16514
14905,8593,4008,67,292,202,38,315,148,4585
4010,1410,669,0,30,30,0,52,64,741
7480,16400,7901,61,359,179,76,416,257,8499
21057,4284,2239,21,101,99,33,108,114,2045
29941,587,241,37,0,0,0,0,18,346
30117,35575,16788,775,1008,293,669,1160,313,18787
76259,6042,3014,48,348,12,12,131,76,3028
81432,2998,1458,0,47,102,0,25,86,1540
80929,140,55,0,0,0,0,0,0,85
97850,17180,8329,101,578,221,220,335,270,8851
99634,392,185,2,4,5,8,7,0,207
92342,6508,3256,61,94,83,0,304,144,3252
97008,29772,14679,174,1120,250,225,1233,496,15093
97862,11296,5314,64,474,80,104,284,183,5982
11784,24992,12442,227,900,164,320,759,410,12550
28693,1819,939,38,37,43,0,43,20,880
29036,21766,10937,107,484,370,59,762,326,10829
29742,2599,1310,26,42,32,11,16,88,1289
55359,6349,3199,24,209,44,8,150,68,3150
29927,9675,5019,40,319,89,59,392,180,4656
57547,133,73,2,0,0,0,0,10,60
41862,867,450,0,24,14,16,56,0,417
43103,11006,5704,71,425,138,39,420,112,5302
64624,1493,670,6,23,22,9,39,10,823
1867,25048,12425,159,822,244,81,984,296,12623
67335,3302,1694,15,127,31,0,73,25,1608
59762,257,142,26,0,6,0,0,0,115
57434,441,156,0,6,0,0,0,17,285
58438,719,381,10,9,0,0,24,9,338
99630,226,119,0,4,1,0,2,2,107
67953,118,52,0,2,0,0,3,6,66
70757,3147,1497,60,46,12,25,40,63,1650
69157,54,26,0,1,0,0,0,0,28
95417,389,241,24,0,8,0,0,0,148
72042,5117,2515,29,186,51,26,159,105,2602
97524,14790,7547,20,448,382,89,582,182,7243
77964,8304,3950,43,228,130,2,328,174,4354
91321,34355,17050,352,1044,249,291,1112,391,17305
92275,2456,1162,0,120,29,69,51,13,1294
40312,4785,2274,21,126,14,31,81,61,2511
94924,1134,503,0,33,52,11,36,5,631
43930,795,408,0,59,7,0,13,18,387
82729,2671,1320,11,100,65,11,29,33,1351
74447,16391,8018,79,425,143,155,432,268,8373
36370,878,414,0,28,9,0,22,11,464
36830,39078,19060,483,1390,278,1121,1447,413,20018
65770,3371,1770,4,80,27,9,63,47,1601
71960,1545,810,17,34,56,0,19,16,735
72935,474,207,0,11,0,0,13,10,267
51034,1760,848,0,15,27,7,21,11,912
44846,3486,1756,68,71,36,28,61,64,1730
47837,1180,628,2,169,3,5,42,34,552
49960,179,85,0,5,7,3,4,13,94
36855,1543,614,16,9,2,0,48,39,929
56334,5556,2726,24,127,59,0,171,62,2830
37096,5608,2825,44,147,70,29,214,48,2783
56587,1246,649,6,21,28,0,17,23,597
60548,12374,6103,161,476,129,187,231,161,6271
58251,2031,947,15,52,18,11,53,16,1084
57052,366,244,32,4,4,0,0,0,122
52201,1503,838,0,40,11,1,12,17,665
49227,1131,588,12,26,24,6,30,46,543
3846,966,433,0,20,13,8,39,17,533
42123,786,475,0,62,0,12,15,0,311
54443,2155,1109,10,43,37,2,52,24,1046
7090,30068,14357,52,732,233,118,881,310,15711
28785,7811,3915,58,158,177,12,132,203,3896
7458,11497,5730,32,127,165,86,174,182,5767
30736,43149,21380,233,1459,285,232,1795,580,21769
7832,3633,1764,19,80,31,26,30,71,1869
31699,684,608,115,0,0,3,10,0,76
16682,23,17,0,0,0,0,0,0,6
32114,32923,15793,257,863,450,466,698,577,17130
12962,5831,2733,0,141,60,43,119,121,3098
12824,970,524,0,0,48,0,4,17,446
13102,32,20,0,0,0,0,0,0,12
78144,43,31,0,0,19,0,0,12,12
3249,7157,3223,0,160,98,0,155,143,3934
53916,22574,11353,230,638,266,60,639,293,11221
52254,802,391,16,15,12,4,17,22,411
72016,3076,1656,49,67,11,48,3,26,1420
53536,8722,4322,3,256,124,12,345,94,4400
56628,1674,819,6,31,96,12,22,15,855
56019,828,408,4,39,8,0,34,4,420
62553,515,262,2,30,9,5,2,8,253
60941,2180,1109,0,60,29,4,82,27,1071
72616,11237,5730,27,303,87,36,275,54,5507
62245,1692,912,1,52,31,9,48,41,780
64496,38,20,0,4,2,4,1,0,18
78330,899,406,6,17,12,15,28,17,493
49874,912,436,16,14,13,0,9,21,476
50142,933,459,10,18,4,0,33,11,474
56573,6210,3117,19,116,70,81,85,116,3093
50574,2049,976,9,14,35,9,30,33,1073
73079,495,251,5,19,4,0,26,7,244
54494,26555,12905,103,709,394,78,658,267,13650
72006,2609,1206,33,100,48,37,45,47,1403
97230,40131,19721,241,1375,450,267,1431,442,20410
80731,1296,639,2,38,6,0,24,20,657
40468,1747,789,7,38,27,3,23,61,958
30178,2971,1495,20,62,5,0,24,23,1476
33827,2930,1436,32,115,36,8,129,33,1494
29045,25814,12834,227,887,169,112,713,389,12980
29485,57000,28133,558,2105,509,258,1874,813,28867
37643,33578,16100,214,1069,553,125,969,536,17478
30564,3414,1736,13,74,8,0,96,0,1678
17356,21630,10471,104,694,227,193,567,146,11159
11568,4704,2238,157,46,53,121,60,54,2466
47997,118,54,0,0,0,1,14,0,64
92145,2389,1188,15,68,0,0,35,0,1201
48767,2014,1057,4,57,35,4,52,31,957
93291,57968,28669,346,2104,170,303,1815,608,29299
45430,7289,3483,39,178,159,13,198,197,3806
98045,14795,7541,19,583,117,80,523,278,7254
98065,15548,7677,23,744,158,86,630,130,7871
98296,30373,15566,241,1209,320,167,1252,451,14807
36571,15407,6885,62,513,78,57,766,250,8522
37410,3764,1734,11,68,16,0,95,25,2030
3235,8698,4128,9,214,124,22,224,225,4570
50464,574,291,0,26,1,0,12,3,283
4862,4146,2029,41,80,67,18,126,65,2117
50582,264,137,0,0,6,0,0,1,127
7405,17620,8967,113,369,185,92,430,174,8653
52064,943,489,0,19,3,17,29,3,454
52405,25474,12215,53,981,351,173,739,249,13259
53089,19151,9502,89,772,206,57,689,288,9649
88253,771,339,4,49,5,3,31,20,432
90035,28085,13035,69,1234,246,146,1174,336,15050
41073,5792,2771,25,183,39,34,147,84,3021
91906,4351,2399,21,116,29,0,143,1,1952
38848,597,280,0,4,0,0,44,9,317
21009,29997,14361,95,1242,239,128,1069,474,15636
50207,2093,996,26,51,56,6,68,35,1097
32060,23768,11755,124,863,208,126,611,267,12013
37617,13870,7209,108,387,249,113,398,240,6661
97063,893,467,0,5,28,0,11,22,426
46222,36414,18218,506,1153,209,330,1004,295,18196
38351,17864,8402,241,560,271,7,524,229,9462
27525,14323,6949,11,477,202,55,644,135,7374
24250,1426,696,0,0,35,8,9,66,730
71073,2599,1265,51,71,13,6,40,56,1334
12461,1718,839,0,35,41,0,135,59,879
13408,3775,1810,122,61,55,122,51,37,1965
13470,649,345,0,16,13,2,5,22,304
6088,4479,2165,26,154,42,0,189,104,2314
7421,7357,3656,40,179,55,22,147,164,3701
15632,9698,4714,60,360,151,72,296,165,4984
61769,621,305,13,11,9,1,11,6,316
48097,5302,2670,30,168,50,40,113,69,2632
64494,849,450,0,30,15,0,14,8,399
48649,1381,723,0,37,26,0,41,47,658
67505,2494,1128,38,31,19,36,27,36,1366
29540,5383,2692,18,124,82,0,239,95,2691
21635,1912,939,21,31,81,0,19,24,973
21774,12734,6572,61,419,139,18,408,184,6162
12821,2766,2603,160,300,14,0,23,7,163
23664,9775,4983,34,380,143,113,300,179,4792
13353,10,6,0,0,0,0,0,0,4
12032,853,444,0,5,19,17,17,17,409
12485,1502,740,82,17,20,4,5,0,762
50066,225,105,0,0,0,0,16,0,120
13083,2069,1061,6,51,26,0,54,6,1008
48449,2928,1484,14,95,53,6,80,49,1444
24211,9344,4505,19,219,191,64,249,273,4839
20609,1135,534,0,25,0,0,29,16,601
35221,4803,2254,75,183,27,0,166,69,2549
24131,46,43,0,0,0,0,0,0,3
37356,2617,1229,56,80,14,21,58,25,1388
4408,139,81,0,2,0,0,0,2,58
6277,4068,1964,0,133,80,16,137,105,2104
15237,42227,20372,180,1112,546,154,1385,656,21855
27539,23436,11672,162,1006,167,97,1041,216,11764
17032,8100,4190,49,177,141,18,190,140,3910
10452,76078,34800,712,2232,278,561,2818,878,41278
2576,4467,2140,46,46,81,33,203,37,2327
17767,178,95,0,0,0,0,12,0,83
18353,12460,5813,24,272,203,49,121,330,6647
32773,30955,15392,136,1373,150,214,1049,381,15563
35763,18201,9088,138,519,146,32,511,141,9113
25202,1184,530,5,41,9,0,90,22,654
77083,79996,38455,730,2177,786,687,2352,1248,41541
53094,19111,9731,121,587,252,150,564,237,9380
55936,1770,816,2,52,12,8,90,25,954
65657,148,63,3,0,0,5,0,0,85
69036,80,47,0,6,3,0,6,0,33
61044,277,131,0,6,0,5,12,6,146
4260,5723,3084,17,192,22,63,238,67,2639
62677,2269,1121,3,86,37,6,68,59,1148
48126,48099,24045,513,1317,395,376,1468,289,24054
5356,864,390,0,28,10,0,0,27,474
6379,8856,4275,22,267,75,34,213,140,4581
48353,6636,3265,57,97,78,49,165,29,3371
48505,20696,9783,374,588,203,109,534,222,10913
16637,2453,1251,21,46,6,0,95,55,1202
48734,7516,3575,37,117,105,88,169,110,3941
50591,411,207,0,15,2,0,17,16,204
81043,58,32,0,2,0,0,6,2,26
11767,15783,7492,11,301,189,76,405,233,8291
81131,1125,537,2,35,77,0,15,0,588
13424,2468,1384,18,84,51,46,48,51,1084
87364,973,529,7,21,6,7,16,4,444
27965,693,401,47,19,8,29,29,0,292
89826,0,0,0,0,0,0,0,0,0
48861,1398,690,10,42,13,11,38,9,708
97229,67339,32584,282,2260,495,157,2699,791,34755
38355,6620,3243,20,341,35,63,266,189,3377
64636,268,143,0,14,3,0,8,3,125
68303,286,146,0,17,4,1,19,2,140
68365,283,107,3,3,1,47,19,1,176
47586,10878,5408,22,242,136,48,333,159,5470
56140,46,24,0,0,2,0,4,1,22
74644,528,288,0,11,4,1,8,2,240
75941,8826,4838,57,308,101,43,210,145,3988
43330,119,64,0,7,0,0,11,1,55
80045,889,350,0,21,0,0,40,0,539
59736,103,54,2,1,2,0,0,2,49
1069,8698,4176,29,159,158,121,130,214,4522
58845,335,202,1,6,2,0,8,4,133
78351,366,144,0,19,6,5,16,6,222
79788,556,296,0,25,3,0,10,0,260
96717,5148,2596,7,186,73,37,178,68,2552
63020,19991,10007,108,627,312,119,704,328,9984
78061,13034,7480,279,332,76,67,475,88,5554
93927,18778,9605,104,522,144,156,636,172,9173
88028,272,130,0,0,15,0,10,0,142
7950,19148,9202,99,545,223,65,528,193,9946
3811,6897,3437,0,187,93,0,149,75,3460
14813,2325,1222,8,51,23,14,83,31,1103
15212,26645,13164,124,773,314,194,734,535,13481
12811,28,16,0,0,4,0,6,0,12
16322,100,52,0,0,0,0,2,2,48
30667,954,432,0,30,18,0,21,8,522
31539,14645,7266,0,343,113,32,427,311,7379
14714,582,318,10,27,13,0,18,6,264
83632,401,198,0,11,10,0,8,8,203
78071,4437,2886,62,281,88,5,118,59,1551
18214,1919,975,5,50,28,3,63,37,944
19143,65247,29771,479,2019,547,758,2138,789,35476
19144,42556,19224,494,1313,449,283,1056,628,23332
18964,14015,6950,169,253,165,42,318,230,7065
29424,390,222,25,0,0,6,0,0,168
8323,613,265,3,15,18,7,25,24,348
12586,12129,5842,135,452,97,84,495,182,6287
10471,21896,10378,157,507,267,231,676,359,11518
12086,1505,738,0,21,38,34,41,18,767
23511,13883,11092,1514,700,0,412,7,0,2791
14860,1182,569,0,44,17,0,64,20,613
12983,7371,3811,18,230,84,10,127,158,3560
36550,489,288,0,0,10,0,0,0,201
17565,2758,1526,13,26,0,15,63,83,1232
38471,357,162,0,0,11,0,0,0,195
75414,2879,1346,31,75,11,8,113,59,1533
47553,8260,4352,78,254,46,34,252,46,3908
66531,1823,835,0,76,44,4,37,17,988
32744,3764,1842,11,141,85,17,105,76,1922
75223,15128,7908,85,671,150,113,440,18,7220
43723,5185,2747,13,146,74,33,100,66,2438
62926,2402,1213,7,67,28,9,88,44,1189
84056,3336,1859,147,138,0,36,138,0,1477
76470,3479,1823,31,91,22,23,74,142,1656
77630,29026,14262,255,957,327,227,904,319,14764
94556,16368,7846,109,330,193,124,406,189,8522
88220,36708,18602,233,1236,345,240,1060,366,18106
78218,36359,17987,293,1415,258,233,1290,450,18372
78232,37732,18901,263,1074,503,110,1226,501,18831
78357,2867,1288,27,91,18,35,75,21,1579
79707,39020,20028,451,1281,334,177,1584,504,18992
56523,534,262,0,34,10,0,18,9,272
57776,0,0,0,0,0,0,0,0,0
69335,40,22,0,0,4,0,0,5,18
61430,677,345,5,11,14,0,15,19,332
61884,1124,545,10,12,0,36,12,0,579
54459,1254,629,3,33,22,0,36,9,625
20902,52484,26365,245,2290,400,303,2130,608,26119
77417,2652,1244,0,33,3,20,71,21,1408
79359,2944,1505,4,37,43,4,147,40,1439
79540,77,45,0,0,0,0,0,0,32
65618,308,184,0,0,0,0,0,0,124
67018,204,128,0,6,0,0,5,17,76
68347,2761,1481,24,76,15,0,95,33,1280
68661,7470,4263,87,377,76,32,215,73,3207
75287,54882,25197,229,2388,399,414,2550,539,29685
76469,78,32,0,5,0,0,0,0,46
77033,29903,14159,352,851,149,278,977,266,15744
71369,2624,1168,5,81,2,18,81,0,1456
81648,2647,1362,2,63,23,25,68,72,1285
56185,619,332,5,13,9,0,17,8,287
56434,342,151,0,4,1,2,25,3,191
58063,393,212,1,8,8,0,21,15,181
92227,27255,13198,206,612,221,121,956,321,14057
84667,384,211,0,4,1,5,15,4,173
94572,10411,5070,57,279,109,44,459,184,5341
95023,52646,26278,398,2043,377,715,1772,610,26368
95668,743,359,31,26,5,0,9,9,384
97370,8526,4252,51,342,147,42,344,215,4274
67648,545,265,3,17,20,0,26,5,280
68623,257,116,0,0,8,0,2,6,141
68626,620,343,14,17,10,8,9,7,277
69163,990,522,4,41,24,3,57,19,468
69212,200,88,0,8,5,0,7,1,112
67042,17789,9471,216,547,161,132,364,328,8318
52223,1418,692,31,64,27,0,56,12,726
16046,16459,8374,73,626,149,30,748,342,8085
19022,3948,1838,7,63,17,0,187,49,2110
19063,35798,16852,194,863,513,81,904,568,18946
19074,5890,2831,32,117,132,58,154,135,3059
11516,7670,3557,172,163,123,33,285,78,4113
7069,5984,2757,62,192,72,0,185,97,3227
68974,174,80,0,4,3,2,3,4,94
70070,13875,6935,0,474,160,89,569,145,6940
71272,1645,1031,65,0,0,73,0,0,614
71671,8501,4021,64,394,93,68,348,162,4480
62440,1315,688,35,66,4,2,60,50,627
70533,7267,3649,26,203,16,30,237,79,3618
70723,1303,679,19,49,4,0,8,33,624
54558,2093,973,1,22,26,1,51,63,1120
55116,24196,11294,117,903,267,80,942,319,12902
55933,234,118,0,5,1,0,11,1,116
46806,26056,12109,258,632,292,133,1039,263,13947
21649,2131,1106,10,66,18,13,39,0,1025
53181,7519,3758,82,190,71,48,185,77,3761
80264,0,0,0,0,0,0,0,0,0
93223,10742,5057,54,338,139,235,369,132,5685
96017,152,91,0,0,11,0,2,1,61
78389,1641,801,39,18,13,0,61,4,840
79510,7379,3717,69,304,83,17,155,105,3662
80022,50392,25549,429,2033,368,229,2085,291,24843
89014,39698,19308,238,1279,250,302,1438,544,20390
15639,2017,877,22,30,9,37,38,90,1140
22729,1199,1083,4,72,6,0,0,19,116
4676,1059,559,0,46,22,0,32,13,500
7755,5851,2986,21,164,25,31,129,90,2865
13148,10605,5230,73,182,159,58,266,196,5375
7920,27017,13105,96,607,191,66,694,381,13912
8321,147,79,0,0,5,0,3,10,68
10014,30738,15513,60,1894,426,37,1503,555,15225
17569,6441,3157,3,223,63,25,217,78,3284
37772,12348,5717,46,472,147,112,312,199,6631
39193,959,524,0,35,19,1,23,20,435
32967,21111,10351,74,674,216,94,697,317,10760
46171,1732,998,18,79,29,0,49,17,734
46938,2984,1363,5,39,46,8,101,25,1621
26325,263,83,0,7,0,0,5,0,180
24411,70,36,0,0,0,0,0,0,34
24839,1705,845,19,52,0,0,57,0,860
25152,231,127,0,0,0,0,0,17,104
42303,41387,20287,224,1269,512,184,1155,641,21100
47958,179,83,0,14,0,4,1,5,96
99347,2240,1096,0,38,13,0,67,31,1144
99556,2640,1442,13,57,54,16,74,58,1198
80224,19253,9604,128,802,183,116,753,274,9649
74880,1958,1055,13,57,6,5,26,26,903
65768,473,232,23,47,11,0,15,0,241
66214,12138,5987,75,477,32,13,403,140,6151
69033,2416,1190,19,48,25,0,84,51,1226
58362,18,9,0,0,0,0,0,0,9
52754,1524,726,3,40,26,2,33,40,798
64467,244,125,0,7,17,0,8,8,119
65722,1680,862,0,60,19,33,130,2,818
45440,20633,10120,194,618,225,24,647,267,10513
70802,23968,11466,341,577,182,446,702,379,12502
71354,1679,747,0,52,18,0,24,20,932
72023,37819,18823,133,1455,243,146,1581,464,18996
48001,11885,6052,102,220,229,32,311,214,5833
48625,13005,6762,49,344,249,76,258,196,6243
48846,19931,11831,197,957,212,42,666,285,8100
29583,4985,2445,6,84,138,10,87,99,2540
30631,1647,832,7,47,15,18,32,18,815
30721,53461,26499,383,1892,492,368,1770,516,26962
41571,496,236,0,10,13,0,5,15,260
43320,1524,822,0,44,18,4,54,51,702
35901,20049,9856,88,806,251,82,845,278,10193
36016,4807,2944,48,356,60,35,100,38,1863
22534,3277,1749,21,78,37,27,97,24,1528
24133,2401,1220,10,105,32,16,89,47,1181
32164,45207,21329,288,966,810,219,1432,917,23878
33139,38606,21153,190,2138,347,36,1825,475,17453
82839,1367,705,5,99,8,0,65,15,662
86032,1688,714,0,38,10,29,32,23,974
96737,4926,2637,0,172,46,0,189,74,2289
16839,762,483,23,43,25,0,13,5,279
17837,19942,10634,366,754,187,385,350,116,9308
5353,889,434,11,23,46,0,13,11,455
13027,32949,16374,106,1220,401,141,973,614,16575
19457,63,22,0,0,0,0,0,0,41
23023,498,316,18,18,10,0,0,0,182
13796,1400,707,0,33,21,0,47,20,693
15358,618,225,0,13,7,0,24,9,393
2827,2060,1017,8,67,33,0,36,97,1043
3224,2335,1164,8,58,32,23,23,72,1171
1603,19336,9540,177,494,177,193,605,146,9796
1821,33016,16262,303,1148,257,230,1030,437,16754
80246,13607,7479,75,604,123,62,423,124,6128
76402,881,372,19,0,0,43,0,0,509
78741,52716,28918,999,2079,325,1317,1463,206,23798
79081,4001,1952,27,124,40,0,93,21,2049
79706,25919,12435,17,1043,180,270,1072,331,13484
61413,906,442,3,26,10,5,33,17,464
61448,3837,1729,0,100,57,24,128,62,2108
65063,3659,1842,22,182,0,6,64,38,1817
66045,2159,931,94,0,0,94,7,0,1228
66958,262,170,1,1,0,0,0,3,92
92243,50484,25240,555,1378,474,451,1364,605,25244
98198,38089,19088,227,1322,430,193,1223,502,19001
99714,1204,632,5,0,26,15,44,29,572
97467,4982,2410,14,112,85,11,211,96,2572
6517,14445,6939,47,393,194,57,545,352,7506
2108,4082,1979,0,117,49,46,154,0,2103
2132,28487,13080,82,1055,324,69,842,506,15407
30338,35435,17136,79,1646,255,36,1637,267,18299
31527,568,289,0,0,0,0,0,0,279
14586,11897,6013,76,500,132,106,456,260,5884
15132,21289,9564,42,504,197,209,613,309,11725
664,14991,7467,211,436,204,78,402,231,7524
1562,11913,6249,0,624,131,28,528,156,5664
14543,3360,1739,11,70,50,0,56,87,1621
15075,180,73,0,0,0,0,0,0,107
96818,59482,30167,414,2260,383,234,2337,472,29315
97470,20269,10153,101,595,353,183,368,299,10116
97819,28,18,0,0,0,0,0,0,10
99516,20965,10335,84,760,152,66,811,533,10630
99666,167,90,3,4,0,0,0,0,77
72729,165,87,0,13,31,0,0,10,78
73947,369,209,0,6,10,0,5,16,160
75784,957,494,17,5,3,3,32,20,463
67105,121,61,0,0,4,0,5,3,60
67155,174,87,0,4,3,0,3,22,87
68322,480,268,0,5,8,0,12,1,212
68375,108,39,0,0,4,0,0,2,69
64477,3533,1841,8,166,75,0,166,32,1692
65717,3012,1537,26,99,40,40,107,26,1475
84649,996,501,0,19,6,0,16,15,495
76087,27089,13930,61,705,304,134,689,352,13159
60615,41563,19140,590,1339,299,564,1564,544,22423
80746,64,41,0,0,0,0,0,2,23
63017,41556,20028,143,1030,504,104,1165,734,21528
35906,9875,4609,48,271,142,24,225,36,5266
50069,1009,515,2,32,16,0,31,6,494
50682,1837,915,0,57,28,3,47,43,922
27967,297,145,0,13,2,0,5,1,152
41824,1099,580,0,17,0,0,92,0,519
42782,1001,460,0,24,11,9,14,0,541
23827,1669,805,3,51,20,2,17,18,864
4451,194,92,2,6,0,0,9,12,102
5476,3182,1563,10,91,46,32,65,66,1619
76377,793,414,0,7,12,7,11,6,379
76437,5706,2818,26,163,30,64,72,71,2888
78621,23496,11735,100,810,166,78,781,296,11761
79322,1998,974,8,48,35,13,36,29,1024
59860,9895,4893,22,226,159,21,210,186,5002
60949,535,252,2,38,3,9,25,10,283
62275,3705,1807,0,112,67,10,134,96,1898
63467,15,7,0,0,0,0,0,0,8
65016,1423,775,11,21,9,0,25,0,648
85713,46640,23470,578,1640,496,477,1263,561,23170
75141,5880,3899,114,461,52,37,111,41,1981
82073,48,31,0,0,0,0,0,0,17
83522,2297,1381,34,82,10,30,23,37,916
13489,679,320,0,24,12,0,17,15,359
15364,771,415,0,20,17,7,23,26,356
16563,1644,1101,55,0,0,51,0,0,543
30184,6612,3227,35,151,178,16,168,33,3385
31326,20230,10177,89,954,146,155,895,194,10053
32694,2454,1184,7,70,30,0,25,17,1270
33458,56642,27915,247,1539,508,249,2232,852,28727
21794,2280,1224,0,57,0,0,25,36,1056
21902,212,209,0,0,16,0,0,0,3
22469,1412,637,0,0,0,0,44,38,775
8064,192,61,0,0,0,0,0,0,131
28518,8512,4156,55,413,120,26,236,131,4356
30009,16097,8102,12,476,293,40,620,253,7995
12170,5061,2579,0,106,48,0,80,112,2482
27514,32304,14411,862,608,223,1333,591,224,17893
52057,7670,3861,26,134,141,55,235,143,3809
52072,262,138,0,15,1,0,7,0,124
36728,287,155,0,17,0,0,0,9,132
8026,2217,1077,11,58,16,31,78,22,1140
11040,41877,19603,152,1019,431,429,1265,545,22274
11724,3160,1477,34,113,24,0,114,51,1683
12180,53437,25843,735,1285,449,766,1679,699,27594
25647,738,301,0,0,0,0,0,0,437
77856,5348,2668,80,153,119,30,100,63,2680
81239,64,45,0,0,0,0,0,0,19
85745,39414,19002,549,1168,538,808,917,631,20412
65254,2074,1015,13,30,8,4,52,41,1059
65658,1234,639,0,0,40,0,7,18,595
67057,217,126,1,4,0,3,4,3,91
68338,338,181,0,5,10,0,15,3,157
86403,18119,8708,41,571,175,81,419,283,9411
86438,837,431,0,0,4,0,23,52,406
88042,198,90,0,0,15,0,0,0,108
90405,28115,14139,47,1499,293,100,901,380,13976
71971,645,257,0,0,0,0,0,0,388
72843,2529,1292,19,162,10,0,47,1,1237
91901,18558,9257,141,598,286,124,462,328,9301
92111,49369,25323,310,1832,251,517,1791,558,24046
6043,4928,2400,29,49,62,45,107,51,2528
7869,25820,12750,146,619,154,137,704,280,13070
7871,20255,9723,156,557,210,80,529,373,10532
59450,503,249,0,2,13,0,9,14,254
60476,2493,1179,46,78,15,0,28,87,1314
52046,2586,1294,2,52,6,23,37,31,1292
54011,6800,3510,26,192,68,21,220,87,3290
37340,597,307,0,58,0,0,0,0,290
37843,3807,1965,29,49,94,0,124,27,1842
13478,2760,1467,22,92,89,0,107,53,1293
21804,40402,18852,625,981,482,799,1481,495,21550
22939,5983,2817,32,46,43,33,124,129,3166
42352,1918,985,9,73,44,33,47,48,933
98860,250,114,0,7,0,0,10,0,136
61001,1042,555,9,16,11,2,18,38,487
43945,3189,1638,46,87,41,14,137,84,1551
45362,1141,637,11,26,2,13,19,16,504
45449,17914,8488,45,798,97,128,671,253,9426
43340,1845,993,42,21,6,34,23,23,852
34240,11142,5339,56,262,208,37,315,161,5803
97455,2861,1435,0,50,29,23,18,26,1426
97741,12341,6460,95,497,86,82,341,140,5881
98342,1363,629,0,21,16,0,27,52,734
98635,1594,694,17,33,42,67,11,78,900
93063,56651,27794,421,1541,715,353,1772,880,28857
29470,4900,2438,91,117,64,18,91,139,2462
48005,5500,2789,11,189,67,21,187,66,2711
39146,2124,1021,19,30,16,36,85,41,1103
28708,375,164,0,10,0,0,18,0,211
30281,67533,32952,379,1736,448,319,2379,1100,34581
19034,5791,2790,39,281,77,6,189,97,3001
19607,23144,10255,59,733,297,251,470,283,12889
21671,799,406,0,24,24,6,23,8,393
24843,56,30,0,0,0,0,0,0,26
24879,778,328,0,0,40,0,11,24,450
42437,8618,4539,256,179,100,92,236,121,4079
43542,3687,1907,47,168,0,15,159,44,1780
32951,12029,6117,37,316,281,36,127,332,5912
27212,2008,1387,12,256,9,5,78,0,621
27376,8998,4465,114,181,251,0,207,181,4533
28456,3800,1782,13,71,79,34,121,58,2018
38855,4392,2114,41,84,55,9,111,146,2278
40844,99,41,0,0,0,0,0,0,58
57562,59,27,0,0,0,0,0,5,32
58210,335,202,0,9,7,0,4,11,133
58256,871,418,1,35,7,0,42,9,453
44201,6944,3263,70,201,112,71,187,48,3681
46784,1973,952,23,59,33,4,49,20,1021
64154,10895,5046,33,358,52,34,419,81,5849
64841,535,229,0,11,0,16,10,0,306
48103,55403,27372,324,1930,789,218,2087,720,28031
49090,14267,7025,89,269,168,50,382,186,7242
55378,29926,14749,216,956,193,313,1066,337,15177
55941,984,483,12,56,17,3,28,21,501
60920,199,94,0,3,0,0,8,5,105
73003,24147,11249,158,849,242,204,980,302,12898
73054,4271,2204,23,81,68,16,101,84,2067
6751,3384,1659,0,73,40,0,99,103,1725
34231,30267,14234,152,921,364,127,723,455,16033
98858,1842,950,25,58,38,0,102,4,892
99011,3118,1763,128,137,0,44,42,0,1355
99606,334,171,3,16,3,2,3,0,163
56754,572,290,5,17,16,1,32,5,282
59025,46,25,1,0,0,0,3,0,21
60072,1021,530,0,25,19,8,32,24,491
79045,18981,9504,235,612,196,215,653,204,9477
93635,40759,20453,292,1687,182,275,1558,456,20306
87521,835,382,0,14,3,0,7,2,453
87732,1531,681,0,38,0,0,63,36,850
91342,96487,48682,604,3131,988,746,3511,927,47805
60453,56420,27759,320,1890,640,304,1593,838,28661
61277,3245,1627,27,51,29,7,39,70,1618
49408,9810,4897,74,292,178,14,259,104,4913
50535,1024,485,1,15,20,0,12,11,539
54747,2690,1326,22,87,41,15,105,39,1364
56721,10180,5132,44,409,67,47,360,119,5048
62861,165,96,19,5,0,0,4,5,69
72002,17343,8914,71,756,103,117,791,223,8429
98261,2681,1290,0,57,46,0,50,73,1391
56736,992,517,0,43,21,2,7,14,475
57639,338,175,2,5,0,3,11,0,163
58316,6982,3321,0,236,20,114,222,45,3661
58477,150,92,0,7,2,0,2,2,58
58581,265,154,1,1,0,0,0,0,111
72123,429,207,4,2,6,9,7,10,222
72351,671,322,7,30,3,0,33,10,349
75573,103,49,0,9,0,0,0,0,54
75778,3172,1261,0,136,9,0,73,13,1911
63055,3133,1686,24,102,8,10,136,14,1447
65264,701,326,2,6,0,22,4,6,375
65730,40,19,0,0,0,0,0,0,21
67016,558,300,0,20,6,0,10,5,258
70554,5638,2727,106,94,8,22,157,82,2911
71232,6709,3496,57,137,135,20,208,79,3213
61724,494,238,0,15,16,0,9,5,256
80488,205,164,0,0,0,0,0,0,41
86433,0,0,0,0,0,0,0,0,0
87715,469,208,0,22,0,0,0,26,261
90402,11866,5740,76,289,159,0,324,243,6126
92021,71321,35997,429,2531,733,623,2005,1059,35324
28803,33756,15614,237,1149,307,131,1086,473,18142
31544,778,350,0,10,0,0,36,16,428
36863,11604,5680,123,252,158,58,268,100,5924
41204,525,306,0,45,9,0,11,0,219
42031,3013,1388,3,45,29,40,153,86,1625
43126,498,216,4,35,2,8,17,2,282
94599,3078,1399,0,35,56,0,74,0,1679
91105,12191,6067,0,434,230,9,424,216,6124
92646,55893,27531,226,1435,647,248,1504,857,28362
57266,609,309,0,12,11,4,11,5,300
42058,2408,1227,0,98,76,27,24,0,1181
45370,2479,1257,0,44,54,0,51,49,1222
50317,37976,19444,304,1445,416,142,1021,330,18532
50467,86,45,0,4,0,0,13,2,41
51566,6514,3150,20,120,117,88,140,110,3364
52738,3747,1966,7,120,53,25,118,13,1781
48159,2574,1306,12,92,24,4,45,33,1268
49097,11124,5633,36,407,137,24,351,131,5491
36785,1039,402,0,54,3,11,0,13,637
39752,3023,1439,54,64,28,20,128,39,1584
46383,41698,20642,449,1342,561,626,1586,412,21056
78585,291,179,0,0,11,0,0,0,112
79903,16399,8446,188,421,71,119,359,155,7953
79927,41227,19584,171,956,388,339,1206,395,21643
80443,4340,2153,0,128,105,0,396,60,2187
80530,4460,2265,23,242,72,11,198,42,2195
62095,10455,4911,62,298,68,53,258,145,5544
72322,133,69,0,0,5,0,0,0,64
68030,737,351,7,13,20,0,9,6,386
88101,46995,24395,617,1555,346,331,1325,459,22600
99832,124,49,0,4,0,0,0,0,75
21652,138,67,0,0,9,0,0,0,71
2537,6535,3081,11,164,59,0,215,145,3454
76665,2523,1279,41,89,19,28,72,28,1244
77002,13571,11525,208,1077,127,34,150,50,2046
77807,11119,6233,65,563,57,73,370,99,4886
78221,39523,20256,403,1553,269,374,1171,440,19267
78552,38553,18336,207,922,376,259,1175,439,20217
66873,255,144,5,25,3,3,3,0,111
67422,1340,680,2,30,43,0,35,13,660
67444,522,283,9,7,15,0,4,4,239
67654,3949,2231,54,248,4,0,40,56,1718
68039,1334,684,10,41,10,10,39,7,650
62534,1389,774,8,39,9,0,35,14,615
72414,353,186,0,21,4,0,13,4,167
72470,209,133,0,4,3,1,0,1,76
80483,748,469,0,26,4,0,4,23,279
74756,707,331,5,26,2,8,12,14,376
75142,19059,9813,142,677,183,156,668,127,9246
76208,24687,12226,181,861,182,165,878,180,12461
83639,3515,1703,5,159,3,34,112,23,1812
85373,19088,8723,24,278,257,23,375,305,10365
92019,42400,21265,451,1308,636,299,1401,706,21135
92257,1332,676,0,22,8,35,0,20,656
95062,38028,19362,349,1557,584,291,1279,570,18666
98857,3637,1859,11,103,42,0,104,84,1778
95820,35477,17166,237,1276,291,156,1273,387,18311
3456,813,404,0,10,12,0,17,11,409
5640,121,68,0,0,3,0,0,4,53
1749,19868,9795,95,563,233,115,363,372,10073
54871,2993,1414,2,91,41,9,76,37,1579
55336,7836,3794,44,245,92,34,249,91,4042
41264,471,275,0,0,0,0,13,8,196
43202,21141,11668,386,756,131,278,786,135,9473
43468,401,195,0,0,12,0,7,7,206
36866,3758,1764,38,71,49,26,175,106,1994
37014,2738,1372,20,149,48,0,99,0,1366
55079,8726,4692,29,288,83,2,312,136,4034
56711,0,0,0,0,0,0,0,0,0
57601,3881,1870,0,126,60,25,103,29,2011
58324,1397,736,0,32,18,0,29,23,661
4460,1224,675,0,26,38,4,74,45,549
14807,2946,1460,14,55,26,23,95,55,1486
15623,599,288,0,14,0,0,27,19,311
16061,2451,1293,12,43,25,2,35,59,1158
16233,1048,527,10,7,5,0,0,13,521
60952,686,339,3,29,3,0,14,24,347
70744,5932,3004,2,147,104,0,276,47,2928
30813,44065,22670,165,2062,218,387,1769,381,21395
87930,715,448,0,0,0,0,19,27,267
31625,972,489,0,21,0,0,8,0,483
75792,2765,1414,26,27,34,18,141,24,1351
33433,39954,18412,228,933,594,107,1022,590,21542
83276,3827,1971,22,150,50,0,117,102,1856
38122,24695,12273,123,743,210,57,904,265,12422
90604,42063,20230,331,1131,291,206,1602,548,21833
96057,1299,677,2,25,23,0,13,26,622
49840,593,296,10,23,17,3,15,17,297
68717,236,129,0,6,6,0,0,1,107
52313,296,155,0,7,23,0,4,25,141
29693,14413,7330,57,488,110,45,371,181,7083
8251,9378,4537,17,198,126,45,433,195,4841
72703,32352,15992,422,1304,202,410,1016,381,16360
13622,2344,1109,6,72,48,9,79,35,1235
70586,20276,10361,179,534,162,173,622,232,9915
63344,1378,771,13,27,22,1,60,12,607
63945,1275,701,0,17,0,0,50,0,574
45354,456,233,8,8,6,6,8,8,223
30008,31982,16168,223,1430,220,114,1381,307,15814
24712,2189,1117,56,10,10,57,0,32,1072
38666,6613,3453,26,156,77,52,170,78,3160
50619,2421,1246,10,79,32,0,60,22,1175
60707,43019,20752,352,1326,292,111,1645,717,22267
86511,3658,1785,24,138,29,75,117,103,1873
87313,5931,2872,65,169,36,21,199,73,3059
75563,4709,2238,62,82,83,17,137,95,2471
37690,3817,1946,35,59,64,24,25,90,1871
47106,4788,2352,19,191,52,25,157,10,2436
27556,143,68,7,2,0,0,10,0,75
74032,2146,1030,29,39,49,0,58,33,1116
27583,7020,3373,136,286,62,19,193,96,3647
67568,199,93,0,7,0,0,11,1,106
94028,6868,3278,0,109,51,0,133,115,3590
88032,252,165,0,47,0,0,0,0,87
89120,25124,12835,233,806,271,168,599,466,12289
89702,0,0,0,0,0,0,0,0,0
74421,4717,2529,32,188,52,16,162,70,2188
75127,1740,900,0,40,42,0,56,18,840
75159,19469,10328,151,905,199,40,882,138,9141
76634,7225,3485,55,122,119,0,144,104,3740
77978,757,427,0,14,3,0,15,8,330
78057,588,350,0,68,0,0,0,0,238
67232,664,288,0,0,0,0,0,0,376
67572,477,226,0,3,12,0,2,7,251
84013,1048,550,12,48,8,9,29,3,498
45761,1843,949,27,150,24,0,85,60,894
46204,8008,5127,83,428,47,7,178,48,2881
47042,4207,2098,14,126,15,53,73,79,2109
47596,82,41,0,0,0,0,0,7,41
47631,2101,1040,0,28,50,0,31,22,1061
65793,6416,3193,28,227,128,11,123,130,3223
69034,1153,641,0,21,12,0,33,9,512
83648,3150,1817,139,116,0,40,145,0,1333
60706,23301,11124,132,871,259,110,949,454,12177
56583,112,65,0,2,2,0,4,6,47
59262,751,346,0,14,10,0,34,14,405
73628,1655,828,0,53,13,11,35,12,827
24316,0,0,0,0,0,0,0,0,0
24318,585,330,0,22,12,7,11,14,255
24322,138,81,0,7,0,0,8,9,57
24437,729,395,0,36,0,0,11,0,334
25064,9260,4307,0,164,106,25,237,164,4953
13774,192,125,0,0,0,0,0,0,67
30560,4759,2512,0,152,101,18,32,53,2247
32011,13805,6817,88,497,231,49,432,150,6988
32063,13840,7112,0,543,123,6,677,68,6728
22529,155,81,20,0,0,0,0,0,74
26690,527,214,0,0,0,0,17,29,313
28337,10019,5021,53,446,84,20,510,184,4998
17963,8852,4640,20,241,104,17,276,174,4212
30115,41105,20114,85,1202,651,134,1499,378,20991
12041,638,320,18,0,0,0,0,0,318
12157,4228,1969,17,144,55,30,149,60,2259
10172,0,0,0,0,0,0,0,0,0
10199,148,47,0,0,0,0,0,0,101
11225,58882,26817,448,2010,372,353,2609,964,32065
15601,57955,27687,443,1241,698,425,1417,1010,30268
15697,2886,1506,22,189,42,0,68,41,1380
16744,208,111,0,20,0,0,0,5,97
16915,5977,2950,33,209,66,31,128,69,3027
66535,2844,1503,3,80,39,0,69,40,1341
67871,4997,2487,138,183,43,31,145,82,2510
74047,7317,3750,78,222,79,25,245,115,3567
75070,98219,46689,460,3862,594,646,4867,763,51530
41630,1397,663,35,13,36,14,13,24,734
62875,1253,667,3,28,18,11,18,10,586
72036,699,321,0,9,4,7,17,8,378
56074,2027,995,12,78,51,21,73,25,1032
45601,56753,30644,365,2439,620,270,1627,630,26109
20045,0,0,0,0,0,0,0,0,0
49925,489,239,0,6,7,12,6,1,250
82833,94,51,0,0,0,0,0,0,43
85379,47791,23304,430,1393,303,317,2245,347,24487
93243,1938,860,45,60,39,0,17,68,1078
94027,7444,3715,34,160,63,34,196,132,3729
94939,7108,3174,28,170,178,29,101,114,3934
78213,43931,21325,522,1644,461,324,1841,449,22606
78230,45369,21887,251,1319,400,345,1315,411,23482
78384,5622,2847,51,149,54,0,211,73,2775
79733,224,120,0,2,2,0,9,0,104
62045,429,231,0,16,3,0,27,0,198
90680,30321,14772,216,1011,213,253,1132,308,15549
13696,47,18,0,0,0,0,0,0,29
14618,22602,10146,175,531,160,227,548,306,12456
16901,10119,4871,71,247,230,26,211,147,5248
20659,23358,11439,222,658,247,131,700,310,11919
3101,2701,1617,10,180,26,2,31,33,1084
5474,956,483,5,39,10,0,21,14,473
10979,171,132,0,0,0,0,0,39,39
18925,6691,3207,0,214,34,41,278,72,3484
1075,17763,6898,38,380,191,562,509,404,10865
1585,4574,2275,13,96,25,0,99,35,2299
2170,19367,9920,144,552,247,139,410,287,9447
38232,1810,887,0,33,28,0,49,28,923
68305,4081,2076,12,118,37,11,73,45,2005
52593,159,85,0,2,0,0,3,0,74
53005,19980,9991,75,604,258,68,501,332,9989
72372,2040,1013,15,57,38,34,80,13,1027
12920,2339,1265,34,50,18,15,76,25,1074
14456,19201,9516,303,390,206,213,498,303,9685
12072,2884,1511,16,76,57,28,107,52,1373
70420,8272,4021,24,177,133,11,141,53,4251
50118,952,488,5,49,5,4,37,8,464
56621,4871,2480,23,116,47,20,141,58,2391
48619,604,283,2,15,8,3,4,48,321
14424,27717,13514,315,636,358,187,853,475,14203
15014,3132,1464,15,78,19,9,194,29,1668
15089,6536,2917,0,148,108,53,268,142,3619
5743,3862,1896,9,81,45,0,98,58,1966
6424,12842,6329,77,405,223,1,419,141,6513
6702,3025,1534,0,62,124,21,78,80,1491
7661,11530,5612,39,507,86,31,389,100,5918
17752,4649,2296,34,142,51,14,132,108,2353
3223,3383,1716,0,51,86,63,75,11,1667
15696,378,234,4,7,1,1,16,7,144
17314,6135,3341,62,131,45,12,59,71,2794
22923,5089,2362,73,127,68,73,133,154,2727
23922,4326,2963,15,295,73,0,83,19,1363
12470,480,241,0,4,0,0,16,0,239
26636,620,298,0,44,14,0,0,23,322
49254,2729,1292,0,107,55,40,139,38,1437
41004,4010,1877,4,130,18,7,85,51,2133
53118,7294,3559,39,187,117,14,220,185,3735
53554,1217,642,0,31,8,3,43,17,575
55347,30390,15017,65,950,358,106,1039,503,15373
57017,1464,728,5,43,20,29,53,23,736
43738,103,66,0,2,1,0,0,1,37
45162,2666,1329,39,68,10,13,53,55,1337
45245,20800,9822,139,910,211,99,704,269,10978
35064,11171,4652,166,362,127,79,319,132,6519
36093,11147,5356,159,286,150,132,400,138,5791
49806,513,266,0,2,13,0,15,14,247
47514,1668,1540,16,251,5,0,10,7,128
49321,17354,9057,90,773,178,116,545,218,8297
20624,1410,678,6,78,12,0,45,5,732
21874,1872,855,5,25,2,5,20,10,1017
22714,1032,501,0,29,1,0,21,17,531
14613,13578,6778,155,517,105,147,406,187,6800
16401,6797,4632,43,504,62,20,112,67,2165
17087,2659,1386,18,85,23,13,53,59,1273
13345,174,91,0,16,0,0,10,0,83
1008,1197,623,0,19,19,0,15,21,574
18454,15,4,0,0,4,0,0,0,11
81235,797,357,0,9,32,0,17,33,440
82648,30,20,0,0,0,0,0,0,10
83250,1718,849,12,37,17,3,81,28,869
92407,69222,35051,617,2412,401,958,2307,752,34171
92660,36906,17376,275,764,568,246,1231,525,19530
90221,52322,26491,689,2029,273,519,1925,419,25831
98166,21212,11042,102,718,298,8,680,501,10170
95032,26281,13007,130,769,246,54,892,379,13274
97424,17854,8799,107,567,274,67,731,288,9055
76667,11096,5836,18,285,136,111,393,260,5260
77580,715,316,0,0,0,0,43,0,399
53507,2196,1089,4,98,14,5,86,51,1107
54548,4840,2496,51,109,132,46,126,137,2344
68523,1494,845,0,41,42,0,30,16,649
68928,335,158,3,8,1,0,8,10,177
59401,13720,7003,114,328,126,132,361,201,6717
62023,117,58,0,3,4,0,6,3,59
63473,279,135,0,7,5,9,0,0,144
64080,13000,6423,23,478,103,24,434,193,6577
57012,1198,581,32,40,12,27,38,14,617
41171,5199,3163,29,300,43,9,169,28,2036
43315,7272,3712,30,222,63,85,180,139,3560
49716,942,460,6,13,12,0,19,5,482
34613,17433,8369,0,359,457,33,270,354,9064
36439,728,320,0,26,7,0,15,9,408
39647,1112,501,0,0,0,0,0,0,611
5033,2577,1343,6,138,53,21,59,11,1234
6365,4666,2187,52,99,79,14,115,27,2479
6488,19754,9524,51,435,167,25,339,394,10230
7734,12879,6199,81,330,44,97,473,206,6680
606,6437,3212,72,103,24,27,189,152,3225
93553,1781,815,30,47,31,0,107,20,966
96792,50127,24527,214,1615,518,441,1736,493,25600
99791,164,88,2,3,2,2,3,1,76
84333,2870,1501,10,155,29,25,111,34,1369
85340,33531,16613,156,1136,221,101,1239,236,16918
87107,30828,14561,210,1070,542,185,836,507,16267
88338,87,46,0,11,0,0,14,0,41
90703,50963,24952,375,1216,636,272,1385,688,26011
90813,59000,29348,538,1912,383,542,2077,557,29652
70710,4952,2677,35,287,66,7,153,56,2275
71658,730,398,21,0,34,0,15,21,332
12903,1215,571,0,38,12,0,39,41,644
14009,5341,2632,30,135,74,40,157,77,2709
3231,251,144,0,5,0,0,0,6,107
4637,155,68,0,2,2,0,0,4,87
6059,0,0,0,0,0,0,0,0,0
17311,174,93,0,0,0,0,0,7,81
99836,97,46,0,0,15,0,6,0,51
27018,7714,3914,41,201,113,62,147,245,3800
28104,31085,15279,164,965,293,144,1163,335,15806
28623,1464,746,0,41,36,0,12,34,718
32950,4222,2183,44,74,75,0,58,110,2039
15962,172,80,1,3,9,0,10,0,92
7033,8160,4063,32,265,92,27,323,104,4097
10023,62435,27151,120,2308,947,343,2776,845,35284
11101,30043,15297,128,1549,202,134,1413,455,14746
2879,20524,10129,154,402,229,63,430,446,10395
13494,332,150,0,3,6,9,0,12,182
1475,10798,5568,110,195,139,13,301,92,5230
24951,1801,857,0,61,0,30,74,59,944
76073,5774,3002,66,195,39,3,214,78,2772
76271,1741,817,6,32,25,0,68,13,924
77085,18274,8972,201,592,204,100,580,106,9302
77443,245,145,0,0,0,0,0,0,100
64638,804,393,0,70,3,0,13,13,411
65484,129,71,0,0,0,0,0,0,58
66086,10396,5398,45,487,90,118,362,109,4998
35745,188,108,0,0,0,8,5,6,80
58367,1753,939,4,46,3,11,41,19,814
60441,35415,17954,430,1399,209,156,1258,334,17461
16263,200,71,0,0,0,0,15,0,129
17013,36291,17668,319,1083,477,365,962,333,18623
17981,2747,1429,11,59,47,17,42,46,1318
26032,1116,600,53,5,4,61,7,8,516
6614,33585,15942,151,943,340,118,1121,551,17643
10035,35743,17697,177,1306,203,268,1464,355,18046
29547,3524,1868,10,200,69,5,52,54,1656
36511,383,180,0,0,0,0,0,0,203
14206,19869,9808,158,525,188,110,636,367,10061
25823,2286,992,0,144,42,97,64,31,1294
4417,334,166,0,2,7,0,7,4,168
40243,10414,4672,47,364,145,57,327,112,5742
28202,12745,7170,92,621,46,125,423,50,5575
28339,7357,3679,35,145,102,43,198,184,3678
28430,2205,958,50,119,0,101,40,10,1247
32464,4311,2213,38,140,115,67,146,58,2098
31060,1866,918,45,96,29,3,85,26,948
96134,1918,1020,16,67,24,24,39,24,898
75570,11024,6963,72,648,110,3,454,100,4061
76904,35697,17177,397,1060,483,321,1253,464,18520
93954,472,202,0,7,5,0,3,2,270
87017,346,150,0,0,10,0,11,0,196
64444,1282,622,0,14,17,3,51,32,660
64767,571,324,0,18,9,10,21,15,247
65616,27432,13217,407,646,323,401,846,380,14215
56644,842,441,7,30,17,10,23,10,401
67626,229,110,2,0,0,0,5,0,119
60462,40305,19707,134,1256,525,177,1403,802,20598
61725,1703,973,0,73,38,0,34,5,730
71075,6129,2756,56,101,34,0,113,29,3373
62533,778,374,30,25,21,0,17,36,404
77327,23034,11768,165,946,338,73,731,266,11266
77995,10411,5014,3,350,157,63,321,138,5397
78676,12868,6435,57,402,265,112,326,258,6433
58552,1668,791,7,18,8,5,38,39,877
58710,524,278,2,9,13,0,4,8,246
60463,14926,7174,66,353,196,111,355,401,7752
73082,3135,1621,24,113,45,34,98,11,1514
85616,5384,2510,54,118,110,16,187,114,2874
83127,3597,1883,73,168,24,10,119,130,1714
92548,8273,4281,52,145,56,14,287,89,3992
94591,55334,26959,272,1840,560,500,1801,875,28375
97232,12419,6013,12,566,115,34,875,110,6406
33014,41316,19845,173,1514,413,128,1457,484,21471
33778,14710,7112,58,636,177,50,399,285,7598
15943,3579,1775,16,125,80,34,101,48,1804
23401,304,163,0,8,2,0,4,3,141
25529,854,351,0,10,0,0,11,21,503
20689,2247,987,0,85,26,0,66,0,1260
20866,16171,7610,108,395,129,147,583,186,8561
21286,20483,9380,228,425,221,461,531,306,11103
19122,22187,11132,132,660,128,232,592,199,11055
21711,1106,594,0,44,8,0,21,8,512
78343,4278,2136,19,84,18,36,143,37,2142
78657,5792,2711,0,106,127,15,125,64,3081
67117,1879,897,16,35,28,22,21,20,982
68969,41,21,0,0,0,0,0,1,20
75482,25003,12036,228,620,238,94,858,345,12967
75702,27766,13975,254,899,137,235,686,367,13791
62558,3347,1687,19,123,30,9,131,60,1660
62633,566,278,3,29,1,3,16,8,288
72852,115,60,0,0,0,0,0,0,55
73010,19735,10061,124,733,302,72,790,181,9674
73763,1589,781,2,37,25,4,36,14,808
57031,801,415,18,18,9,5,13,7,386
57073,746,379,4,11,28,0,6,10,367
57077,1643,875,0,81,39,6,61,17,768
58059,1348,712,21,65,17,0,45,14,636
90020,39102,19171,185,1496,263,228,1680,333,19931
84032,22464,11759,153,1050,137,146,1096,238,10705
93657,34723,17569,218,1189,236,172,1024,420,17154
94542,14217,6813,140,394,246,227,493,176,7404
94611,39384,18554,177,1810,451,64,1693,739,20830
99337,31088,15922,129,1018,474,76,952,638,15166
99835,8738,4471,32,364,90,21,239,95,4267
96019,10111,5108,91,493,112,100,285,89,5003
51111,235,150,0,0,0,0,18,0,85
67111,249,108,0,5,4,0,14,4,141
44305,22425,10668,94,669,257,110,668,331,11757
44906,16849,8135,111,533,175,95,475,221,8714
45118,3579,1828,33,126,71,11,112,28,1751
52068,4385,2346,21,181,57,12,141,42,2039
52619,696,379,12,20,9,0,21,0,317
53048,3345,1658,16,106,17,0,153,29,1687
53209,46008,21257,200,986,472,157,1639,711,24751
54177,2879,1485,15,68,41,0,85,62,1394
12165,191,92,0,4,5,0,0,3,99
5873,643,324,0,14,40,0,2,26,319
1944,5370,2632,27,68,84,0,141,153,2738
14733,3844,1933,29,64,46,42,79,52,1911
14873,2578,1369,9,85,49,0,45,44,1209
95993,36962,18715,441,1003,402,355,1065,574,18247
90503,44908,21825,375,1672,327,213,1473,697,23083
91504,26863,13413,205,1108,202,122,1138,269,13450
99825,63,32,0,0,0,0,0,0,31
96090,445,227,0,3,8,0,15,14,218
66944,174,74,2,7,0,0,7,8,100
67053,582,265,0,8,5,0,11,6,317
68873,3466,1601,10,166,41,22,84,48,1865
64726,288,178,0,14,10,0,3,0,110
65534,1323,904,259,0,34,13,70,50,419
82710,270,110,0,0,0,0,0,0,160
84092,29567,15169,228,958,472,145,972,534,14398
85086,42272,20399,150,1263,365,214,1297,496,21873
85253,18643,9265,42,246,279,122,337,331,9378
76903,31749,15663,152,873,171,106,899,345,16086
60513,18880,8596,68,587,238,28,1045,277,10284
79056,73,46,2,0,1,0,0,0,27
41059,2640,1333,0,72,80,7,161,65,1307
4287,3235,1516,0,59,28,0,61,31,1719
4851,82,48,0,0,8,0,0,3,34
7632,5450,2702,29,128,78,0,200,79,2748
14568,6065,3101,29,176,79,26,216,56,2964
77064,49790,24663,309,1733,561,248,1766,761,25127
78163,11106,5626,0,332,128,110,248,270,5480
78883,285,91,0,0,11,0,0,10,194
38738,3608,3551,32,537,15,0,0,0,57
38768,73,37,0,0,0,0,0,0,36
40516,3364,1777,37,49,55,0,88,39,1587
30317,13737,6343,26,775,114,65,737,169,7394
44060,60476,29177,299,1630,759,359,1458,1225,31299
46923,8246,4133,10,299,79,70,272,97,4113
47142,1091,574,0,46,0,0,0,32,517
34243,32235,14927,80,504,375,137,644,517,17308
34286,18625,8248,74,861,307,316,911,437,10377
37321,19345,9551,108,568,252,129,598,99,9794
26348,63,30,0,0,0,0,0,0,33
24258,1651,718,0,42,33,11,6,21,933
43348,1736,851,8,57,32,6,114,22,885
28663,617,275,12,13,0,2,18,0,342
30047,65420,33455,399,2201,600,346,2435,941,31965
97824,1833,932,9,37,36,0,25,40,901
98304,634,356,0,26,15,0,0,29,278
80455,438,281,0,4,16,0,0,5,157
80735,380,192,0,19,3,0,6,4,188
83118,1028,547,0,64,0,0,64,21,481
85617,1231,649,11,27,42,0,18,38,582
75962,3189,1236,91,0,0,180,0,0,1953
76707,15418,7382,192,413,140,104,639,89,8036
77044,45885,22408,187,1875,169,95,1604,409,23477
77053,30938,15546,257,1312,199,168,881,356,15392
77302,18972,9661,97,778,200,119,839,335,9311
66439,2584,1246,17,67,28,6,66,49,1338
67635,185,69,2,0,3,0,0,1,116
57646,278,158,0,16,3,0,14,4,120
59537,40,17,0,6,0,0,6,0,23
49885,2321,1225,10,35,48,38,41,46,1096
50853,673,352,0,42,4,12,27,0,321
46960,996,572,7,71,7,0,50,67,424
47361,214,114,0,10,15,0,7,0,100
54821,1257,643,0,14,23,7,23,61,614
48014,4152,2005,30,138,51,38,94,38,2147
61571,24974,11943,54,778,210,89,1085,274,13031
61932,439,215,5,8,5,0,9,10,224
29334,13648,6393,101,432,93,34,520,93,7255
44449,1264,663,14,28,12,15,38,0,601
38781,217,104,0,0,0,0,2,0,113
23662,11990,5831,100,406,100,0,373,110,6159
30543,4853,2361,24,77,17,31,210,46,2492
25266,603,298,0,65,6,0,32,0,305
25442,1649,877,44,24,33,8,52,80,772
33462,33173,17302,99,1372,388,129,920,563,15871
72366,2194,953,0,72,35,0,24,57,1241
72383,65,32,0,0,0,0,0,0,33
75480,1857,943,32,18,34,14,35,0,914
75932,1691,920,10,122,83,0,48,67,771
82646,0,0,0,0,0,0,0,0,0
82832,796,420,0,24,53,0,22,0,376
83272,265,104,0,7,16,0,13,3,161
93441,1013,485,8,21,3,0,22,25,528
96776,1302,700,15,15,39,0,22,40,602
5860,2584,1330,4,93,37,14,57,34,1254
10927,12081,6034,35,437,134,71,349,113,6047
12010,28221,13617,191,828,298,165,667,419,14604
12190,851,469,0,7,8,0,4,2,382
12405,652,312,0,0,0,12,6,17,340
12865,3688,1859,20,70,50,9,94,72,1829
21914,771,417,0,3,0,0,20,18,354
14605,12470,5493,218,310,66,168,424,93,6977
75020,22487,10912,174,688,323,72,643,444,11575
75851,4878,3730,0,523,28,0,85,53,1148
76543,30378,14743,316,889,232,274,737,245,15635
76712,25503,11932,69,792,239,44,866,273,13571
77372,13238,6301,67,288,43,204,307,188,6937
80751,17445,9322,147,749,179,123,400,250,8123
98310,20934,10825,83,635,244,42,608,220,10109
87122,18422,9070,82,635,371,63,578,286,9352
93906,65256,31935,572,2562,589,413,2464,691,33321
94901,42482,21911,252,1429,481,264,1748,430,20571
34972,20496,11838,70,1039,177,79,603,335,8658
37857,19871,9769,77,462,223,58,464,197,10102
38057,3850,1807,0,105,36,26,20,94,2043
46038,42524,21154,162,1688,184,182,1553,347,21370
43151,316,136,0,8,2,0,8,5,180
4922,1062,561,7,38,19,0,46,17,501
1235,2640,1349,0,81,43,15,12,47,1291
1770,4301,1988,12,146,105,0,134,51,2313
24870,2784,1455,8,123,36,0,157,69,1329
19562,2553,1099,8,98,41,10,57,39,1454
32139,854,471,0,38,64,0,0,39,383
11429,27403,12851,211,806,207,128,989,587,14552
93010,45092,22434,412,1259,485,266,1368,627,22658
93022,7232,3942,18,280,131,16,195,104,3290
94043,31488,16753,234,1210,299,92,1287,248,14735
97147,321,128,0,6,13,0,8,11,193
88048,2561,1361,0,53,55,0,50,0,1200
89048,21408,10446,39,335,432,84,557,416,10962
36523,2890,1641,16,69,46,0,60,36,1249
38367,3195,1514,13,129,17,14,188,96,1681
68786,1047,536,7,19,24,0,17,17,511
71725,605,329,3,8,2,2,30,22,276
76524,2944,1496,8,53,19,62,76,22,1448
77396,57775,29470,379,2848,282,197,2410,391,28305
58704,4775,2367,108,118,0,77,225,0,2408
65081,4221,2671,15,313,32,9,88,71,1550
40409,4011,1881,48,149,18,7,162,42,2130
33408,18248,8970,147,384,284,86,372,336,9278
34208,39538,18821,132,1333,397,166,1332,632,20717
35953,7522,3941,16,315,84,10,303,91,3581
43943,3029,1610,8,122,50,0,66,73,1419
45311,6197,3012,23,128,90,45,190,174,3185
36763,275,176,0,0,3,0,3,1,99
38370,704,318,23,12,6,33,3,5,386
52333,6627,3296,0,162,73,75,172,106,3331
39208,32424,16405,100,1124,343,84,1425,392,16019
60655,28804,13876,104,963,251,171,1023,423,14928
61114,15591,7223,47,457,223,134,296,271,8368
61274,201,115,0,0,0,0,7,0,86
62316,545,294,0,25,12,0,15,15,251
71999,720,239,46,0,0,37,0,0,481
72752,366,175,0,21,9,0,16,0,191
73110,33383,15658,247,1030,361,238,1078,411,17725
79519,40,24,0,0,0,0,0,0,16
60421,3843,1907,15,139,46,18,120,80,1936
16504,15650,7352,202,337,211,77,606,113,8298
17266,494,276,0,9,8,0,16,12,218
19438,24845,11849,121,571,277,38,677,342,12996
15243,13112,6099,66,297,185,0,421,271,7013
15520,280,111,0,0,0,0,23,17,169
28424,49,23,0,0,0,0,0,0,26
32119,22398,10871,110,429,287,96,653,259,11527
47847,1185,553,0,38,1,0,42,7,632
48439,48659,23441,215,1405,439,246,1591,555,25218
15642,44060,21636,128,1141,676,179,1134,754,22424
20657,18963,9528,126,587,198,66,494,205,9435
21811,23701,11512,59,490,360,78,666,589,12189
24070,1917,995,10,118,37,0,118,21,922
2921,12415,5943,112,332,252,105,350,253,6472
4345,11440,5197,119,270,78,82,326,186,6243
10467,103732,49745,584,3677,522,670,3855,1283,53987
25309,13493,6252,69,657,130,92,419,158,7241
28450,2596,1131,5,76,35,12,101,34,1465
12850,3204,1712,3,159,72,4,104,59,1492
18912,396,188,0,64,0,0,65,6,208
75496,3812,1864,13,58,68,0,118,44,1948
76210,44231,21828,171,1804,541,325,1708,390,22403
76230,9762,4610,32,285,160,62,302,178,5152
86326,25015,11845,220,533,345,138,979,399,13170
13601,37624,19268,224,1459,357,343,1114,433,18356
15359,170,83,0,19,3,0,3,0,87
15636,3959,2179,18,43,61,0,48,102,1780
15647,215,95,0,20,0,0,19,7,120
16048,139,76,0,0,0,0,0,3,63
16055,8028,4030,9,168,133,7,149,88,3998
5602,11785,5397,34,261,87,62,383,231,6388
5820,543,314,6,8,11,8,16,24,229
6758,364,181,0,5,7,0,0,5,183
7419,8820,4436,37,278,105,14,283,101,4384
7620,1521,717,2,45,32,9,42,33,804
21136,34164,15828,193,877,272,224,1029,570,18336
22026,15845,7604,74,586,144,95,842,175,8241
75212,26320,12230,125,873,154,184,777,226,14090
78123,2412,1206,0,84,18,0,20,46,1206
83347,3044,1516,15,109,26,45,123,6,1528
98339,3141,1593,0,92,48,0,72,26,1548
98626,24070,11823,120,633,233,289,582,388,12247
79312,986,491,12,35,9,15,3,11,495
49102,1699,877,0,55,19,22,10,0,822
8221,6826,3221,27,176,72,13,177,86,3605
11764,12723,6541,48,293,125,57,249,155,6182
11967,27649,13078,52,747,212,267,999,299,14571
12069,213,107,0,20,0,0,0,16,106
12746,1004,467,12,41,5,35,60,9,537
13122,1289,596,0,78,9,40,48,3,693
13416,2346,1138,7,73,34,0,57,36,1208
1851,30574,15071,350,927,222,186,826,525,15503
29032,4767,2210,0,49,19,53,131,130,2557
27201,81,40,0,0,0,0,7,7,41
28369,2865,1405,1,121,42,34,131,24,1460
42048,1834,837,1,10,21,15,24,17,997
43023,13864,7092,238,411,166,284,277,293,6772
66728,29,8,0,0,0,0,0,0,21
67870,1265,569,0,38,0,0,48,10,696
61079,170,99,0,10,11,0,10,6,71
98404,35100,18321,389,1531,184,192,1331,460,16779
97115,3989,1899,35,74,23,59,154,39,2090
72074,120,70,0,3,2,0,4,15,50
79070,10045,5077,127,292,73,32,407,51,4968
90603,21299,10825,116,717,267,110,625,275,10474
93111,17263,8250,199,479,168,240,362,305,9013
93908,12093,6050,36,339,192,28,336,170,6043
80127,44851,22251,146,1115,543,86,1557,946,22600
74538,4105,2093,15,100,52,32,107,74,2012
84124,22303,10942,81,644,208,48,750,313,11361
85726,0,0,0,0,0,0,0,0,0
64866,1296,685,5,69,13,1,17,24,611
90057,49492,26957,420,2570,493,320,1957,562,22535
90250,96836,47518,782,3465,560,611,4021,931,49318
90304,25591,12902,338,810,140,167,561,214,12689
72675,1226,677,0,11,21,0,2,32,549
72944,3707,1659,46,36,57,18,113,17,2048
47585,749,361,0,0,16,0,0,0,388
48422,6640,3357,24,215,68,26,240,95,3283
39635,294,166,0,20,0,0,0,11,128
37398,14601,7287,11,439,185,11,350,132,7314
62345,391,200,0,7,11,0,4,3,191
64092,95,58,0,0,0,0,0,0,37
55325,4620,2339,21,110,65,26,133,89,2281
51554,174,95,0,0,0,0,7,0,79
52159,2252,1078,0,71,34,0,86,55,1174
52164,346,163,0,12,8,0,8,17,183
52247,5546,2617,43,93,33,4,111,33,2929
52624,268,109,0,45,7,0,0,6,159
54490,856,475,3,33,19,0,9,12,381
48720,987,502,3,14,17,6,7,26,485
49083,7913,3970,73,216,134,0,326,146,3943
44670,172,111,0,0,0,0,0,0,61
23156,1625,809,0,30,42,0,22,37,816
24984,154,94,15,0,14,0,0,0,60
11231,37845,17577,77,1762,260,239,2114,447,20268
28621,10499,5437,57,348,125,25,273,108,5062
29178,3211,1624,51,41,45,9,65,70,1587
51573,1070,538,5,42,11,4,10,14,532
52039,935,450,0,29,33,16,18,14,485
54769,692,345,0,30,14,0,28,14,347
55330,38283,19306,134,1507,356,143,1653,332,18977
61955,189,105,0,13,0,0,7,3,84
62565,7024,3226,35,254,84,75,140,148,3798
62889,938,468,12,22,9,16,22,41,470
63117,8978,4563,7,348,112,15,325,125,4415
70816,42094,20039,374,1439,365,275,1464,561,22055
67334,34,17,0,0,0,0,0,2,17
74435,3269,1635,9,110,34,33,79,53,1634
74826,1133,523,9,39,4,0,34,16,610
75835,11105,5413,21,180,140,62,375,105,5692
72447,2065,952,16,97,38,7,75,83,1113
72736,7128,3495,27,166,93,17,210,73,3633
13634,4049,2114,43,154,58,35,73,91,1935
15460,122,70,0,0,0,0,3,3,52
16028,1748,857,0,72,27,27,38,49,891
30662,9077,4561,95,207,101,29,242,112,4516
25165,634,328,0,0,4,22,20,0,306
19732,99,27,0,0,21,0,0,0,72
18702,39841,19753,422,987,313,279,1359,508,20088
8750,3117,1482,9,55,103,0,40,94,1635
11569,1080,616,0,22,38,0,55,12,464
27027,4382,2065,30,59,55,74,78,62,2317
28017,721,239,56,0,0,111,0,0,482
52590,1243,592,16,27,13,14,28,15,651
52701,100,47,0,3,0,0,5,0,53
53235,9477,4763,30,409,206,38,346,185,4714
55427,22966,11121,51,843,167,80,856,278,11845
38505,2030,1196,112,9,0,23,0,0,834
15860,1061,551,15,25,13,2,24,14,510
8230,5342,2558,26,104,84,30,150,117,2784
11934,8006,3787,65,222,126,69,320,23,4219
14542,60,26,0,0,0,0,0,0,34
25267,578,318,0,28,28,0,34,0,260
953,71891,34581,716,2329,645,588,2938,793,37310
1945,20488,9423,61,365,229,24,611,362,11065
95233,567,223,20,5,8,0,26,0,344
99783,170,108,1,6,2,0,4,0,62
74743,8397,3947,20,193,89,72,248,133,4450
76711,9772,5095,80,205,66,53,361,103,4677
82060,613,384,0,0,0,0,0,0,229
84743,17,2,0,0,0,0,0,0,15
84763,319,129,0,5,14,0,5,11,190
84784,2916,1288,6,50,0,6,92,0,1628
68127,22445,11781,192,800,241,141,765,245,10664
68952,99,54,0,0,0,0,0,10,45
72513,2889,1439,0,70,42,0,111,54,1450
74062,1016,531,2,7,7,3,10,18,485
92126,82572,42755,995,3341,802,498,2734,1010,39817
6018,2885,1439,15,86,39,0,80,38,1446
7730,16991,7905,24,401,147,131,562,252,9086
10921,3911,1937,8,82,51,10,71,89,1974
52623,2029,1073,7,84,33,18,90,21,956
29112,3841,1771,19,72,48,10,115,55,2070
14830,19772,9648,115,583,192,194,760,239,10124
15317,38561,19080,199,1404,390,150,1237,507,19481
20553,0,0,0,0,0,0,0,0,0
20560,0,0,0,0,0,0,0,0,0
99726,77,50,0,22,0,0,21,0,27
55003,4262,2855,23,299,45,0,78,59,1407
56175,3036,1518,30,143,38,5,65,40,1518
56535,1235,610,1,21,20,3,38,15,625
56744,504,260,9,24,10,0,9,12,244
62517,199,93,0,6,1,4,15,0,106
63547,392,225,1,5,19,1,9,10,167
48723,12028,5953,76,329,165,25,261,178,6075
43962,92,40,0,2,1,0,2,2,52
46746,4695,2561,10,179,42,9,87,69,2134
49749,3992,2099,15,81,124,12,53,112,1893
43431,4868,2292,0,112,47,60,90,50,2576
35082,0,0,0,0,0,0,0,0,0
97720,4360,2157,0,111,19,15,93,85,2203
99611,15657,8416,70,724,183,70,461,173,7241
93618,31230,15730,81,921,163,233,1122,249,15500
90831,0,0,0,0,0,0,0,0,0
91789,44474,21609,407,1273,646,365,1128,929,22865
95623,3730,1956,11,30,59,10,30,77,1774
729,51593,24731,469,1519,485,408,2020,653,26862
29689,3934,1810,21,43,0,0,175,43,2124
49119,209,76,0,0,0,0,0,0,133
25030,280,170,0,0,18,0,0,20,110
25702,7216,3742,102,103,53,1,203,103,3474
40819,535,240,0,0,0,0,0,0,295
40831,5205,2300,22,154,43,55,172,24,2905
21917,2577,1254,16,125,0,0,95,7,1323
22180,24438,12388,64,703,212,120,711,258,12050
28552,146,69,0,19,5,0,21,5,77
30035,22697,10603,137,743,280,136,662,354,12094
30456,1936,885,3,13,13,0,49,44,1051
31773,3547,1780,0,104,47,25,112,47,1767
36564,52,10,0,0,0,0,0,0,42
37212,21031,10172,665,474,159,730,477,195,10859
38128,45509,20265,351,1130,199,312,1394,611,25244
17551,11411,5294,341,301,76,572,223,163,6117
17921,7556,4353,9,496,141,63,137,108,3203
24128,1987,1033,13,58,42,4,80,47,954
25977,277,109,0,0,0,0,0,0,168
42749,5346,2658,63,153,38,28,190,30,2688
43611,18579,9203,54,525,207,82,637,209,9376
32330,828,415,2,31,15,0,40,7,413
40020,110,54,0,0,2,0,11,0,56
52549,901,438,7,17,9,6,26,17,463
59937,13931,7175,90,401,327,49,580,174,6756
45729,1351,690,0,27,65,0,58,40,661
66209,19829,9446,50,528,346,58,553,413,10383
69334,1911,996,17,39,12,0,23,42,915
62899,1900,1029,15,44,33,0,29,26,871
55952,2580,1314,8,74,18,0,71,19,1266
56060,418,212,0,19,9,2,12,8,206
61817,2516,1281,0,105,19,24,97,38,1235
54773,3432,1716,5,125,28,23,151,24,1716
72320,1590,1555,17,225,8,0,0,14,35
72373,918,416,12,14,6,0,17,10,502
72584,316,134,0,0,0,0,0,0,182
74023,11396,6004,101,413,141,116,227,106,5392
97347,2069,1009,2,79,77,1,32,66,1060
30525,7305,3418,24,63,110,10,220,122,3887
37216,18609,9318,78,852,134,113,740,249,9291
37713,1614,798,0,29,0,0,26,0,816
38018,37217,17317,127,1147,233,253,1461,437,19900
98416,983,449,44,0,0,17,0,0,534
98670,43,16,0,0,0,0,4,0,27
99218,16518,7635,252,500,291,309,440,132,8883
57370,761,377,3,29,5,11,19,13,384
58428,254,142,0,5,3,0,6,0,112
58768,298,147,5,6,0,4,10,0,151
92239,274,152,0,14,1,0,0,0,122
65441,5421,2719,4,239,32,15,154,71,2702
68325,195,92,0,3,2,0,0,0,103
60111,150,73,0,0,27,0,0,11,77
51011,81,40,0,2,1,0,2,1,41
55734,5993,3039,28,162,132,113,105,76,2954
64129,8881,4160,51,278,76,32,234,68,4721
73564,473,222,10,7,1,0,4,13,251
74056,5152,2478,62,88,47,0,142,181,2674
71264,1109,541,0,33,12,8,74,5,568
98616,94,40,0,0,0,12,0,0,54
79782,4618,2481,16,76,5,55,215,33,2137
91042,26631,13347,105,875,204,226,750,319,13284
86540,1043,490,6,27,7,8,19,9,553
73043,155,64,0,0,1,0,3,4,91
73738,1201,596,0,71,11,2,52,47,605
76022,13532,6232,158,476,84,101,467,235,7300
49437,6984,3359,16,210,106,16,200,128,3625
51561,1517,800,0,59,7,0,48,32,717
64759,8005,3910,28,271,39,52,233,181,4095
65543,181,86,0,0,0,0,0,0,95
67574,180,78,0,4,3,0,0,3,102
54405,3006,1594,21,87,25,0,101,24,1412
60641,71023,34841,471,2784,578,364,2715,1186,36182
62356,465,231,0,5,6,0,3,8,234
82501,19688,10211,107,635,239,164,638,252,9477
83827,164,87,0,0,8,0,0,4,77
85629,25362,12049,74,1411,184,219,1174,304,13313
78613,79699,39321,267,3360,662,354,3739,936,40378
95526,210,117,0,4,4,0,0,9,93
96705,2869,1545,16,56,40,25,67,23,1324
97227,4759,2499,4,375,77,3,271,34,2260
87044,288,183,0,19,0,0,7,0,105
87124,54780,26393,451,1713,740,196,1821,789,28387
87558,439,266,0,12,10,0,0,0,173
87733,139,75,0,6,0,0,0,0,64
87823,1149,452,0,1,0,0,62,0,697
92250,8979,4823,203,366,59,76,213,297,4156
92821,37529,18060,412,1247,327,323,1323,518,19469
29169,24170,11786,145,751,186,315,605,420,12384
29691,11113,5153,29,310,68,106,306,143,5960
30802,6147,3221,35,195,74,73,228,149,2926
34116,36531,18086,331,1375,281,315,1445,393,18445
36280,3875,1862,25,84,95,0,84,21,2013
46561,13593,6352,69,501,235,120,611,156,7241
47708,329,199,4,0,0,0,5,17,130
41365,234,92,0,0,0,0,0,0,142
94598,27780,13136,62,819,411,126,838,424,14644
92254,10385,5475,37,476,105,132,258,107,4910
94133,26527,13231,96,973,292,139,850,286,13296
87821,589,247,0,17,0,0,0,0,342
89108,73678,36755,457,2831,396,718,1970,755,36923
99153,371,204,0,0,6,0,9,2,167
2140,21338,10122,49,1008,174,95,946,141,11216
55710,1235,686,0,14,22,0,25,44,549
56323,539,268,10,8,3,8,10,6,271
33140,21807,10887,110,612,339,93,724,285,10920
33146,16156,7799,318,239,141,414,482,113,8357
34461,10664,5476,89,157,139,92,104,113,5188
36064,9780,4870,60,406,128,0,424,127,4910
53576,2275,1200,9,89,16,3,38,19,1075
48131,6986,3389,11,234,161,28,308,174,3597
46595,129,36,0,7,0,0,7,0,93
47575,1177,690,83,17,15,0,14,39,487
81047,1523,796,0,76,21,15,52,17,727
62933,1385,524,6,10,17,60,12,12,861
71047,11692,5601,93,352,109,52,419,147,6091
99724,46,27,0,2,2,0,0,0,19
18512,12005,5732,36,389,146,25,293,167,6273
18950,165,92,0,16,0,0,9,0,73
18980,507,272,5,20,0,7,24,38,235
12788,2717,1625,48,103,24,16,67,36,1092
13364,106,64,0,0,0,0,0,0,42
10013,28709,14029,101,1571,325,286,1301,427,14680
10958,3365,1885,7,93,57,39,51,26,1480
17501,4251,2108,0,139,58,2,80,42,2143
27281,3079,1357,0,165,44,0,102,56,1722
50051,276,153,0,26,2,0,3,2,123
52249,913,441,11,18,29,0,20,2,472
68438,110,68,0,4,9,0,1,0,42
58752,177,81,5,5,0,0,0,2,96
47832,976,540,0,1,23,0,15,19,436
47924,150,86,0,0,0,0,0,0,64
48066,47710,22995,258,1385,466,335,1411,693,24715
70581,559,299,0,0,33,0,0,0,260
73108,15156,8161,130,471,44,176,468,118,6995
76115,20507,10338,176,641,134,185,544,116,10169
53172,21089,10278,40,638,163,108,825,352,10811
54612,5094,2761,52,233,33,48,107,71,2333
55448,27787,13685,190,1033,280,198,1018,369,14102
55973,261,132,0,8,4,9,4,3,129
56045,984,528,2,31,24,9,18,17,456
40379,3414,1666,3,87,35,10,113,32,1748
40870,381,167,0,0,0,5,23,0,214
30816,2024,935,3,56,7,19,86,30,1089
44606,8718,4420,69,284,52,66,268,65,4298
46163,12768,6231,63,363,143,108,455,239,6537
47110,840,322,0,17,0,0,16,18,518
33907,24198,11419,190,944,389,155,683,347,12779
35972,1211,702,0,18,7,23,28,8,509
48098,19237,9314,59,417,291,34,473,441,9923
48356,8680,4467,90,285,144,42,253,59,4213
13640,362,202,0,0,8,0,0,0,160
4048,3005,1518,20,98,39,0,110,53,1487
20854,49194,23941,189,1080,773,202,1144,831,25253
21012,21772,10559,43,562,294,71,913,376,11213
18301,30547,14639,488,752,295,336,1033,388,15908
8742,24292,11632,103,697,288,116,590,543,12660
55954,1371,620,7,32,26,12,26,17,751
61031,1541,796,7,36,15,0,69,24,745
65257,1465,781,0,20,31,9,38,15,684
66442,16565,10308,831,530,0,153,472,22,6257
66748,2747,1431,0,71,54,7,74,32,1316
66939,597,302,0,26,7,0,10,25,295
70030,3628,1889,0,161,74,0,185,0,1739
70057,4729,2816,42,169,81,24,90,70,1913
71227,3915,2051,29,93,23,5,80,66,1864
58077,685,354,0,24,7,8,29,13,331
58220,2052,1043,1,70,33,1,45,65,1009
63867,1028,495,5,28,10,0,51,7,533
75422,3301,1571,57,43,45,2,116,51,1730
32577,4321,2118,48,108,91,38,236,35,2203
47263,245,110,0,4,2,2,10,2,135
1937,174,127,0,23,0,0,0,0,47
58317,213,117,0,3,1,0,0,8,96
61265,43706,21526,214,1530,568,136,1392,514,22180
57014,1408,720,0,49,18,3,50,17,688
35044,7351,3469,99,329,69,0,329,119,3882
35504,13160,6257,172,417,101,34,428,141,6903
46131,32371,15541,79,1190,375,264,1149,423,16830
48312,34798,16962,196,1188,397,148,1010,480,17836
12835,2328,1182,6,61,50,0,71,54,1146
13339,6396,3275,19,151,98,0,134,59,3121
29437,3191,1517,0,16,12,0,32,94,1674
22832,1122,574,0,25,0,27,25,11,548
11766,12414,6050,39,372,244,192,366,287,6364
12168,2053,1079,30,86,21,9,86,44,974
13132,3397,1647,0,82,36,9,142,49,1750
28462,12659,6273,62,238,237,112,346,196,6386
29078,17393,8742,39,536,158,52,589,222,8651
21222,54873,26378,300,1693,615,284,1869,749,28495
90732,22273,10375,70,713,213,57,680,235,11898
87110,38753,18994,138,1449,364,174,1348,662,19759
90043,44627,21139,282,1599,417,270,1470,753,23488
95966,29367,14458,248,711,289,170,704,448,14909
84752,905,463,4,20,16,0,5,16,442
85034,4772,2291,81,173,15,87,164,41,2481
98177,21619,10384,172,688,419,99,784,400,11235
98396,685,382,5,38,5,4,22,7,303
98683,33235,15659,259,1018,374,171,1339,582,17576
7874,8281,3984,34,285,100,43,245,168,4297
8001,977,578,0,18,19,0,52,8,399
8858,147,99,0,0,0,0,0,0,48
10004,3028,1267,9,185,17,3,207,41,1761
4780,778,401,27,10,29,4,15,8,377
1370,4041,1897,29,100,64,35,91,70,2144
27349,5500,2676,31,90,55,0,171,76,2824
32328,3032,1537,28,100,94,57,78,62,1495
38236,629,324,0,12,8,0,35,0,305
38476,1042,559,82,73,0,0,0,15,483
22485,25261,12680,154,900,176,131,870,434,12581
31054,1543,799,7,45,9,14,32,5,744
31820,10815,5434,104,496,101,62,413,220,5381
19731,300,139,0,51,0,0,0,0,161
29377,1402,543,0,48,0,0,46,0,859
71457,27353,12733,409,567,248,495,664,276,14620
95564,432,218,0,17,1,3,15,4,214
98355,917,533,32,16,31,0,0,11,384
74571,3486,1781,6,125,69,11,75,65,1705
76692,10474,5488,7,221,126,60,225,240,4986
77054,22704,11409,105,1280,142,317,612,286,11295
41547,449,171,0,0,0,0,0,0,278
62254,6292,2907,22,145,27,60,92,62,3385
62295,1547,754,4,70,6,11,40,14,793
62428,2803,1398,5,44,33,14,81,38,1405
54771,4243,2163,12,132,37,15,109,78,2080
54874,3841,2048,3,169,71,12,126,65,1793
55052,1992,1052,29,59,30,3,36,30,940
55309,18886,9135,127,561,101,39,703,146,9751
45773,70,27,0,0,0,0,0,0,43
47451,1184,601,0,31,17,0,21,6,583
49765,3699,1886,21,95,63,7,95,59,1813
1606,19729,9316,41,440,214,126,676,419,10413
67646,731,382,2,11,21,0,17,15,349
68047,1738,877,10,42,31,7,48,25,861
59760,284,114,0,7,3,0,4,7,170
61755,4738,2395,45,223,24,6,203,122,2343
62418,2108,1066,5,110,31,5,59,23,1042
57648,304,172,0,7,6,0,3,4,132
64016,4800,2385,22,242,69,7,198,38,2415
72666,140,51,0,0,18,0,0,32,89
70357,2487,1333,0,147,11,19,41,35,1154
79521,3761,2046,32,181,46,18,91,43,1715
97530,6570,3331,30,143,174,0,103,68,3239
91914,16357,8476,222,601,115,107,717,233,7881
92131,34359,16594,106,1088,325,74,1185,514,17765
86333,7417,3892,90,93,53,59,54,91,3525
88043,1573,750,0,47,26,4,49,20,823
88312,2719,1399,0,92,73,45,0,152,1320
38619,5351,2599,24,75,27,19,103,116,2752
40503,29601,14198,272,951,227,554,894,459,15403
40771,1627,747,18,13,0,0,55,12,880
44669,1347,646,0,32,25,0,20,6,701
45051,174,0,0,0,0,0,0,0,174
47001,10264,5189,103,149,186,68,128,146,5075
35020,26345,12412,261,750,355,149,989,411,13933
33830,27476,13254,94,769,362,149,860,369,14222
62995,5928,4005,100,404,90,0,115,69,1923
63631,1240,608,0,45,21,0,11,14,632
71032,2273,1216,3,45,29,0,32,50,1057
57559,512,241,0,5,0,0,8,4,271
50065,701,337,33,16,2,22,5,34,364
52767,182,72,0,0,0,0,17,0,110
45219,18029,10101,1108,302,67,985,250,103,7928
45327,9356,4563,47,162,44,0,203,192,4793
50029,551,302,3,18,2,0,15,6,249
53073,14753,6900,43,384,331,179,400,277,7853
38460,1329,668,9,11,58,0,32,8,661
57551,2308,1174,10,63,14,0,61,26,1134
38943,80,19,0,0,0,0,0,0,61
48021,32469,15154,232,873,259,256,1382,551,17315
48331,21650,10053,192,581,303,227,559,379,11597
48884,4629,2365,23,129,35,23,109,86,2264
49202,19058,8629,185,367,178,136,528,375,10429
42071,31614,15268,377,786,215,824,895,319,16346
43302,54023,29396,349,2101,691,438,1363,657,24627
55944,7315,3643,3,301,69,44,158,46,3672
30824,17025,7768,94,644,131,100,555,273,9257
20319,42,42,16,0,0,0,0,0,0
17327,7568,4082,4,235,63,26,201,108,3486
32789,26568,12616,110,677,418,153,639,563,13952
33440,19878,10729,241,517,138,73,344,328,9149
26610,1226,528,0,31,21,0,56,0,698
24102,1633,791,0,79,21,0,31,37,842
1731,2061,1074,0,133,4,7,123,7,987
2452,15288,7798,422,488,85,307,487,339,7490
2492,20258,9822,102,476,259,150,558,353,10436
3264,7307,3585,190,263,20,117,23,207,3722
3842,15412,7362,55,222,301,71,499,310,8050
4987,1023,524,5,21,18,6,24,8,499
12189,17563,8441,53,586,116,201,614,188,9122
6256,2308,1019,1,107,34,0,72,46,1289
15510,2564,2564,47,415,5,0,0,0,0
19960,6571,3339,124,186,89,50,205,156,3232
21010,217,138,0,14,0,9,0,0,79
22185,0,0,0,0,0,0,0,0,0
25917,2104,914,28,89,6,0,99,40,1190
28782,6562,3275,16,98,258,28,128,143,3287
30040,70510,35048,452,2330,437,235,2532,671,35462
27983,8631,4704,31,237,62,7,72,252,3927
12548,1213,616,0,8,0,0,23,0,597
3844,2344,1237,0,40,24,0,52,19,1107
5904,255,102,0,16,0,0,0,12,153
7063,13666,6734,90,590,108,0,435,108,6932
7762,8232,4072,83,82,154,0,216,144,4160
10152,0,0,0,0,0,0,0,0,0
48819,2816,1408,24,63,30,7,104,69,1408
42039,1890,876,0,43,51,6,132,35,1014
45312,1277,591,15,1,26,5,13,28,686
46127,217,127,0,26,7,0,0,9,90
37737,5638,2832,35,113,67,11,208,62,2806
38670,810,368,4,22,1,27,17,23,442
38703,12968,5942,134,299,184,124,472,156,7026
87025,1082,501,0,10,38,7,15,13,581
89118,22105,11566,188,1045,296,58,888,226,10539
93648,16194,8143,99,468,227,120,595,153,8051
52132,1837,913,0,95,1,0,37,14,924
52301,3546,1756,28,106,67,4,89,49,1790
53550,1156,553,5,33,14,4,26,21,603
53719,31142,16138,166,1363,228,71,1232,391,15004
53792,0,0,0,0,0,0,0,0,0
54451,11481,5809,29,253,132,44,333,180,5672
55979,1185,591,0,29,12,0,22,9,594
60106,20462,10240,105,620,205,149,634,231,10222
62288,3094,1524,21,119,20,8,122,23,1570
75041,32257,16731,232,1149,167,285,1036,344,15526
75109,4555,2413,26,69,41,14,123,42,2142
78249,59508,29598,1521,1639,474,1399,1477,744,29910
78618,331,156,0,5,7,4,5,4,175
63033,42991,19071,101,1072,573,276,1586,783,23920
64156,7935,3785,0,327,9,75,354,60,4150
58053,1177,583,5,35,26,4,29,10,594
71964,3660,1785,0,84,57,0,85,20,1875
84653,9086,4702,110,305,68,46,283,90,4384
85006,28176,15101,196,1222,240,229,996,255,13075
85201,51519,25535,310,2213,281,412,1829,335,25984
87753,174,52,9,0,0,0,0,3,122
98250,8024,3817,50,172,134,3,210,184,4207
95435,14,0,0,0,0,0,0,0,14
82712,251,135,0,0,20,0,0,22,116
94108,14550,7075,17,289,174,60,530,146,7475
28579,554,294,0,0,22,0,0,29,260
30641,1957,884,0,41,30,0,66,13,1073
38873,3278,1352,21,109,40,58,216,40,1926
38941,4481,1948,62,94,26,102,104,44,2533
38967,7514,3418,43,206,87,0,237,88,4096
39362,3594,1863,14,130,0,108,84,20,1731
44703,8081,3912,39,336,110,83,280,53,4169
45244,28602,14075,63,837,369,49,942,373,14527
32217,19411,9506,183,649,123,87,595,474,9905
32433,17586,9810,62,587,293,50,489,220,7776
99136,12,7,0,0,0,0,0,1,5
84062,47813,24211,469,1391,218,428,1694,329,23602
97051,16110,8009,32,550,193,22,663,226,8101
38044,772,297,1,28,18,0,49,17,475
38224,878,449,0,31,24,14,9,9,429
38318,290,171,0,8,5,0,0,6,119
56146,81,44,6,2,1,7,0,1,37
56314,1094,583,3,36,6,3,36,14,511
56590,308,157,3,6,2,6,12,12,151
57439,60,28,0,0,0,0,0,0,32
53541,955,476,7,25,9,7,17,15,479
54410,2495,1219,9,72,29,9,63,28,1276
54471,1852,937,4,43,35,9,43,44,915
44321,15346,7791,50,492,224,55,533,143,7555
46517,26177,12711,192,990,262,218,1353,303,13466
46786,41,13,0,0,0,0,0,0,28
49729,1576,833,17,17,17,3,20,21,743
50327,11381,5259,36,325,93,81,458,224,6122
59868,1847,1032,56,41,44,8,17,28,815
60093,19441,9433,60,494,192,83,543,197,10008
61236,123,62,0,0,0,0,0,3,61
30628,6874,3486,59,155,15,53,231,145,3388
32413,14619,7512,51,608,218,68,423,410,7107
20723,35091,17259,195,1349,273,176,1334,324,17832
15723,13,0,0,0,0,0,0,0,13
11964,2054,1095,0,81,42,5,0,0,959
13756,414,225,0,0,9,0,23,11,189
13777,352,191,0,4,16,0,8,0,161
25061,850,322,0,43,12,0,62,47,528
25810,208,117,0,0,0,0,0,0,91
26263,325,200,11,0,0,0,4,8,125
36922,375,197,0,22,9,0,0,5,178
27235,4557,2313,0,131,41,0,133,67,2244
27577,25330,12483,110,709,230,194,606,437,12847
27707,51168,24491,288,2364,381,511,1710,587,26677
29581,5189,2312,13,126,61,39,327,50,2877
95451,11627,5400,0,502,133,59,470,271,6227
95658,6853,3327,36,72,172,32,144,108,3526
96146,969,562,0,51,11,12,0,0,407
97071,29460,14123,125,690,199,320,734,294,15337
97875,3160,1541,38,88,59,43,40,45,1619
93436,56406,30079,495,1810,552,404,1465,643,26327
19707,16113,8091,80,207,343,29,465,202,8022
33897,19855,9387,63,523,178,134,665,487,10468
25419,11305,5793,38,383,128,72,224,48,5512
28129,5287,2583,4,78,70,8,109,32,2704
12153,1027,603,0,72,0,0,43,3,424
13039,16837,8111,45,631,162,82,416,275,8726
13077,7135,3401,54,151,108,54,177,120,3734
1342,1439,682,16,0,15,0,40,20,757
48212,38161,19320,294,1413,258,334,1135,300,18841
78243,424,358,32,22,0,0,0,0,66
82214,1338,662,0,21,8,14,26,19,676
82609,17656,8370,124,456,97,106,628,274,9286
92020,58742,29539,477,1880,437,226,1983,740,29203
55032,3506,1864,9,83,57,11,98,67,1642
55757,734,371,1,38,8,3,25,17,363
56228,1003,529,0,38,9,0,38,17,474
38761,2579,1197,8,21,18,23,39,21,1382
39652,8173,3971,13,184,61,149,306,163,4202
31305,5983,2982,81,100,23,1,117,80,3001
33033,58224,28526,343,1966,506,457,2416,599,29698
34736,18213,8802,8,411,208,52,822,131,9411
48125,20399,10257,81,734,184,99,707,297,10142
48360,12458,6188,109,238,127,147,387,108,6270
37716,27010,13186,123,630,300,86,739,465,13824
37738,5555,2802,56,96,75,10,149,108,2753
16693,4189,2157,36,110,52,34,123,29,2032
7624,8577,4319,90,213,97,36,131,143,4258
8037,23800,11766,205,674,161,89,658,240,12034
30125,23814,11433,71,889,267,24,590,319,12381
24151,20327,9992,15,532,167,145,737,240,10335
24153,38125,18079,108,953,498,592,852,422,20046
24441,6228,2990,0,190,12,23,159,171,3238
24892,1389,540,10,37,20,0,23,13,849
20427,0,0,0,0,0,0,0,0,0
25855,168,106,0,0,0,0,0,0,62
25875,703,395,17,0,18,0,30,29,308
13842,543,306,6,20,0,16,4,8,237
14217,22974,10817,83,627,261,236,634,324,12157
97119,4649,2481,12,129,44,24,95,107,2168
2666,493,278,0,0,16,0,0,18,215
3256,2333,1145,38,34,42,13,120,38,1188
61367,739,343,5,10,5,4,18,21,396
61864,1719,872,6,56,46,15,56,35,847
80612,338,135,0,0,0,0,11,0,203
70461,27781,13175,159,771,393,339,936,624,14606
70749,1397,571,0,12,13,0,14,29,826
85343,195,129,0,0,0,0,0,0,66
68130,21276,10670,51,825,274,35,834,208,10606
66608,5733,2857,38,305,84,23,122,47,2876
73034,44647,22335,483,1589,468,513,1411,735,22312
73949,1523,707,15,47,17,10,58,22,816
52353,9424,4637,10,255,116,66,203,66,4787
53049,3127,1546,0,131,26,13,104,41,1581
36602,939,482,5,43,20,0,9,8,457
38310,6002,2918,26,159,30,32,198,81,3084
48469,1292,604,3,40,30,0,37,31,688
56137,1141,583,0,23,9,0,8,5,558
49347,1307,660,30,49,25,11,52,22,647
35126,20825,9912,120,423,285,118,713,306,10913
35476,7473,3105,68,189,108,15,343,64,4368
35672,6189,3012,50,142,60,26,111,159,3177
46748,5228,2576,0,160,60,65,145,87,2652
49782,562,285,8,3,21,4,2,13,277
34986,26317,12297,68,389,263,0,725,270,14020
36351,3410,1784,4,133,56,5,120,49,1626
15711,412,216,0,7,0,0,16,4,196
31649,1096,593,0,104,6,0,46,5,503
32547,33339,16645,286,1086,240,330,1076,514,16694
32771,54980,26192,345,2796,374,199,2519,976,28788
33043,4928,2542,6,93,77,28,203,86,2386
23970,8205,3789,23,89,98,54,277,107,4416
8735,3874,1875,18,62,70,0,40,70,1999
22824,6622,3330,18,200,54,19,177,134,3292
29566,17603,8505,16,338,384,219,297,526,9098
36568,67,9,0,0,0,0,0,0,58
36616,8,0,0,0,0,0,0,0,8
36769,2830,1333,28,58,28,48,50,26,1497
24380,2600,1397,11,65,27,0,50,13,1203
25048,59,48,0,0,0,0,0,0,11
901,6536,3540,77,373,58,12,171,105,2996
965,7314,3653,27,185,92,62,256,144,3661
2649,14101,6740,12,260,219,100,359,199,7361
44481,9617,5062,37,216,180,119,242,146,4555
46552,6846,3503,19,186,83,54,192,148,3343
46815,28548,13409,222,676,249,320,1029,406,15139
31771,6204,3198,23,265,32,123,229,83,3006
3262,899,462,0,7,4,5,23,30,437
3291,106,26,0,0,0,0,0,0,80
6481,1214,537,30,33,20,10,32,19,677
7801,25026,12523,243,883,171,220,912,274,12503
949,73891,34526,465,2412,650,532,2603,785,39365
16911,407,216,5,3,1,0,0,5,191
31749,2649,1421,0,48,0,25,74,13,1228
23462,63659,30129,387,2257,431,682,2404,802,33530
10031,60254,30567,409,2238,523,239,2290,936,29687
18087,508,249,25,14,12,8,14,8,259
13308,3106,1547,20,86,70,22,106,16,1559
28574,18116,9228,118,516,105,97,471,48,8888
27214,10773,5503,100,370,115,9,567,147,5270
27310,7290,3506,12,157,37,28,178,148,3784
27981,1832,874,0,36,25,0,22,28,958
28360,14931,7208,91,410,150,160,448,170,7723
80544,119,74,0,44,0,0,0,0,45
83633,706,334,0,30,8,0,17,17,372
84053,1076,487,0,19,11,8,22,11,589
63755,25354,12266,50,826,389,133,726,427,13088
64667,383,239,0,43,2,5,2,15,144
72457,184,70,0,13,0,0,20,7,114
72847,2405,1196,6,42,18,5,74,94,1209
68736,635,315,5,10,6,0,20,18,320
78361,5386,2629,41,93,39,72,211,64,2757
78579,5642,2722,29,145,38,24,76,41,2920
71377,115,90,0,27,0,0,0,0,25
92701,53565,27695,462,2311,252,343,2131,315,25870
99681,339,190,1,4,0,6,7,2,149
93270,5542,2877,60,262,68,40,125,41,2665
61322,1454,816,14,65,7,4,84,18,638
69147,486,248,10,0,7,0,14,0,238
70726,57241,28755,402,1980,335,289,2302,729,28486
72950,335,209,0,0,17,4,0,0,126
99602,183,111,2,6,5,0,5,2,72
96112,202,69,4,3,0,0,7,2,133
32246,51275,24757,128,2141,387,299,1800,478,26518
32666,7147,3543,49,146,152,152,160,149,3604
80542,4776,2423,0,201,60,34,179,55,2353
83350,12672,6644,45,556,138,61,420,134,6028
19437,1037,541,14,15,0,0,33,0,496
86512,2889,1446,15,97,17,25,39,27,1443
13608,1544,792,5,42,13,15,23,28,752
87014,616,382,0,0,0,0,0,0,234
97123,48770,24303,348,2092,465,340,1952,616,24467
91352,47438,23289,343,1752,391,376,1355,603,24149
73078,10718,5095,108,276,87,31,427,102,5623
66042,735,386,0,16,6,39,5,28,349
67658,151,50,0,3,0,0,0,3,101
65614,596,317,0,19,11,4,6,3,279
75124,4003,2006,7,102,46,5,114,38,1997
76633,5286,2811,38,226,77,15,206,76,2475
77465,7001,3451,16,144,56,50,145,70,3550
84075,28485,14655,161,1239,240,50,1339,204,13830
51238,1168,572,4,38,14,8,18,20,596
84528,2393,1305,27,54,30,0,72,16,1088
60112,4356,2277,17,398,34,27,230,32,2079
49099,5477,2684,27,177,128,0,80,64,2793
60436,18945,9564,167,527,173,81,637,160,9381
78255,14703,7764,94,552,98,127,648,228,6939
63304,41277,20495,244,1406,373,102,1382,529,20782
64101,278,271,0,33,0,0,0,0,7
22101,29296,14422,75,519,330,26,558,473,14874
72758,40770,19902,166,1855,182,221,1659,334,20868
23302,268,114,0,0,0,0,27,0,154
23927,3951,1839,0,49,65,19,90,87,2112
24279,5366,3027,34,276,64,13,151,65,2339
24733,630,327,1,46,0,0,48,1,303
26167,1017,529,0,52,9,23,53,0,488
14486,370,183,9,0,6,13,8,31,187
15562,207,111,0,7,7,4,9,3,96
16882,467,263,0,0,7,0,4,0,204
17029,194,81,0,14,0,0,0,12,113
30905,7991,5531,462,109,8,68,144,0,2460
21716,5311,2636,38,235,65,41,225,27,2675
28054,37335,17423,215,864,579,128,1298,568,19912
28363,1426,761,131,0,18,14,118,25,665
18092,3135,1632,0,41,62,38,77,27,1503
11958,698,361,16,33,0,0,30,29,337
13203,16528,7823,15,516,193,57,710,182,8705
13318,1305,647,5,26,37,13,23,19,658
56069,4625,2371,53,147,25,46,90,52,2254
8316,384,155,0,22,0,8,0,0,229
8873,53686,26319,384,1698,666,410,1846,730,27367
10913,5610,2894,98,192,30,97,183,41,2716
15542,1051,583,0,31,7,0,44,27,468
15824,5253,2567,52,115,85,17,103,74,2686
16402,901,471,0,33,6,6,18,17,430
17102,7493,3575,57,251,46,18,267,42,3918
76023,6533,3173,11,195,73,37,291,76,3360
73801,15529,7783,40,558,129,104,439,156,7746
74451,4543,1948,37,127,77,37,55,59,2595
74878,1397,749,2,34,21,0,52,36,648
64781,73,38,0,2,0,0,0,1,35
65335,142,63,0,2,0,0,0,0,79
70518,13199,6578,58,712,185,108,461,161,6621
70752,776,374,0,96,59,0,7,0,402
27948,11118,5476,137,371,50,13,484,264,5642
29229,50866,22903,310,1617,184,438,2502,842,27963
55402,408,260,0,8,0,0,0,0,148
45645,2357,1172,33,33,76,0,46,31,1185
46040,11459,5948,23,473,79,0,305,151,5511
23070,381,192,0,0,0,0,0,39,189
17881,1498,763,5,38,31,5,43,20,735
18347,2449,1322,0,13,95,0,68,60,1127
19085,8961,4421,283,37,104,160,74,114,4540
10707,10316,5282,127,450,62,31,490,130,5034
27252,2509,1389,0,226,37,7,76,93,1120
27573,11158,4966,95,538,80,66,449,366,6192
55020,3750,1852,40,132,53,14,121,50,1898
55421,27998,13930,164,1079,181,130,828,322,14068
55920,7807,3764,61,294,56,21,331,87,4043
16134,3584,1826,9,88,53,11,85,54,1758
14462,519,273,4,4,4,5,8,4,246
24531,8347,4576,69,411,147,25,158,116,3771
25054,553,246,0,14,0,0,0,0,307
26273,1791,1360,24,144,0,1,7,7,431
2478,26033,12058,96,883,223,81,899,348,13975
19151,33174,14853,229,583,265,55,1167,645,18321
75169,13793,6700,84,349,233,78,330,205,7093
76837,3279,2314,31,218,74,0,27,27,965
77533,719,347,5,14,2,24,15,6,372
82435,12004,5790,56,319,172,14,284,165,6214
65640,875,331,14,21,15,0,29,20,544
67467,2500,1302,15,100,18,0,47,28,1198
67859,797,435,7,18,9,0,9,9,362
87420,12106,5894,137,290,93,81,371,144,6212
87901,6398,3171,29,181,51,3,122,145,3227
88020,667,347,0,13,6,0,25,9,320
88415,3546,1932,30,203,38,55,113,79,1614
90026,69589,35246,482,3318,359,236,3124,633,34343
78226,7109,3361,0,283,90,60,254,73,3748
72157,1362,584,0,8,26,0,21,28,778
72760,297,144,13,5,0,0,2,0,153
10462,76756,36091,375,2332,577,616,3316,873,40665
2554,10842,5498,4,509,79,72,333,210,5344
58727,264,110,0,2,10,0,0,0,154
60437,183,86,0,3,2,0,3,10,97
52214,3590,1714,21,84,70,14,106,119,1876
54180,3417,1646,12,109,19,11,87,15,1771
28694,7459,3507,24,211,131,76,271,82,3952
13783,2665,1299,0,88,41,0,76,44,1366
21771,29265,14519,246,680,272,142,730,497,14746
44217,3997,1994,52,123,36,20,104,44,2003
55401,9595,4909,22,554,198,34,325,154,4686
56758,374,209,0,3,13,0,4,16,165
61028,2051,1018,18,36,47,15,47,27,1033
61089,728,385,0,50,9,2,20,12,343
62629,13736,6595,89,571,171,128,645,150,7141
48504,27361,13248,324,676,301,156,705,391,14113
41231,1026,518,0,23,13,0,33,32,508
38626,1006,446,0,0,7,4,0,8,560
87043,4497,2072,34,75,171,0,50,135,2425
94580,29942,14976,214,1173,256,99,1142,488,14966
95234,113,51,0,17,0,0,0,0,62
6052,7859,3878,54,277,72,19,348,76,3981
6278,4363,2241,8,164,50,0,101,78,2122
29488,22056,10895,100,693,292,298,731,430,11161
24622,878,459,36,0,7,0,10,9,419
25252,1186,569,36,54,19,0,109,38,617
26202,507,230,0,0,17,0,37,16,277
38506,28476,13957,179,1094,384,270,999,325,14519
24064,4970,2490,40,95,116,9,92,90,2480
32216,38073,18157,187,1224,255,124,1269,459,19916
31907,56663,27517,467,1728,296,371,1776,1000,29146
23551,880,659,232,0,0,85,0,0,221
25169,382,232,0,0,9,0,0,30,150
25651,829,445,0,25,19,0,36,30,384
25978,583,318,15,40,0,0,0,0,265
43201,33455,18558,2968,736,100,2576,415,57,14897
43521,2742,1415,12,90,42,27,92,39,1327
53505,441,234,0,12,3,0,4,0,207
54004,2386,1241,21,70,37,12,40,29,1145
57030,2898,1462,1,80,39,25,94,75,1436
59469,158,90,0,3,0,0,3,0,68
60144,69,35,0,0,0,0,0,5,34
60409,36955,16050,255,806,212,341,1526,590,20905
44436,3695,1901,46,25,69,33,38,76,1794
44804,940,493,0,68,4,2,41,29,447
45240,27161,13184,227,526,295,65,902,317,13977
45654,1177,624,0,48,15,0,54,31,553
66424,463,216,0,30,3,0,4,4,247
68455,404,185,0,2,17,0,4,4,219
62949,833,436,8,18,14,3,23,4,397
63332,1253,656,0,45,36,1,23,17,597
48314,20606,9973,120,498,258,219,431,295,10633
48462,13958,7191,31,479,202,164,326,216,6767
62446,342,176,0,7,8,0,6,14,166
74072,1803,896,20,48,16,7,51,31,907
74569,1288,939,0,126,6,2,12,9,349
97857,584,279,0,3,6,0,9,3,305
98148,11761,5852,66,435,56,61,370,107,5909
1054,1983,1006,12,64,21,5,55,46,977
1351,2099,941,0,55,33,32,50,28,1158
35824,8645,4113,138,262,24,93,242,21,4532
37362,3528,1921,27,107,42,8,27,85,1607
98641,22,12,0,0,0,0,0,0,10
58271,612,310,7,10,22,2,11,19,302
78753,59085,31479,427,2629,211,285,2272,470,27606
65586,75,35,0,0,0,0,0,0,40
65734,3140,1642,31,22,13,9,78,8,1498
66043,11117,6565,100,512,58,78,350,112,4552
66416,588,313,3,32,5,0,28,14,275
67226,20442,9865,124,648,139,179,506,317,10577
61065,10360,5407,167,562,85,15,330,25,4953
49862,5155,3073,31,300,51,0,103,55,2082
55030,1306,699,26,42,15,15,25,13,607
57020,1479,760,7,72,11,8,76,12,719
62572,516,222,0,30,1,2,40,9,294
64470,1499,739,10,48,14,19,43,18,760
72668,236,128,0,0,14,0,0,0,108
70058,38334,18423,370,913,480,234,1238,444,19911
78152,2174,1074,0,69,40,0,115,32,1100
78664,62183,31140,417,2605,360,327,2580,662,31043
78946,1247,780,0,199,50,0,4,7,467
56466,2990,1474,22,54,28,31,75,67,1516
56661,865,453,9,16,17,0,34,25,412
58240,1128,577,16,29,21,3,30,12,551
72651,1107,648,0,99,53,0,37,41,459
51529,1697,882,0,25,29,22,51,24,815
52765,335,171,0,13,5,0,10,11,164
53949,5986,3062,27,182,129,26,195,90,2924
63780,6442,3091,24,196,90,21,186,62,3351
66026,467,242,0,11,10,0,4,0,225
66716,364,184,0,7,5,2,6,0,180
68357,361,195,0,18,1,0,7,5,166
60804,83147,41769,875,2978,406,575,2887,779,41378
61201,38385,18628,431,944,457,374,1252,512,19757
85085,22211,11138,76,920,183,142,1177,184,11073
79344,92,29,0,0,0,0,0,0,63
80134,66679,33406,269,2665,409,309,2773,709,33273
80212,19652,9207,136,1059,246,83,986,115,10445
95831,42514,19937,364,974,538,211,1252,1022,22577
95963,15043,7526,130,430,177,113,455,172,7517
97833,876,390,0,43,16,0,5,28,486
89020,1407,783,0,117,87,0,72,0,624
89434,25795,12153,154,534,378,221,968,423,13642
91335,80524,39785,655,3031,656,568,2691,1193,40739
91763,38406,18623,258,1148,297,224,1380,397,19783
77853,1160,573,0,41,29,7,25,30,587
29626,12570,6050,259,323,203,68,283,255,6520
30176,6594,3159,19,158,141,15,128,101,3435
30512,21080,10323,91,298,435,109,429,344,10757
35615,245,136,0,57,0,0,0,0,109
38720,589,278,0,44,14,0,44,5,311
44689,786,452,3,5,14,0,5,4,334
47240,21579,10831,130,604,273,131,723,241,10748
47302,26816,12913,133,532,265,189,784,305,13903
42153,525,270,0,6,5,0,11,6,255
89129,56716,27530,393,1939,397,198,2047,534,29186
98923,1265,693,33,87,43,0,25,0,572
704,8274,4001,39,140,95,107,242,148,4273
54930,1593,781,1,32,31,2,41,27,812
57272,272,183,0,19,2,0,17,6,89
57644,224,102,0,10,6,0,4,10,122
41179,7816,3829,21,285,38,110,189,114,3987
35816,13923,6587,205,287,71,413,382,117,7336
35905,6144,2838,8,168,88,0,252,127,3306
31088,54742,26342,222,1569,383,423,1755,1186,28400
48023,5119,2640,35,125,131,18,108,51,2479
48170,39658,19419,109,1255,432,164,1213,639,20239
12585,870,412,0,13,23,0,12,0,458
13456,3962,1977,0,78,22,38,89,46,1985
21714,199,118,0,0,0,0,0,0,81
22535,542,316,0,10,7,0,21,5,226
3874,8868,4396,0,189,195,0,165,241,4472
4050,282,138,0,14,2,0,15,5,144
12581,2313,1253,25,64,33,0,37,74,1060
13342,202,110,5,0,0,0,0,15,92
11010,25068,12522,240,628,373,80,633,404,12546
11105,37382,18814,180,1891,301,168,1439,353,18568
1063,592,13,4,0,0,190,0,0,579
1950,17990,8338,38,439,236,23,495,368,9652
81431,364,203,0,16,5,0,15,9,161
83468,122,72,0,0,16,0,0,0,50
92075,12624,5872,19,596,230,44,393,56,6752
92122,48438,25171,1230,1920,438,1402,1420,289,23267
86441,2404,1361,0,0,162,0,71,16,1043
89411,635,267,0,0,7,0,0,33,368
97633,1220,655,0,33,17,0,54,27,565
94514,1461,752,8,80,4,9,83,30,709
79059,701,328,0,12,7,0,23,7,373
79916,3039,2620,539,35,0,33,0,0,419
53934,4535,2353,14,116,72,18,84,89,2182
55106,58160,29484,656,1853,349,288,1960,595,28676
60636,32203,15225,311,653,322,289,1107,246,16978
60657,70052,35414,430,3461,411,406,3267,529,34638
63732,1053,549,5,93,31,5,3,57,504
14480,1063,441,0,0,0,0,0,46,622
21102,11299,5665,59,422,117,103,241,195,5634
4001,2565,1383,25,66,91,7,42,46,1182
15693,214,122,0,0,0,0,0,0,92
16935,1278,611,0,18,16,8,40,28,667
8007,5020,2477,23,157,22,24,253,72,2543
8561,320,134,0,19,0,0,32,0,186
909,4989,2310,0,260,52,35,181,120,2679
27244,15535,6852,526,200,114,868,199,154,8683
27827,58,29,0,0,0,0,0,5,29
10020,0,0,0,0,0,0,0,0,0
48419,2349,1151,14,83,32,11,74,21,1198
49033,1596,740,12,43,27,13,42,26,856
41659,405,190,41,0,0,0,0,0,215
43068,55225,26901,239,1794,292,251,1953,745,28324
51534,9228,4562,43,314,102,131,380,175,4666
53295,181,163,0,19,0,0,0,0,18
38326,2439,1152,0,18,41,0,51,72,1287
55343,25185,12159,103,998,334,138,830,264,13026
57212,2049,980,12,106,25,8,72,19,1069
57401,32900,16159,399,974,348,207,1098,407,16741
36026,1002,513,0,8,6,28,12,11,489
49707,21897,10800,96,630,285,92,660,368,11097
50312,16173,7676,44,556,138,35,657,210,8497
39339,14464,7180,110,461,144,135,370,217,7284
47406,3786,1756,81,8,0,57,14,0,2030
48860,1729,1016,4,34,8,3,33,30,713
56321,1512,1458,146,16,3,0,1,0,54
58060,1170,616,4,35,29,13,19,9,554
51242,217,108,0,6,3,2,13,6,109
36028,1674,749,1,18,53,0,43,15,925
3037,4355,2178,22,66,60,40,81,54,2177
93064,0,0,0,0,0,0,0,0,0
91303,31053,15962,136,1742,144,185,1053,160,15091
95677,25279,12249,231,877,222,330,868,267,13030
97133,4286,2097,40,80,84,23,98,55,2189
98501,41669,20222,141,1212,604,182,1453,549,21447
85631,3771,1878,155,10,71,18,195,77,1893
77625,10025,5053,0,44,63,41,348,119,4972
86545,1373,641,7,24,11,19,52,25,732
87941,903,367,59,11,0,0,27,0,536
92003,5042,2703,9,53,58,0,86,83,2339
14125,3733,1966,20,120,41,31,121,67,1767
7851,65,34,0,0,0,0,0,3,31
8217,25,15,0,0,0,0,0,0,10
10545,129,129,0,10,0,0,0,0,0
12120,623,274,0,25,23,18,29,7,349
6106,37819,18155,445,1254,199,484,1301,346,19664
15712,207,100,0,9,0,0,14,0,107
43732,1448,776,1,28,54,0,30,4,672
26411,931,477,19,135,7,0,17,12,454
27545,27186,12810,204,1115,286,152,1101,350,14376
27936,994,453,0,29,5,24,38,36,541
49284,3131,1664,31,75,31,7,114,48,1467
6903,14472,7165,98,291,99,103,245,299,7307
11753,12596,6217,33,258,138,19,376,246,6379
12574,405,275,0,0,7,0,10,0,130
13409,2519,1243,12,78,40,13,79,45,1276
22567,3079,1589,18,92,108,31,53,57,1490
23456,54216,27119,273,1979,611,280,2096,656,27097
23942,1353,674,43,35,61,0,64,20,679
2892,5186,2494,1,178,38,25,169,82,2692
3746,267,124,0,10,9,0,0,6,143
14435,2750,1395,0,62,30,18,36,41,1355
77990,878,429,0,37,9,0,22,0,449
78005,668,331,0,60,0,0,54,38,337
64739,914,455,20,18,0,6,45,20,459
65048,164,107,0,11,0,0,0,0,57
19330,5442,2718,67,135,86,16,147,65,2724
24435,2282,1105,0,35,69,15,46,14,1177
24474,429,227,0,11,3,0,10,0,202
25976,2462,1108,20,13,30,47,68,64,1354
5491,5803,2777,37,144,83,34,153,98,3026
8068,7181,3438,133,154,50,25,203,138,3743
10984,2780,1324,32,59,21,17,76,64,1456
12040,163,48,0,0,8,0,0,23,115
23438,1771,945,26,24,30,10,51,29,826
15205,22321,10830,55,748,312,97,827,349,11491
3886,2070,990,25,51,43,0,50,50,1080
25530,5663,2924,88,240,60,69,214,45,2739
25701,20875,10364,286,555,237,184,509,152,10511
43031,13408,6653,94,424,243,78,473,170,6755
43316,5869,2888,10,172,93,74,217,56,2981
43725,19592,9435,145,572,163,97,490,361,10157
45341,3857,1878,12,98,102,30,215,71,1979
45651,6019,3119,36,166,86,51,197,86,2900
29483,81942,39094,452,2427,615,250,3111,1216,42848
30454,680,299,0,0,83,0,42,0,381
31021,28391,13465,209,880,341,182,994,280,14926
27340,41,10,0,0,0,0,0,0,31
27344,18798,9201,18,538,202,210,536,263,9597
28356,4890,2489,0,166,24,0,163,85,2401
95915,0,0,0,0,0,0,0,0,0
97731,348,189,0,0,0,0,43,11,159
83322,25,10,0,2,0,0,2,0,15
84642,3662,1914,12,110,28,27,87,36,1748
85748,18372,8836,109,299,302,58,527,309,9536
75707,14157,6651,111,327,122,127,338,189,7506
77388,49487,24117,456,2156,432,338,1651,648,25370
77473,90,34,0,0,0,0,11,0,56
93704,29294,14424,209,699,323,88,544,343,14870
86507,2217,1034,20,91,24,24,49,19,1183
92027,56811,29023,284,1564,463,494,1854,416,27788
63822,2762,1297,25,44,42,6,47,42,1465
64102,0,0,0,0,0,0,0,0,0
65337,2055,1017,8,84,31,20,103,27,1038
66434,4774,2302,3,162,28,14,109,89,2472
66770,1124,489,0,10,32,10,0,4,635
61501,1534,871,7,72,10,4,64,32,663
54603,13868,7557,115,539,198,60,479,139,6311
77471,41139,20772,237,1294,301,183,1341,377,20367
79029,15984,8230,85,334,70,83,370,141,7754
67349,1036,509,0,49,13,20,39,38,527
74577,218,88,0,3,0,0,4,0,130
76309,13695,6625,90,438,161,86,362,185,7070
63932,1306,726,0,18,0,31,0,18,580
72079,760,298,0,0,8,0,43,10,462
72749,122,85,0,0,0,0,0,0,37
84665,524,318,16,31,0,0,15,5,206
88119,1976,1015,0,106,29,8,60,15,961
94720,2971,1402,104,0,0,162,0,0,1569
96040,178,72,0,0,0,0,0,0,106
97020,1008,522,7,31,21,7,33,11,486
50568,1686,874,20,50,9,7,27,26,812
67451,1115,516,0,31,5,0,13,10,599
67640,627,318,2,15,3,0,12,4,309
68351,886,458,4,16,8,0,19,2,428
67009,1005,485,3,39,10,0,31,14,520
53085,11466,5569,55,277,186,55,243,310,5897
59916,169,83,0,4,2,0,3,0,86
17857,7380,3399,41,206,104,0,252,87,3981
11232,27602,14304,99,1448,112,133,1252,220,13298
12998,363,202,0,0,0,0,0,0,161
7827,4078,2156,46,81,48,12,109,101,1922
68777,649,326,0,9,40,0,5,12,323
62433,927,465,0,24,38,0,39,23,462
77493,32257,16027,273,973,220,57,1261,459,16230
72732,4515,2249,25,188,99,20,136,66,2266
72853,1771,812,0,63,15,0,74,36,959
85363,6747,3442,62,286,34,11,319,48,3305
65258,437,220,0,1,3,0,13,0,217
93546,9359,4637,155,416,74,0,342,91,4722
93907,22766,11291,143,633,327,128,630,380,11475
95247,4270,1935,36,80,70,13,53,141,2335
98853,16,8,0,0,0,0,0,0,8
87515,363,115,0,0,26,0,0,0,248
3240,1220,662,6,26,19,0,13,17,558
4992,142,0,0,0,0,0,0,0,142
6480,9362,4361,8,250,167,19,298,94,5001
7070,18427,8642,78,829,192,93,777,338,9785
2038,33022,16053,96,866,415,229,1223,422,16969
32008,4538,2400,0,148,6,51,146,68,2138
15772,1651,830,3,26,21,4,26,26,821
15823,1302,630,3,49,25,24,55,32,672
16734,270,144,0,2,0,0,8,2,126
24609,7172,3392,19,256,100,55,221,131,3780
25827,1983,989,0,43,19,0,0,0,994
26261,2496,1221,1,67,4,15,18,94,1275
18201,27182,13292,270,877,121,117,957,235,13890
18413,182,61,0,8,13,0,0,7,121
18518,8038,3934,37,132,87,20,290,154,4104
18920,373,213,0,0,0,0,0,14,160
4415,269,124,0,22,11,0,32,6,145
95375,5,5,0,0,0,0,0,0,0
87832,150,57,0,0,28,0,0,0,93
97122,351,194,0,0,0,0,0,0,157
93066,3112,1646,24,64,28,7,52,58,1466
99212,19895,10030,76,706,237,59,513,341,9865
65772,1762,870,6,52,30,3,68,39,892
68123,31990,16086,302,1164,226,241,1153,294,15904
68955,2117,1055,8,75,32,0,97,28,1062
83651,34354,17211,268,897,255,405,1136,302,17143
84108,22433,11040,138,666,237,259,837,237,11393
85337,2669,1358,37,190,30,18,65,19,1311
76577,3052,1557,20,71,18,0,66,22,1495
71037,18200,8898,43,681,196,128,699,253,9302
35752,2680,1052,10,88,46,52,42,39,1628
49459,1453,734,11,36,30,0,44,23,719
50444,387,173,0,11,8,0,7,6,214
77640,15796,7660,104,431,164,214,442,266,8136
59529,188,97,3,0,3,0,5,2,91
22488,1084,583,0,26,44,0,34,0,501
4071,5152,2363,74,128,93,70,132,118,2789
59544,231,122,0,8,0,0,13,3,109
45133,23764,11660,129,677,259,138,688,339,12104
29414,39520,19225,163,1657,454,106,1576,551,20295
15071,10348,4974,30,370,112,52,334,136,5374
15801,18953,9305,39,654,264,169,483,299,9648
45356,25209,12499,166,765,294,173,976,406,12710
32656,14433,7169,97,422,177,194,374,196,7264
33543,26172,12526,179,974,196,168,1191,347,13646
22408,30126,14613,110,957,246,219,1222,279,15513
17867,119,58,0,3,0,0,0,0,61
19702,55192,27047,353,1807,472,184,2000,752,28145
26435,117,77,0,0,0,0,0,0,40
27101,19681,10086,99,538,207,96,715,300,9595
13162,560,286,0,0,0,38,0,0,274
3304,7837,3961,16,227,69,45,247,115,3876
5058,266,119,0,7,7,0,18,0,147
5774,1035,509,9,15,28,18,6,10,526
8087,24953,12357,169,537,284,101,857,441,12596
1960,52564,25246,366,1451,508,357,1140,724,27318
2129,19414,8754,33,770,142,37,976,216,10660
47525,276,151,0,0,0,0,9,0,125
47580,427,192,0,18,15,0,15,0,235
47952,3056,1497,0,96,25,10,45,51,1559
48138,10179,5055,23,158,184,45,241,162,5124
31089,4695,2224,13,120,44,57,165,56,2471
80236,18795,9680,202,471,146,84,605,320,9115
81522,131,66,0,0,0,0,0,0,65
82325,985,512,0,20,1,0,16,13,473
71855,587,336,0,0,12,7,11,3,251
72013,2180,1133,26,69,10,0,116,21,1047
72359,462,201,0,0,0,0,31,7,261
67756,1905,900,5,10,36,0,63,42,1005
74948,11862,5583,82,387,194,84,283,197,6279
75204,30797,16363,201,1587,227,135,1223,150,14434
75770,3223,1533,33,136,34,19,95,54,1690
18831,1487,699,5,24,51,5,53,32,788
21402,6409,4525,1031,11,4,341,17,9,1884
1757,28862,14309,159,927,381,223,930,340,14553
4551,797,377,3,5,15,7,7,13,420
4607,1199,598,0,27,50,9,20,27,601
10469,73870,34385,473,1746,991,493,2310,1124,39485
11362,18721,8786,64,724,246,105,604,339,9935
17022,30556,14406,320,1037,215,330,864,364,16150
676,36995,18045,225,1096,333,185,1223,668,18950
44077,56353,27597,508,1569,649,457,1571,817,28756
44240,39536,19965,689,1273,306,798,1145,447,19571
39741,1662,861,27,91,13,0,85,3,801
33709,25455,12525,150,676,347,147,710,529,12930
40075,966,535,5,9,30,0,52,0,431
50158,30902,15551,236,789,227,205,974,462,15351
64682,428,207,0,7,2,4,10,0,221
67363,98,47,0,0,7,0,0,9,51
62612,1799,875,6,50,24,8,31,28,924
61067,752,376,11,2,9,0,6,53,376
74501,28016,14674,141,1101,279,107,822,372,13342
54493,613,328,6,10,5,0,20,11,285
54498,2457,1253,11,65,14,39,54,25,1204
54515,448,231,1,7,9,1,13,13,217
56296,1948,987,33,58,19,1,52,33,961
56470,10592,5191,13,280,200,22,223,154,5401
56016,933,519,3,47,16,3,35,11,414
30475,0,0,0,0,0,0,0,0,0
32504,23080,10821,171,578,122,354,494,339,12259
32736,9922,5093,71,175,142,11,286,163,4829
44705,19451,9339,144,483,190,51,577,189,10112
34684,28784,13384,158,765,365,117,835,534,15400
34947,13188,5777,123,289,71,46,512,139,7411
34951,15978,7798,22,506,254,91,351,195,8180
42266,2138,1137,20,93,35,0,57,35,1001
47568,720,329,0,18,10,3,14,2,391
48189,14035,6963,93,362,164,141,365,256,7072
48896,392,154,0,3,0,5,17,0,238
49346,5703,2863,5,124,89,3,164,95,2840
14782,2435,1193,3,80,8,15,59,20,1242
23882,1651,807,6,10,27,0,44,30,844
24243,1984,1072,0,83,23,13,31,8,912
24931,1348,722,0,10,0,0,63,68,626
25514,3470,1681,16,16,65,15,125,60,1789
18103,46333,22927,139,1491,490,184,1381,842,23406
12066,1784,888,4,19,19,0,56,47,896
28025,54829,27522,221,1594,557,455,1840,726,27307
58758,234,122,0,0,0,0,0,0,112
58778,180,82,0,3,0,0,3,6,98
61006,1905,913,21,13,33,3,45,27,992
61317,479,271,12,10,3,7,15,8,208
77360,5036,2573,13,97,68,71,48,115,2463
46802,10235,5768,104,436,97,93,150,111,4467
46804,28780,13433,156,845,303,50,714,475,15347
50703,18978,9524,131,727,163,123,699,226,9454
38501,38376,18981,423,917,369,976,1174,434,19395
38921,4188,1687,13,91,97,9,194,34,2501
53108,3270,1628,0,109,47,0,50,46,1642
53522,1050,539,3,38,19,8,28,18,511
28763,2758,1324,0,130,14,0,125,35,1434
27526,47425,22577,199,1524,353,235,1613,505,24848
30752,8463,4198,22,218,149,14,217,92,4265
24502,45406,21317,1152,860,213,1559,981,427,24089
28435,2058,1129,36,14,50,0,69,15,929
20777,3616,1917,0,77,66,14,89,70,1699
90059,45952,22119,399,1264,215,374,1553,393,23833
95942,629,370,0,0,20,0,22,12,259
96761,23223,11904,52,672,301,156,910,203,11319
7846,35,19,0,0,0,0,0,0,16
8065,7223,3524,20,187,65,5,227,134,3699
8089,4195,2124,14,96,45,24,101,70,2071
11204,76978,38466,498,2657,798,277,2495,869,38512
4355,2553,1343,9,83,40,3,54,28,1210
27410,55519,25433,307,1561,599,340,2223,626,30086
35094,14438,7510,59,516,91,15,470,149,6928
35803,25710,12391,106,516,303,227,704,333,13319
37848,215,129,0,16,0,0,28,0,86
23192,6830,3298,20,230,80,0,143,135,3532
30549,24892,12036,137,849,193,6,935,290,12856
20782,32553,15962,150,1480,297,246,1587,288,16591
24271,2456,1197,0,20,9,2,19,18,1259
78873,1908,872,0,43,27,41,28,40,1036
79031,1469,741,25,32,27,0,32,0,728
80138,33603,16882,157,925,300,299,1197,514,16721
81092,766,386,0,35,3,0,18,9,380
71328,6553,3099,25,256,94,53,230,57,3454
96052,1493,864,26,51,37,16,18,21,629
96097,9647,4555,67,360,160,43,300,120,5092
90089,3862,1842,96,0,0,123,0,0,2020
76033,26310,13257,224,722,230,211,760,276,13053
76374,3906,1857,12,103,80,65,172,67,2049
77365,34781,17465,232,1070,245,171,1183,404,17316
42083,291,134,0,30,0,0,20,0,157
63566,120,63,0,7,0,0,0,0,57
57450,574,281,0,21,12,0,17,5,293
58013,130,72,0,0,0,2,0,7,58
46911,1308,641,6,37,18,3,23,52,667
47031,5353,2707,0,128,37,7,234,88,2646
47341,2339,1237,0,64,13,7,71,32,1102
47346,3945,2022,6,116,84,61,114,37,1923
47557,1803,957,3,85,28,0,88,9,846
49802,6137,2910,6,129,80,48,157,81,3227
68413,570,281,0,21,18,0,21,2,289
69027,28,15,0,0,0,0,0,0,13
69044,791,440,8,41,5,3,7,6,351
59639,1118,610,0,11,21,0,25,29,508
60175,25734,13277,298,597,260,127,455,381,12457
60523,10136,4653,8,74,260,31,140,117,5483
60618,94395,48151,474,4543,669,434,4370,802,46244
56461,3346,1823,5,97,57,9,110,65,1523
58535,662,361,1,10,10,0,16,22,301
70052,3787,1802,30,15,17,0,91,48,1985
1588,9775,4697,18,358,81,77,404,109,5078
1985,4581,2379,0,85,83,18,158,50,2202
90723,54776,27261,402,1675,449,555,1918,312,27515
89019,2376,1192,0,19,14,0,28,31,1184
94946,694,322,0,16,24,0,18,11,372
39153,3868,1692,0,72,14,0,236,89,2176
39345,5935,2705,17,207,65,3,198,50,3230
40144,1446,683,13,55,0,0,59,0,763
31627,247,133,3,7,4,0,11,3,114
33025,71763,33277,374,3161,597,429,3326,791,38486
33161,55663,26445,478,1705,458,574,2123,695,29218
63104,19913,9428,57,718,137,185,557,257,10485
63341,3663,1700,0,56,105,16,80,91,1963
70607,27268,13214,421,739,218,211,1008,380,14054
71269,12706,6186,62,527,165,78,500,139,6520
56510,2330,1108,8,76,25,7,76,35,1222
50206,483,249,15,13,12,1,18,21,234
50169,3108,1161,8,51,22,6,221,30,1947
53045,21509,10280,106,530,266,57,634,351,11229
53588,4084,2070,15,103,65,11,105,59,2014
34289,3734,1754,0,81,81,0,75,112,1980
39565,19704,10140,51,524,242,73,742,409,9564
40207,30523,14595,148,1055,337,70,966,484,15928
47909,42532,21281,476,1277,256,394,1549,622,21251
42716,1578,719,11,24,0,9,128,11,859
18832,1855,934,2,30,33,25,32,39,921
21225,33927,16328,377,1116,218,85,1303,469,17599
28379,24403,11724,164,476,267,121,653,346,12679
93535,72948,36037,621,2053,434,610,1986,899,36911
93592,77,40,0,0,6,0,9,0,37
58573,579,305,0,10,11,0,14,4,274
59863,38,18,0,0,0,0,0,6,20
60963,1895,916,24,78,23,15,70,39,979
62249,15507,7873,100,547,235,65,486,226,7634
74901,1872,919,6,62,27,5,52,38,953
76148,23586,11648,231,814,240,138,770,289,11938
56601,34281,16975,442,945,360,420,855,508,17306
57764,2021,1043,23,70,0,33,53,0,978
84340,3755,1768,15,118,26,32,163,63,1987
99763,597,350,6,9,3,6,10,0,247
97326,1112,594,0,14,9,11,11,53,518
83226,1951,1011,14,52,20,0,45,28,940
83333,10398,5239,64,484,91,0,271,117,5159
89408,19951,9948,60,584,292,53,492,219,10003
89523,34675,16839,258,1161,370,151,1112,551,17836
90814,18587,8640,111,526,157,48,678,181,9947
92304,21,21,0,0,0,0,0,0,0
94503,20306,10091,105,642,134,196,729,220,10215
14722,269,118,12,3,0,6,0,0,151
29828,689,304,0,5,6,0,43,21,385
14846,743,377,3,14,10,2,6,11,366
37415,23967,11123,132,860,300,169,781,312,12844
16132,352,201,0,0,0,0,0,0,151
17053,4812,2331,29,114,68,11,102,119,2481
34442,13953,7073,61,157,224,40,266,373,6880
43214,26229,12949,201,992,304,58,1003,375,13280
43607,21117,10194,760,462,170,331,558,300,10923
34498,576,278,3,22,25,0,20,15,298
90037,65016,32005,699,2317,409,344,2289,683,33011
90706,77529,38057,623,2903,563,602,2611,836,39472
91731,30139,15371,222,853,403,257,813,296,14768
94940,234,102,0,0,0,0,0,17,132
98364,95,47,0,0,0,0,0,0,48
98592,1570,790,0,0,39,0,0,0,780
99830,595,329,0,33,2,0,16,2,266
85923,469,237,0,0,6,0,17,0,232
80621,12732,6762,83,367,80,68,429,169,5970
2740,43604,20504,329,1059,423,387,1294,735,23100
39078,873,427,0,4,16,0,91,18,446
56226,218,121,2,15,2,0,9,3,97
56567,3341,1683,27,83,37,4,112,33,1658
57001,1581,835,15,44,24,3,44,21,746
57319,782,401,1,5,8,8,18,21,381
55719,5923,2974,0,109,78,40,178,150,2949
50846,924,443,0,41,13,4,21,21,481
62863,9824,4799,80,232,117,35,247,160,5025
64075,12449,6155,36,276,219,127,373,191,6294
32836,20154,10286,117,585,136,87,820,218,9868
20115,6911,3270,0,152,135,44,184,152,3641
20603,31401,14476,311,946,274,154,1020,459,16925
21810,765,309,0,72,44,0,46,56,456
22811,628,325,0,36,20,0,15,0,303
23461,430,315,59,0,0,31,0,0,115
23962,472,229,12,0,13,0,0,1,243
14826,2000,979,8,66,15,0,63,18,1021
15203,9777,5222,223,278,85,255,140,178,4555
15934,295,181,0,0,0,0,14,0,114
16148,16233,7884,45,326,402,113,368,248,8349
17372,4409,2133,10,122,78,22,133,62,2276
33834,7695,4719,102,366,53,65,156,29,2976
36371,597,282,10,42,12,3,15,15,315
19013,35345,17511,363,943,191,341,691,447,17834
28163,5469,2843,18,175,53,31,100,30,2626
95714,440,200,5,8,4,0,17,6,240
96085,85,41,0,0,6,0,0,12,44
99133,1576,820,8,39,10,8,30,49,756
93668,1173,629,0,18,7,0,64,0,544
16506,24118,11671,109,713,304,96,522,271,12447
18072,6502,3023,69,173,69,17,198,44,3479
19033,8882,4354,88,448,40,13,165,197,4528
33426,23155,10668,141,719,90,248,745,509,12487
33616,16145,8080,86,574,105,85,756,159,8065
33855,0,0,0,0,0,0,0,0,0
36111,12369,5699,48,220,89,112,452,200,6670
6811,32388,16520,158,1173,318,226,983,514,15868
8844,39520,19134,119,1080,351,327,1396,566,20386
12473,785,490,0,0,0,0,10,0,295
47879,3417,1620,98,34,44,49,105,8,1797
49319,16886,8550,177,698,195,43,608,247,8336
50447,1304,634,9,54,21,5,37,15,670
78629,12047,5984,50,280,64,101,427,134,6063
81201,9161,4769,57,222,163,28,193,235,4392
82640,46,22,0,0,0,0,0,0,24
95565,772,402,11,4,13,30,30,0,370
77379,79986,40056,193,3500,968,145,2964,1151,39930
77859,6822,3325,53,349,60,20,89,142,3497
83548,127,69,0,7,3,0,0,0,58
65720,876,458,13,16,18,0,19,5,418
68731,2813,1464,66,53,25,31,79,41,1349
76389,1413,742,0,35,44,0,16,23,671
76448,5547,3011,176,383,30,0,215,35,2536
85040,35358,17403,324,972,178,251,1030,247,17955
59745,85,47,0,0,2,0,0,3,38
61013,504,229,0,16,4,14,7,23,275
61252,5341,2729,48,171,78,9,123,96,2612
59250,172,87,0,0,1,0,0,1,85
64453,191,101,0,10,11,0,0,0,90
72482,1106,562,19,33,14,0,36,4,544
73741,1712,1355,5,318,26,2,6,13,357
23669,41669,19836,523,1026,442,483,1165,616,21833
24082,659,283,0,0,9,0,17,10,376
24083,3334,1585,0,106,16,0,59,20,1749
25812,1725,983,15,83,51,0,61,5,742
15610,3746,1834,17,80,97,11,67,117,1912
16024,258,133,0,9,0,1,3,4,125
31014,13265,6123,150,218,133,136,495,161,7142
33050,9433,5208,44,309,178,97,224,160,4225
28367,67,32,0,1,5,0,4,0,35
17535,2655,1236,18,60,29,8,78,20,1419
17721,1537,753,12,64,18,64,51,14,784
18901,27469,13479,372,546,318,148,586,279,13990
19003,13565,6200,93,588,139,105,528,122,7365
29461,37133,18501,364,1010,616,246,1300,624,18632
53939,241,133,1,10,0,0,7,1,108
36867,22983,10908,284,567,168,167,572,187,12075
10280,9384,4477,0,457,84,0,488,80,4907
10931,1017,477,5,16,7,12,44,3,540
11598,13715,6693,195,485,235,75,436,154,7022
16668,3293,1623,36,46,70,5,91,69,1670
77096,33769,16640,159,1508,249,141,1392,346,17129
66087,1960,1015,11,35,46,14,49,46,945
66734,209,103,0,0,0,0,0,0,106
66962,306,158,0,11,5,0,2,3,148
68666,1506,715,4,52,13,6,29,31,791
73551,66,31,0,0,0,0,0,5,35
43323,699,393,2,3,10,0,19,12,306
44146,29223,13416,251,843,320,181,801,487,15807
62535,3003,1457,32,110,36,35,91,77,1546
65082,1149,590,14,13,9,0,45,14,559
70526,17989,8792,161,811,206,129,569,211,9197
71411,3184,1607,0,113,48,9,109,81,1577
27617,18856,8686,72,773,112,91,942,303,10170
27954,7389,3833,8,340,91,30,218,82,3556
27972,70,36,0,10,0,0,0,0,34
54442,1160,672,12,13,16,2,23,15,488
54880,29958,14694,229,924,418,259,957,475,15264
55374,15078,7181,69,597,70,42,645,141,7897
50254,279,148,0,13,5,0,5,6,131
50434,356,184,0,7,0,0,15,3,172
51026,719,347,0,9,13,0,45,6,372
52577,15247,7656,93,460,150,57,502,256,7591
85603,6770,3215,25,127,162,100,100,221,3555
95552,659,331,0,15,14,0,19,18,328
79835,10810,5528,106,438,117,131,348,65,5282
13849,4334,2196,57,88,35,0,90,82,2138
15722,2323,1186,21,66,28,15,93,37,1137
15936,1326,710,0,61,28,9,26,21,616
16943,488,266,7,11,5,0,4,0,222
2910,22143,10425,148,610,219,48,804,303,11718
12843,420,213,0,0,11,0,6,0,207
18977,4136,2134,0,61,115,22,60,134,2002
38004,10614,5234,66,447,53,61,600,123,5380
40769,18075,8566,209,343,166,192,467,225,9509
31542,3170,1804,35,96,37,11,58,59,1366
45001,759,413,6,36,0,6,23,13,346
45169,4513,2196,39,143,53,0,174,61,2317
34472,31632,14944,117,815,293,220,803,366,16688
37370,4962,2435,22,149,68,88,249,76,2527
41366,27,27,0,0,0,0,0,0,0
43080,5254,2669,44,183,40,0,108,97,2585
29069,4393,2049,37,82,65,46,146,81,2344
49328,4055,2104,17,94,69,14,87,56,1951
96039,907,437,13,12,7,4,10,24,470
97835,276,137,1,11,8,0,12,1,139
80909,39119,19475,338,1138,447,364,1045,526,19644
81064,269,128,0,6,9,2,14,3,141
82063,214,100,0,0,0,0,0,0,114
82324,227,128,0,14,0,0,3,0,99
85050,30647,15009,113,1108,121,67,1249,419,15638
76525,1082,522,0,33,22,0,42,18,560
76657,9897,5045,113,361,102,156,304,231,4852
77024,38379,18738,224,775,339,163,1079,487,19641
77961,303,127,0,38,0,0,0,0,176
56678,1201,625,5,36,15,0,29,18,576
58353,113,67,4,13,0,0,0,0,46
49779,4541,2191,31,101,89,47,121,75,2350
54013,3474,1738,9,123,43,30,93,51,1736
45107,9909,4731,25,438,87,59,327,160,5178
46958,594,378,0,37,0,0,19,0,216
48144,9509,4823,58,257,136,14,291,118,4686
30725,4646,2343,0,223,89,95,123,45,2303
44452,3444,1713,22,120,0,20,18,97,1731
22903,40507,20151,1106,1019,302,1283,976,350,20356
23110,590,252,0,59,0,0,42,29,338
23518,29723,15071,189,1285,363,223,1082,445,14652
27243,4431,2054,5,56,50,13,121,70,2377
28092,39710,19532,266,1163,578,278,1065,527,20178
31051,140,68,0,3,0,0,6,0,72
31079,2161,945,0,51,21,11,104,23,1216
31532,650,314,15,7,2,15,13,14,336
24867,434,143,0,0,0,0,0,0,291
25565,511,295,0,0,0,0,38,14,216
25836,555,401,0,0,0,0,0,0,154
75143,14304,6882,32,318,193,34,402,112,7422
80466,3739,1841,23,108,32,21,64,90,1898
80477,130,66,0,0,0,0,0,0,64
95251,582,267,34,0,13,0,0,40,315
15559,1800,922,7,24,24,7,50,35,878
6475,10118,4702,32,199,68,19,247,261,5416
7040,24471,11894,98,810,271,7,874,208,12577
10022,31125,14113,28,1178,526,94,1244,533,17012
10171,0,0,0,0,0,0,0,0,0
20751,2240,1163,26,38,51,0,41,68,1077
25112,105,47,0,0,0,10,0,0,58
14001,9549,4927,60,204,104,19,221,193,4622
4490,266,132,0,0,7,6,0,10,134
74354,17926,8724,141,477,129,113,533,245,9202
75453,2878,1472,6,98,13,0,91,38,1406
77703,13809,6567,90,476,152,109,340,108,7242
80914,443,331,77,6,0,18,0,0,112
81610,320,184,0,18,0,3,5,7,136
84078,30202,15510,153,934,171,130,1029,192,14692
85033,65759,32103,667,1983,223,582,2377,504,33656
95386,10587,5347,158,331,155,81,406,78,5240
95838,39187,19339,389,1194,300,318,1412,319,19848
87573,38,25,0,0,0,0,0,0,13
99627,308,154,2,9,4,2,2,3,154
30161,34286,16457,298,872,362,173,971,387,17829
30337,13768,6574,66,347,92,121,453,96,7194
31407,12808,6714,0,461,178,0,695,43,6094
36373,410,180,27,0,11,0,0,0,230
37118,1033,575,0,0,24,0,0,15,458
37379,27532,13752,171,742,354,160,812,601,13780
45148,1467,800,39,61,12,0,27,22,667
41568,738,258,0,0,0,0,27,17,480
5252,250,109,0,4,0,0,0,7,141
6021,325,186,5,18,3,10,5,7,139
6418,12669,6006,31,489,93,27,320,260,6663
957,38915,18015,280,704,352,363,1073,589,20900
24549,4059,2101,20,148,33,0,154,44,1958
18640,17218,7749,90,391,170,75,402,177,9469
30260,25487,11807,204,695,224,416,974,232,13680
91406,55215,28466,297,2316,496,204,2069,495,26749
92382,4709,2338,14,151,39,8,154,0,2371
94019,20314,9657,29,623,231,58,821,266,10657
96790,9776,4720,21,274,124,10,269,220,5056
88262,13,9,0,0,0,0,0,0,4
89156,29323,13800,182,604,240,234,831,369,15523
63034,17879,8308,135,638,309,50,553,336,9571
79039,951,434,0,28,19,0,25,12,517
76596,1317,0,0,0,0,6,179,48,1317
77561,79,34,0,0,0,0,0,0,45
83601,11,11,0,0,0,0,0,0,0
84643,411,199,0,13,11,0,15,3,212
86015,470,185,1,0,0,2,61,0,285
66858,375,195,11,1,10,10,0,0,180
56738,1453,769,0,56,19,9,36,24,684
58228,807,466,20,20,18,4,2,10,341
48829,3429,1660,17,96,37,41,75,54,1769
41007,4292,2325,9,121,51,39,42,109,1967
35774,237,110,0,0,0,19,0,0,127
43157,648,276,0,18,2,0,24,15,372
46555,2559,1381,7,71,42,0,68,26,1178
47201,44127,22406,257,1577,425,110,1768,550,21721
36758,1355,606,0,38,0,0,15,33,749
37143,4075,2018,22,225,60,7,186,67,2057
37191,3881,1954,0,146,38,10,113,0,1927
53158,16826,8242,135,442,277,174,567,361,8584
38952,432,231,0,16,7,0,20,7,201
60628,66724,30816,593,1855,612,609,1631,1031,35908
62809,144,74,0,9,0,0,9,13,70
64085,8199,3907,69,196,186,0,248,136,4292
72080,368,184,0,0,0,19,10,13,184
73841,1329,1077,0,162,4,2,0,5,252
74029,4971,2503,32,134,93,0,172,56,2468
83119,345,176,0,0,0,0,0,11,169
77803,31978,15978,299,957,237,207,1071,294,16000
66520,478,266,0,13,4,0,12,17,212
59915,391,165,0,10,3,0,34,15,226
16436,723,393,8,15,7,3,23,16,330
18966,37649,18269,243,956,399,203,1022,538,19380
13838,4284,2202,36,162,96,0,142,104,2082
14820,834,413,3,16,11,0,21,15,421
15444,369,147,0,18,14,0,0,32,222
26570,3829,1856,19,200,24,75,188,47,1973
30602,2824,1035,113,0,0,124,0,0,1789
32669,13098,6830,88,363,105,61,635,332,6268
33980,13336,6129,99,309,130,0,250,100,7207
34228,7233,3480,9,66,202,10,31,211,3753
38579,947,452,0,37,0,0,19,34,495
40104,969,542,0,8,0,6,24,30,427
43912,6317,3192,31,149,129,23,149,112,3125
47104,38,20,0,0,0,0,0,0,18
54220,39059,18913,285,1068,657,137,1097,744,20146
49309,1567,838,5,40,47,12,32,27,729
42713,1916,878,47,25,3,6,41,4,1038
14033,1754,778,0,42,58,20,64,26,976
17057,22857,11573,242,510,269,78,657,168,11284
21835,294,178,0,0,0,0,0,8,116
23306,776,415,0,21,2,2,10,37,361
5072,480,207,0,12,7,10,3,25,273
11704,40285,19639,234,1256,467,138,1117,507,20646
75401,18869,9051,153,777,203,85,517,190,9818
77019,21319,10427,60,725,241,20,640,296,10892
83834,193,119,0,0,0,0,0,11,74
84014,17166,8326,62,578,210,34,734,334,8840
16412,10648,5411,183,334,90,314,273,174,5237
3765,471,250,0,0,26,0,13,0,221
4350,3622,1769,27,84,61,14,121,22,1853
7014,4971,2604,36,280,33,0,193,120,2367
7702,4088,1803,25,53,83,0,99,40,2285
21122,60461,29834,371,1997,732,218,1822,810,30627
21826,5331,2410,123,120,45,219,173,38,2921
23434,49556,23596,290,1383,425,229,1693,844,25960
75092,24575,11830,122,797,205,261,591,338,12745
76802,5183,2530,36,182,40,5,160,83,2653
84042,10809,5276,102,255,83,104,352,120,5533
84308,231,94,1,6,8,0,4,12,137
95660,36472,18006,272,1123,231,314,1439,462,18466
87532,18756,9280,101,465,273,100,638,278,9476
89026,0,0,0,0,0,0,0,0,0
99350,14017,6864,82,361,228,44,508,208,7153
92036,2221,1211,0,35,69,0,50,46,1010
7940,17156,8142,237,372,67,346,372,99,9014
25818,413,131,0,0,0,0,0,0,282
738,30376,14196,211,796,192,239,902,361,16180
28654,3100,1423,14,33,85,0,52,46,1677
30122,25786,12611,132,910,213,143,805,263,13175
27917,734,302,0,25,5,0,15,48,432
66854,677,380,0,25,3,9,28,3,297
69127,943,519,12,17,23,3,12,2,424
59106,17334,8475,97,550,250,64,757,203,8859
59821,2653,1342,28,106,70,17,106,47,1311
61264,10621,5037,38,294,107,45,372,117,5584
61433,107,60,0,0,0,0,0,0,47
62082,2746,1557,11,98,55,10,69,46,1189
62263,5034,2595,22,167,59,22,159,101,2439
98178,27280,13293,127,701,279,152,992,259,13987
98569,6108,2975,0,126,320,0,77,158,3133
95722,4822,2320,16,152,109,25,93,116,2502
96027,2416,1275,7,71,35,9,49,35,1141
97131,2661,1408,2,75,47,6,70,58,1253
67514,907,456,0,7,15,23,5,10,451
68758,1280,662,14,26,17,0,14,12,618
68956,1445,676,16,36,11,9,34,18,769
71115,15659,7175,55,488,162,0,546,138,8484
79092,1018,482,3,43,25,8,31,14,536
92059,1456,669,23,44,68,0,53,30,787
93424,776,418,0,14,48,0,15,0,358
95116,56481,28823,492,2126,324,265,2065,578,27658
83661,9787,4990,23,251,129,90,213,84,4797
65622,8798,4228,46,202,132,106,188,230,4570
66740,511,265,0,17,3,0,12,3,246
45871,2008,1044,12,53,7,6,72,10,964
46077,28371,13972,67,1131,203,17,1156,296,14399
46628,27159,12987,64,820,351,155,979,259,14172
48216,5179,2688,72,145,10,76,203,27,2491
37657,991,463,0,16,16,0,36,7,528
60097,10826,5811,80,320,68,38,261,166,5015
62982,960,396,0,20,33,9,30,7,564
55784,117,66,0,4,3,0,2,0,51
58076,355,231,20,0,0,21,0,0,124
52053,1132,573,2,9,63,2,17,11,559
48630,37,20,0,0,0,0,0,0,17
48806,1555,760,2,59,13,2,66,31,795
43768,497,172,2,3,2,0,83,46,325
2838,3519,1602,14,80,12,0,102,35,1917
13901,19195,9374,156,537,235,275,647,280,9821
14783,361,185,0,6,2,0,8,3,176
16627,2138,1016,21,43,37,17,67,41,1122
26215,36,19,0,0,0,0,0,0,17
22654,999,527,0,8,0,0,17,14,472
18063,544,285,0,23,24,0,40,35,259
19545,630,349,0,0,12,0,35,23,281
29409,2666,2459,428,0,0,0,0,0,207
78122,384,190,0,0,27,0,13,17,194
54625,237,134,2,6,2,9,6,7,103
59421,1696,854,0,40,30,7,43,54,842
61439,242,133,7,8,7,0,10,1,109
65347,629,336,7,34,2,0,13,3,293
68063,255,127,0,1,0,0,5,1,128
71858,2285,1260,0,105,33,25,23,48,1025
56556,1096,554,3,30,8,0,24,27,542
57246,195,101,1,10,4,0,8,3,94
62570,514,275,2,18,0,2,16,5,239
63939,1473,751,0,30,0,0,13,15,722
73642,135,71,0,2,2,5,2,2,64
74333,1129,593,0,34,9,9,24,13,536
50162,1335,739,4,18,8,12,26,13,596
52635,865,470,3,33,18,0,42,53,395
52742,7588,3635,56,289,92,9,204,78,3953
53574,3870,1926,4,134,55,5,125,66,1944
54232,803,393,5,20,15,12,0,18,410
56218,483,262,0,10,3,3,6,10,221
56363,180,105,2,7,5,2,7,0,75
57010,399,199,0,0,9,0,0,10,200
42166,2923,1433,54,88,0,0,88,56,1490
30581,33,18,0,0,0,0,0,0,15
46064,17493,10439,52,1009,181,49,658,196,7054
47907,0,0,0,0,0,0,0,0,0
49079,13024,6412,40,533,111,12,350,219,6612
17270,53,26,0,0,26,0,0,0,27
18054,4678,2366,107,138,104,7,75,60,2312
8319,1159,616,24,29,29,17,23,33,543
28150,27581,12943,175,823,417,184,771,450,14638
28464,2707,1184,50,31,12,58,67,13,1523
12978,303,120,0,0,0,0,0,0,183
13153,382,217,0,8,8,0,16,0,165
24595,612,59,0,20,0,117,0,36,553
24822,767,372,0,42,8,14,43,0,395
24881,329,185,0,12,11,0,31,0,144
20618,454,226,32,0,0,0,7,9,228
14304,29375,14395,89,905,340,175,728,821,14980
93013,16644,8275,48,539,266,91,559,187,8369
97812,860,426,14,17,18,0,39,24,434
1940,13484,6196,55,385,115,24,408,104,7288
2144,25277,12880,182,1195,240,81,736,228,12397
3046,2811,1449,28,107,42,18,88,21,1362
61036,6620,3161,32,139,142,17,269,131,3459
70810,39856,18515,456,1036,651,310,1180,519,21341
71956,1685,849,0,56,64,19,134,12,836
57633,427,247,2,32,13,0,16,11,180
58503,33225,16183,145,1365,376,95,1179,418,17042
58656,509,257,4,14,16,0,26,7,252
59243,245,141,0,6,10,0,4,1,104
59339,148,92,0,2,2,0,2,2,56
67401,51077,25334,465,1854,665,277,1673,659,25743
68791,1894,972,0,55,26,0,40,31,922
64668,1640,742,14,21,21,5,43,22,898
65035,2075,1011,10,90,22,2,129,19,1064
74011,27969,13885,165,675,380,129,821,431,14084
75424,3103,1544,26,127,45,21,72,18,1559
76940,115,86,0,0,0,0,0,0,29
54824,2184,1143,20,62,30,0,48,31,1041
36574,878,491,0,33,25,0,0,0,387
40856,723,338,9,0,4,17,25,2,385
45321,851,428,0,34,10,0,15,14,423
46743,2202,1187,10,34,41,0,77,0,1015
48628,2322,1182,0,50,34,21,51,63,1140
59460,161,102,0,0,5,0,0,0,59
56257,490,238,4,16,16,0,17,8,252
57585,155,80,6,0,8,0,0,3,75
49760,734,379,0,13,17,0,11,16,355
50107,1156,560,8,20,4,4,20,9,596
4267,62,28,0,0,10,0,0,0,34
7071,22030,11449,188,926,140,74,609,367,10581
1902,49172,24157,216,1655,481,301,1852,535,25015
13695,184,105,0,0,10,0,0,0,79
15234,13649,6791,18,537,132,19,305,139,6858
15362,718,365,0,19,7,5,15,6,353
16222,2654,1445,21,64,18,0,34,57,1209
8534,13167,6311,60,192,196,60,318,270,6856
10514,12389,6192,40,289,127,48,390,189,6197
20510,0,0,0,0,0,0,0,0,0
12077,6823,3177,0,115,105,48,161,80,3646
12087,1053,419,0,25,37,41,41,37,634
41817,212,61,0,0,0,0,0,0,151
12885,4432,2235,17,147,58,0,79,46,2197
46278,8481,4161,171,172,130,36,244,174,4320
46550,12786,6255,39,434,152,104,292,131,6531
29321,3194,1248,0,95,25,41,76,65,1946
14212,10695,5346,32,219,59,28,267,115,5349
64012,27190,13425,197,939,180,104,732,317,13765
15081,369,198,3,21,7,0,9,5,171
65648,6073,3161,38,143,25,63,148,34,2912
75670,18056,8557,159,410,111,96,379,170,9499
31404,32876,14720,420,954,279,390,945,487,18156
76622,1066,530,0,40,22,9,36,22,536
31827,2174,974,0,32,12,20,69,49,1200
66115,0,0,0,0,0,0,0,0,0
32726,22377,10344,104,725,226,154,567,272,12033
33133,34460,16993,200,923,296,142,834,488,17467
67218,22499,10774,131,704,250,68,712,314,11725
23838,16399,8362,154,293,158,30,394,275,8037
78259,26508,13022,159,853,161,52,784,290,13486
20645,998,416,0,0,7,17,7,8,582
21218,49271,24353,906,1649,351,645,1615,855,24918
93256,5939,2805,11,278,73,45,262,81,3134
11714,22714,11105,80,631,343,90,575,318,11609
11786,6111,3058,20,236,82,40,185,56,3053
19054,16543,8038,250,476,140,153,654,200,8505
27326,2872,1445,0,91,93,0,62,12,1427
26138,141,77,0,0,0,0,0,0,64
26282,14,14,0,0,14,0,0,0,0
18810,5590,2759,46,207,72,29,227,29,2831
26374,1235,555,0,29,21,0,26,7,680
26559,1255,549,0,39,0,4,100,11,706
44273,7172,3580,5,178,112,7,169,220,3592
45101,2287,1025,6,112,21,12,77,33,1262
47459,3860,2007,21,88,15,12,74,98,1853
28449,1932,971,12,19,48,12,38,45,961
35462,4258,1750,17,29,166,0,165,91,2508
27518,20875,9930,75,621,214,22,679,294,10945
15049,848,390,0,32,15,0,17,13,458
15312,3853,1925,15,88,41,15,117,88,1928
74044,7354,3607,33,137,84,34,178,136,3747
17082,3192,1601,13,55,35,3,98,20,1591
31546,8103,4547,0,424,88,9,86,126,3556
23934,370,167,0,4,0,0,13,0,203
79743,309,174,4,5,0,0,7,10,135
20855,14302,7060,49,357,248,15,373,188,7242
99766,625,344,2,15,7,2,9,5,281
29936,13666,6791,101,488,175,156,435,168,6875
32926,22350,11289,49,656,182,32,472,399,11061
39462,1214,623,9,39,19,0,6,13,591
12955,381,174,0,8,7,0,4,10,207
14204,8649,3741,44,93,85,36,224,67,4908
70043,23602,11723,186,745,181,222,882,207,11879
35961,7003,3540,6,249,82,15,292,48,3463
27860,2066,1092,0,41,16,0,39,18,974
71929,4470,2235,21,91,50,9,219,81,2235
72046,4165,1883,21,125,58,39,79,73,2282
42436,1092,483,13,7,22,0,6,0,609
50558,634,332,3,14,5,0,18,9,302
28523,2364,1165,64,96,83,50,34,21,1199
48471,5224,2637,57,151,56,13,131,92,2587
24239,206,89,0,0,7,0,23,0,117
73664,1114,528,2,34,5,9,44,11,586
33618,27081,12941,47,826,270,129,621,404,14140
60608,79205,43845,1086,4015,727,481,2346,626,35360
60653,31972,13703,97,867,315,205,1495,417,18269
61846,4918,2510,74,180,133,20,126,59,2408
68377,399,193,0,13,10,0,13,1,206
70517,27314,13556,285,914,149,359,710,305,13758
71764,1769,840,0,28,15,14,65,19,929
72047,843,406,12,36,1,13,10,5,437
76598,506,0,0,0,0,16,61,5,506
77048,17721,8156,28,389,171,0,821,105,9565
78208,5031,2379,38,167,32,17,232,27,2652
64847,451,249,1,14,0,4,15,6,202
63376,74448,36120,312,2676,614,361,2528,1081,38328
64164,213,88,0,0,0,0,0,0,125
87020,11172,5741,75,430,38,59,324,231,5431
91350,37350,18298,198,1222,360,192,1146,365,19052
93932,810,361,0,3,16,0,53,0,449
96015,529,300,0,0,0,0,0,11,229
2859,7227,3514,0,224,99,0,243,91,3713
6478,13022,6457,23,268,173,17,287,288,6565
6824,35119,16796,287,957,329,641,1090,546,18323
1908,3495,1679,0,121,46,27,119,60,1816
52203,2036,1050,0,77,47,0,61,35,986
55959,2473,1305,13,27,13,0,47,69,1168
40941,283,146,0,0,24,0,9,0,137
36904,3738,1622,23,69,20,13,79,55,2116
37760,13371,6660,247,290,49,81,389,126,6711
47581,3853,1890,22,89,96,6,78,57,1963
22214,0,0,0,0,0,0,0,0,0
52586,424,228,0,24,6,0,0,15,196
49006,29109,14490,1577,569,113,1694,522,181,14619
57216,1081,561,13,38,25,0,38,13,520
74038,2123,1068,25,60,53,4,71,57,1055
74554,1738,863,6,74,35,12,25,17,875
50612,333,151,0,9,0,0,7,0,182
71003,1215,510,2,42,20,0,58,16,705
30563,5955,3045,30,214,10,35,249,102,2910
30660,1204,691,0,15,5,0,4,17,513
31756,791,384,51,18,0,0,17,0,407
3246,16324,7934,178,296,230,179,307,326,8390
4958,1826,976,4,80,24,15,50,11,850
84120,52103,26297,400,1564,524,449,1651,567,25806
85347,679,303,0,16,4,26,3,5,376
74745,9499,4602,45,235,131,50,258,126,4897
75462,11611,5435,19,430,64,0,500,188,6176
76301,15056,7114,84,368,81,56,311,126,7942
80723,7024,3438,15,185,39,115,172,65,3586
82422,14,6,0,0,0,0,0,0,8
82432,256,130,0,20,11,0,12,5,126
98305,310,115,0,0,12,0,0,20,195
98821,313,202,0,0,47,0,0,0,111
73075,9564,4802,80,326,141,54,171,112,4762
74045,352,187,0,22,0,0,14,8,165
95215,24371,13346,115,555,218,108,932,210,11025
64650,637,357,15,38,7,2,10,4,280
67420,4617,2404,78,96,74,0,113,44,2213
67951,5178,2617,21,144,36,32,193,67,2561
68634,489,261,0,12,14,0,3,2,228
28455,1914,823,0,15,16,21,13,39,1091
29030,1928,914,27,75,18,0,29,19,1014
28405,32330,15538,328,1091,340,301,940,452,16792
42348,4988,2636,12,193,82,42,173,27,2352
50707,8741,4545,25,238,49,64,262,125,4196
26169,624,319,7,30,0,12,0,15,305
48748,1838,959,0,27,36,0,22,45,879
50651,3685,1818,11,125,28,0,135,23,1867
79011,188,98,0,0,7,0,0,9,90
7764,7917,3506,100,141,64,128,245,95,4411
60959,1060,537,12,26,2,15,10,38,523
62323,268,148,0,32,8,0,5,0,120
63673,1615,778,29,55,28,15,27,26,837
68768,612,327,0,23,10,18,10,21,285
65351,2580,1354,0,78,52,12,77,29,1226
14822,1012,504,0,37,22,8,30,13,508
16416,180,98,0,11,0,0,3,4,82
30582,5038,2402,93,160,40,123,140,61,2636
23047,1990,897,0,10,31,19,0,19,1093
47967,564,293,0,2,42,0,9,14,271
48613,1020,537,15,33,16,5,29,24,483
49082,5854,2979,43,131,70,20,109,40,2875
53935,281,129,0,11,4,0,17,0,152
15218,13504,6331,23,511,149,21,564,186,7173
54003,1124,598,0,54,15,6,19,15,526
80209,25271,12942,108,1195,263,89,922,239,12329
7628,17694,8570,80,444,184,88,389,314,9124
20639,15139,7826,99,416,198,89,382,150,7313
20662,2994,1497,0,21,23,25,79,84,1497
8083,9728,4719,63,273,71,45,203,117,5009
29501,46516,21346,295,1353,335,276,1541,756,25170
12063,400,178,0,0,0,0,0,13,222
95356,32842,16300,121,915,354,259,1023,536,16542
49065,6608,3281,57,166,72,17,229,139,3327
89418,369,195,4,0,0,0,16,0,174
90212,13156,6193,33,312,94,13,347,212,6963
54723,1148,609,17,28,14,16,25,29,539
60714,29743,14246,187,768,320,61,853,477,15497
48434,66,32,1,0,0,0,0,3,34
44815,630,327,0,18,14,2,25,20,303
3086,3788,1971,17,74,62,0,133,46,1817
20674,1059,517,0,47,0,0,111,54,542
6357,11641,5237,53,301,124,80,391,150,6404
21244,35724,17085,110,1252,259,230,1537,584,18639
15646,161,58,0,5,5,0,0,5,103
21529,457,240,10,9,0,0,4,28,217
14432,6297,3040,35,176,60,17,115,79,3257
2493,12067,5538,45,163,195,85,311,129,6529
4282,5772,2945,0,215,49,21,105,93,2827
83809,239,137,0,35,20,0,0,0,102
84315,8928,4523,0,498,34,54,411,89,4405
93001,33185,16763,189,1077,369,141,897,490,16422
85302,40434,20009,121,1484,380,233,1189,502,20425
38001,4656,2115,9,161,104,33,96,80,2541
31554,8611,5678,48,588,101,109,152,129,2933
45721,34,20,0,0,0,0,0,0,14
77629,702,341,0,6,29,32,11,0,361
47427,728,354,17,5,23,0,14,33,374
80024,336,134,0,29,0,0,52,21,202
26631,332,122,0,0,0,0,0,0,210
27521,6111,3077,14,262,20,18,280,77,3034
54948,257,128,5,0,4,0,3,8,129
28327,16192,7360,24,449,129,78,399,166,8832
60050,32732,16272,315,976,411,210,1069,553,16460
26187,6409,3104,0,152,57,9,182,104,3305
28544,6692,3470,414,29,0,176,88,59,3222
48750,8479,4128,14,133,134,17,216,113,4351
43534,1739,893,11,72,6,0,55,37,846
50541,836,412,12,18,11,6,45,8,424
84636,490,246,15,12,3,0,6,4,244
75750,3483,1720,3,70,38,4,143,56,1763
95765,37878,18158,265,1092,190,97,1240,296,19720
99659,468,250,3,13,0,0,11,3,218
53034,1691,825,17,53,22,21,43,23,866
83217,759,420,0,15,4,4,24,9,339
70532,2232,907,14,72,26,11,81,54,1325
71854,36867,17925,154,1020,399,248,923,526,18942
76629,1627,826,18,55,9,7,36,25,801
55071,5684,2884,57,223,34,11,194,96,2800
49024,28710,13769,48,641,293,218,875,582,14941
95366,17654,8755,130,528,329,60,416,312,8899
61364,19054,9651,133,596,316,88,615,322,9403
62070,48,9,0,0,0,0,0,0,39
29627,19301,9457,184,653,99,87,607,328,9844
71303,21809,10373,291,638,215,88,869,225,11436
44286,6193,3075,14,114,63,0,154,140,3118
8023,312,154,0,0,3,0,0,3,158
22712,9049,4601,34,219,56,57,262,168,4448
27301,8826,4480,33,355,106,21,358,143,4346
15668,12448,5844,13,287,198,21,314,266,6604
27829,1480,710,23,49,23,3,40,106,770
16694,113,48,0,3,0,0,1,3,65
72207,10198,4723,101,351,91,4,273,115,5475
26436,212,100,0,0,0,9,0,0,112
80701,15806,7940,121,563,153,59,481,220,7866
95645,1652,879,0,89,13,15,43,22,773
17007,5924,3188,0,202,113,67,171,94,2736
96826,31945,16003,295,680,440,386,1109,420,15942
17370,5041,2582,15,136,0,8,176,42,2459
10302,18204,9313,124,601,126,70,645,230,8891
11501,19393,9127,39,698,226,136,688,221,10266
12950,735,442,8,19,0,0,4,4,293
13321,917,474,10,0,14,0,35,42,443
23851,13262,6184,100,368,147,39,406,291,7078
2906,28196,13702,412,741,271,664,685,219,14494
4290,1443,711,8,34,20,0,17,43,732
14101,1972,982,0,44,18,13,76,13,990
74432,9278,4457,42,212,215,11,134,187,4821
19358,855,350,12,25,0,6,23,0,505
84773,260,90,0,0,0,0,13,18,170
78886,379,208,0,0,13,0,3,0,171
24551,24879,12285,115,617,384,173,620,494,12594
96024,933,493,0,28,43,5,21,21,440
78112,8505,4246,77,215,60,122,169,72,4259
98353,46,30,0,0,0,0,0,0,16
16421,2673,1261,0,92,84,7,71,42,1412
95112,61060,31972,1110,2545,351,1149,1871,565,29088
10111,0,0,0,0,0,0,0,0,0
30726,0,0,0,0,0,0,0,0,0
27701,22849,11158,127,841,208,90,724,350,11691
35542,965,421,0,9,56,0,0,19,544
14853,2690,1335,104,0,0,71,0,0,1355
37067,29595,14470,191,1182,301,135,1281,484,15125
25674,2686,1256,27,51,48,55,53,42,1430
38114,26786,12286,161,599,235,278,881,276,14500
44412,2630,1380,8,75,7,99,62,64,1250
4984,600,292,0,27,12,6,2,31,308
38801,30050,13706,211,685,229,136,826,402,16344
22967,1702,870,0,70,41,16,38,12,832
47138,4892,2237,0,177,12,0,109,90,2655
31561,39,19,0,0,0,0,0,0,20
29053,17852,8452,74,488,205,77,674,257,9400
26615,137,58,0,0,0,0,0,0,79
16242,4350,2038,15,122,65,19,122,62,2312
93292,41031,19977,23,1320,356,360,1331,428,21054
80540,4552,2217,0,62,87,0,103,86,2335
80904,20235,10116,64,486,357,73,413,295,10119
84711,718,359,0,15,9,0,20,22,359
37324,5683,2726,0,151,73,34,199,66,2957
76436,237,147,0,0,0,0,12,0,90
61454,500,217,0,5,7,1,10,12,283
62030,149,55,0,4,0,0,1,3,94
79533,412,227,1,3,2,0,5,6,185
63750,5,0,0,0,0,0,0,0,5
66732,309,181,0,10,3,0,3,4,128
78733,8611,4217,35,188,59,0,305,193,4394
68862,3018,1517,24,64,15,20,84,49,1501
68464,529,275,9,33,11,0,11,7,254
60614,71308,35945,429,2535,460,478,2725,658,35363
61874,8150,3781,168,275,106,177,269,24,4369
55108,15929,7553,79,508,180,187,482,173,8376
61610,5493,2785,170,152,55,195,67,46,2708
84070,28362,13623,242,950,174,84,938,318,14739
78075,206,61,0,0,0,0,0,0,145
57636,208,78,0,0,0,0,16,0,130
49288,1424,713,4,32,31,8,43,40,711
83869,5007,2530,18,84,108,10,170,112,2477
38642,2353,1133,0,169,14,0,183,51,1220
39553,17226,8726,87,561,189,18,655,228,8500
93669,164,85,0,0,0,0,0,0,79
99501,17058,8872,96,740,193,82,488,171,8186
47420,446,255,0,15,11,0,91,9,191
5461,4633,2410,13,70,46,22,153,60,2223
53139,2559,1210,6,55,29,3,80,51,1349
60973,411,193,0,15,5,0,5,7,218
32323,422,244,0,30,38,0,33,23,178
62452,421,213,2,21,5,0,16,4,208
64402,2731,1198,6,67,24,10,108,38,1533
15683,7824,3776,38,179,136,16,301,210,4048
16646,2331,1113,20,43,31,18,67,47,1218
73859,1384,669,0,44,7,2,26,42,715
81225,1470,720,0,79,21,20,64,3,750
65601,591,272,7,10,31,7,6,30,319
65479,166,107,0,0,0,0,0,0,59
67143,29,15,0,2,0,0,0,0,14
30307,19652,9389,42,705,149,38,848,211,10263
71469,2326,1152,0,46,34,0,47,29,1174
35473,16305,8064,143,562,126,17,648,173,8241
75226,4674,2565,22,147,83,36,118,15,2109
38061,591,299,0,0,0,0,0,19,292
39209,27336,12446,127,698,304,267,800,381,14890
30565,4424,2295,5,266,74,78,109,44,2129
40935,2935,1527,0,113,0,31,99,56,1408
19041,6250,2881,69,135,82,43,108,130,3369
23061,21721,10948,194,565,253,130,771,408,10773
24634,474,203,17,3,4,0,20,23,271
45678,1086,542,0,24,0,10,26,0,544
50075,838,422,12,14,28,8,23,11,416
30185,4160,2100,45,90,19,11,136,92,2060
53960,3467,1753,12,98,43,24,109,46,1714
56447,914,470,0,18,39,0,15,20,444
36754,400,232,0,29,33,0,0,61,168
57763,280,146,0,4,0,0,4,2,134
44904,13542,6452,90,478,138,43,483,219,7090
46167,6572,3072,28,192,69,14,188,66,3500
19525,16294,7980,49,588,72,52,614,111,8314
65791,4900,2448,10,95,40,17,172,78,2452
8260,12737,6065,42,174,238,49,211,264,6672
66930,190,86,0,0,2,19,0,6,104
29349,30751,15181,94,1448,433,133,869,403,15570
54767,3661,1757,12,164,38,6,126,45,1904
55301,12760,6300,72,587,58,107,577,32,6460
14026,588,321,0,0,0,0,12,8,267
92879,46920,23079,410,1568,282,536,1814,317,23841
35563,4501,2288,20,129,44,7,147,40,2213
96730,1359,689,5,45,42,18,40,44,670
98590,401,189,0,7,2,0,21,0,212
98337,7039,3918,99,255,125,70,162,53,3121
56315,1663,854,0,73,24,13,36,15,809
88201,26539,13229,58,608,267,128,805,426,13310
58540,2828,1391,8,85,55,1,48,40,1437
58830,279,160,0,6,0,0,2,12,119
59733,302,154,2,0,2,1,0,0,148
62701,1206,797,11,67,6,0,47,25,409
63373,593,286,6,22,5,3,35,7,307
61103,23964,11391,116,592,259,161,810,466,12573
80479,5,5,0,0,0,0,0,0,0
61704,37204,18626,173,1344,331,280,1146,434,18578
81237,38,7,0,0,0,0,0,0,31
49829,16943,8328,77,426,311,59,442,308,8615
57457,92,48,0,3,0,0,3,0,44
72840,2181,1016,23,42,0,7,70,35,1165
57474,215,90,0,3,0,5,4,3,125
67416,1101,526,1,24,1,4,35,0,575
76865,144,59,0,0,0,0,0,0,85
65278,119,65,0,2,2,0,0,6,54
59087,371,194,0,3,7,0,18,10,177
75639,2821,1354,39,123,17,0,135,24,1467
75006,51136,24551,279,1620,435,309,1851,891,26585
53820,2304,1187,19,49,50,13,41,41,1117
51525,1120,499,5,25,14,0,15,34,621
54734,861,433,3,18,17,5,33,15,428
62661,1537,782,3,58,25,4,37,38,755
36543,189,60,0,0,0,0,34,22,129
63433,33,22,0,0,0,0,0,0,11
39572,1266,556,0,43,35,0,62,19,710
68842,665,323,0,21,2,3,9,17,342
46901,40357,20023,362,1143,574,231,1055,565,20334
57384,913,433,2,28,10,5,36,17,480
57783,15527,7648,194,453,149,231,333,217,7879
70377,4635,2571,63,162,9,9,136,116,2064
33936,23787,11771,195,648,345,119,700,455,12016
36091,3526,1870,0,210,71,29,84,74,1656
85207,49727,25029,279,1702,792,334,1382,686,24698
43952,18498,8664,243,580,235,389,341,256,9834
50022,8282,4137,59,315,86,77,221,141,4145
79842,434,225,8,11,11,0,14,9,209
36267,12,12,0,0,0,0,0,0,0
14731,1115,534,3,37,14,17,30,16,581
93263,21572,10779,257,574,105,202,722,77,10793
92311,33612,15698,117,1127,207,197,985,381,17914
25081,1037,507,0,12,28,0,20,11,530
99742,601,308,5,20,6,3,10,11,293
11553,25869,12500,263,906,172,171,794,378,13369
30039,46126,21659,289,1052,239,347,1363,368,24467
36548,839,500,35,15,48,0,30,13,339
29653,4682,2268,53,107,125,9,163,81,2414
38233,2440,1180,9,62,62,0,80,25,1260
12980,1276,651,0,28,5,8,16,48,625
40311,7349,3496,10,223,80,40,194,156,3853
18354,924,457,18,28,27,0,13,0,467
92173,31866,15222,393,827,242,361,809,290,16644
98029,28727,13144,42,1635,247,103,1649,232,15583
19066,5497,2692,35,99,42,25,87,90,2805
2421,18984,9173,48,359,227,69,513,198,9811
47020,1192,626,0,59,0,22,49,11,566
55329,1924,945,0,52,31,6,49,18,979
2863,19346,9818,97,594,106,225,664,253,9528
57791,300,161,0,17,0,0,14,4,139
14470,7548,3729,15,158,56,75,179,99,3819
43322,355,177,1,12,5,0,5,4,178
16124,1981,988,5,34,34,29,17,24,993
44882,2849,1554,31,58,23,3,102,18,1295
34491,24936,12139,42,356,672,0,288,363,12797
22845,9,9,0,0,0,0,0,0,0
48116,27345,13388,155,779,269,157,864,484,13957
19565,8880,4490,31,228,111,57,270,98,4390
36786,2804,1234,5,62,32,6,159,45,1570
12035,856,466,6,0,6,9,20,0,390
37762,2845,1421,0,55,11,0,65,38,1424
13080,3329,1604,36,81,14,0,81,25,1725
74017,28375,14257,187,918,241,165,842,444,14118
75559,5168,2287,6,97,54,5,221,73,2881
80744,394,201,0,5,4,0,4,6,193
72556,3231,1597,20,106,45,108,94,5,1634
68801,30063,15555,150,1259,288,97,1176,303,14508
69038,558,310,7,13,21,4,15,7,248
74450,1846,904,11,52,51,11,49,26,942
75032,32317,16181,210,1281,229,159,1033,321,16136
17822,0,0,0,0,0,0,0,0,0
20006,2756,1211,65,66,0,100,41,0,1545
1984,5208,2217,170,93,12,187,124,30,2991
2642,4893,2263,0,65,103,34,86,31,2630
4449,1496,770,6,24,6,10,37,11,726
5156,9112,4631,6,348,112,16,401,143,4481
5766,533,258,0,10,7,0,25,15,275
5862,237,109,0,2,2,0,2,0,128
12561,18731,8425,583,240,183,697,488,257,10306
12778,628,388,0,0,7,0,0,32,240
15423,2488,1235,2,77,24,92,102,85,1253
8030,13269,6075,31,523,96,50,510,157,7194
16879,432,173,6,4,6,0,24,6,259
39044,3689,1805,14,172,122,24,126,109,1884
32812,35101,17214,303,1309,308,196,1721,591,17887
50423,2536,1257,0,75,22,16,50,28,1279
51061,437,230,0,21,1,1,13,7,207
52356,2691,1296,15,90,9,22,81,22,1395
52569,574,325,0,0,9,0,3,17,249
68348,341,145,0,2,14,0,2,13,196
69221,199,94,0,3,0,0,2,0,105
62853,987,539,9,23,27,10,54,4,448
63846,1674,768,3,46,14,9,34,28,906
56110,1796,944,21,36,31,12,55,27,852
56761,443,242,0,3,4,2,12,6,201
58568,705,351,8,30,5,0,30,12,354
59354,38,15,0,0,0,0,0,0,23
48735,1060,527,9,29,13,5,44,17,533
48879,17959,8951,112,600,131,61,515,331,9008
71479,684,318,0,8,6,0,13,11,366
74434,8583,4182,31,176,110,82,304,111,4401
45317,1226,585,0,35,0,0,26,51,641
55155,0,0,0,0,0,0,0,0,0
55612,622,365,1,24,2,0,24,6,257
55790,2004,980,8,48,55,9,47,40,1024
37770,2675,1356,28,55,52,34,81,33,1319
43730,2287,1221,72,56,14,0,71,49,1066
44137,22657,10570,180,439,225,243,899,407,12087
44215,2323,1211,11,73,29,28,84,49,1112
45314,6010,2776,161,81,38,268,149,68,3234
46740,4333,2098,43,46,20,54,98,39,2235
47521,639,284,0,12,13,33,36,0,355
36043,3636,1755,0,62,44,21,28,65,1881
41719,1108,565,6,114,0,0,49,0,543
29302,16958,8448,150,492,291,127,425,197,8510
29910,41018,20446,393,1439,679,182,1459,598,20572
49455,4787,2391,28,231,41,17,123,88,2396
49848,71,29,0,0,8,0,0,0,42
15229,13755,6485,58,388,102,75,517,293,7270
4011,20534,10005,431,611,361,294,541,230,10529
5360,188,91,0,11,0,0,9,1,97
6467,287,120,1,0,0,0,0,0,167
7062,12618,6004,63,385,144,50,498,186,6614
24179,18416,9151,84,545,265,46,704,279,9265
24557,7532,3599,26,110,118,16,266,160,3933
25688,295,131,0,9,0,0,34,0,164
21875,6460,3017,58,111,120,81,201,93,3443
23030,4712,2357,7,149,51,18,119,90,2355
18049,17549,8639,78,589,135,81,523,334,8910
19118,10919,4929,90,272,160,70,212,158,5990
8341,2305,1214,0,54,47,2,18,26,1091
10976,2357,974,88,84,12,81,84,73,1383
1002,30066,14597,1615,569,266,1535,450,281,15469
28168,10056,4522,51,295,187,62,205,154,5534
59338,135,63,0,3,2,2,0,2,72
60043,2512,1273,0,76,11,0,52,44,1239
60477,37919,18451,334,1269,388,202,935,693,19468
61316,299,149,6,9,0,2,5,2,150
62466,4598,3222,60,325,27,7,48,32,1376
32437,921,419,0,22,23,0,32,21,502
34484,3604,1426,9,83,23,8,9,89,2178
34771,17351,8876,160,376,289,262,614,141,8475
41667,710,295,0,9,0,0,92,0,415
43222,4529,2481,39,51,28,7,179,99,2048
45822,18714,9401,117,437,173,139,529,285,9313
47994,301,159,8,4,3,0,13,4,142
49642,762,356,4,0,19,0,8,20,406
49717,150,72,0,0,0,0,11,0,78
13368,1063,510,0,24,2,2,40,37,553
53183,2918,1508,12,112,26,34,54,40,1410
28527,1016,502,0,0,8,0,9,40,514
31501,14963,7557,146,524,138,87,404,159,7406
23128,717,286,0,50,0,10,0,19,431
25126,25,12,0,0,0,0,0,0,13
21607,839,401,5,25,6,0,21,0,438
89419,5523,3682,56,308,41,9,63,30,1841
90027,44686,21741,168,2248,466,125,1965,586,22945
83446,24,12,0,0,5,0,0,0,12
85602,9033,4638,23,294,160,55,249,180,4395
85929,7407,3570,40,169,156,0,50,148,3837
99016,14543,7736,24,611,44,26,498,239,6807
99901,13818,7072,76,476,182,80,424,241,6746
99926,1635,882,26,63,21,16,28,25,753
7059,15783,7611,59,266,251,123,359,239,8172
7934,1603,723,0,56,16,0,47,25,880
10530,12791,5652,46,470,88,58,404,210,7139
3777,1507,663,8,26,16,16,49,7,844
1031,1197,649,37,21,43,0,19,15,548
26040,1996,1054,0,66,17,52,37,5,942
26451,733,335,5,25,0,6,12,2,398
32408,18141,9373,89,463,175,77,444,182,8768
33592,11068,5679,119,353,87,114,202,200,5389
33597,8207,4103,39,207,104,24,194,71,4104
37069,20238,9726,111,449,271,54,600,268,10512
38133,22254,10645,99,676,185,174,1028,388,11609
21871,1978,951,8,42,5,0,4,56,1027
20872,12940,6149,122,278,136,33,397,193,6791
24566,1218,538,0,0,19,7,99,41,680
25049,507,250,0,40,0,13,60,0,257
81067,5754,2934,7,188,40,34,187,102,2820
83237,968,490,0,22,0,0,9,27,478
83462,659,324,0,52,19,3,30,12,335
72583,2109,1089,7,10,52,14,16,39,1020
73173,3014,1542,22,128,25,0,161,16,1472
97377,1110,605,0,39,11,0,19,15,505
98057,13362,6948,24,494,75,52,547,135,6414
91945,27193,13297,165,1135,301,106,1150,392,13896
74428,1307,743,0,57,11,0,73,51,564
75413,246,105,0,0,1,0,5,1,141
84116,35041,18350,344,1192,250,68,1088,292,16691
85535,0,0,0,0,0,0,0,0,0
85749,18813,9448,118,401,478,85,308,362,9365
77657,21612,10715,77,566,289,183,691,278,10897
42345,10874,5344,72,344,85,90,311,188,5530
62461,672,330,0,34,14,0,26,13,342
54927,482,247,0,24,13,0,5,9,235
56244,1538,871,0,55,16,12,37,32,667
57719,8053,4134,86,385,128,31,409,81,3919
46931,161,97,0,5,0,0,0,0,64
49506,33661,16376,245,989,215,436,970,248,17285
1951,3755,1537,0,62,50,20,149,92,2218
67216,23223,11789,163,593,105,171,876,346,11434
67228,2636,1398,0,129,0,0,125,17,1238
68527,702,334,0,17,0,2,39,39,368
68901,26203,13197,385,782,230,210,718,406,13006
69347,1278,638,10,41,39,18,61,24,640
62261,64,26,0,0,0,0,0,12,38
58760,316,150,0,7,3,0,15,4,166
62521,35529,17238,152,897,440,113,819,633,18291
63135,21869,10281,122,571,165,150,718,242,11588
63567,250,169,27,0,2,0,10,10,81
63848,1589,770,4,29,25,38,18,16,819
64161,300,169,8,12,23,0,12,10,131
72365,2673,1193,0,49,8,24,77,38,1480
95415,1262,674,22,32,6,0,38,0,588
99609,574,305,3,15,1,2,10,4,269
91941,32384,15575,110,941,289,264,1120,521,16809
92518,1186,550,8,66,15,0,46,8,636
90042,63911,31573,488,2556,454,384,2635,698,32338
90068,20982,10871,16,898,193,83,942,225,10111
99679,415,238,1,11,0,0,16,2,177
38469,4125,2047,24,90,54,5,108,60,2078
38665,2594,1324,7,29,60,0,130,0,1270
47558,4692,2316,58,118,1,17,133,114,2376
47588,556,302,0,20,6,0,9,5,254
30566,7736,3609,53,230,27,54,337,145,4127
31705,32477,15707,214,813,316,627,1078,377,16770
63077,11118,5566,10,251,87,66,294,163,5552
64158,5041,2545,15,177,17,60,144,76,2496
70301,45298,21335,409,1349,384,457,1321,623,23963
57660,103,48,0,0,3,0,5,2,55
58062,141,74,0,4,0,0,1,0,67
49507,38374,18828,410,1317,176,148,1423,357,19546
49945,2659,1398,28,107,38,17,89,81,1261
50563,2531,1303,30,116,28,5,60,54,1228
43736,35,13,0,1,3,0,0,1,22
44040,2903,1422,0,46,46,0,49,72,1481
53140,29219,14261,248,675,308,553,595,345,14958
34737,2551,1201,18,81,27,4,47,38,1350
36875,3174,1669,25,39,64,8,15,92,1505
37061,4646,2257,15,140,40,70,92,67,2389
38340,12868,6276,223,524,103,134,350,149,6592
56236,345,179,1,17,9,0,5,3,166
56328,169,79,0,6,8,4,2,6,90
57382,1376,655,0,24,4,0,41,30,721
57767,139,67,0,0,0,0,8,0,72
58069,100,46,0,0,3,0,0,2,54
59031,380,199,0,7,0,0,10,15,181
60447,14220,6775,34,478,124,69,482,152,7445
48636,712,351,7,3,8,0,7,5,361
43006,655,329,6,28,45,0,8,35,326
30533,26683,12821,371,568,329,770,631,469,13862
20640,10018,4946,123,246,22,32,267,79,5072
21060,34360,16624,146,1127,318,222,1218,286,17736
15035,2106,1037,7,65,17,0,71,52,1069
15413,593,262,0,27,40,0,39,0,331
15846,3563,1829,14,65,66,0,60,34,1734
22042,34486,17650,208,1894,405,129,1592,332,16836
2557,4686,2278,0,178,58,0,149,0,2408
2888,19167,9658,160,665,267,63,680,340,9509
4942,1333,660,9,48,41,0,66,14,673
10473,59609,26916,466,1396,494,577,2114,1028,32693
10983,6178,2982,94,188,55,37,149,98,3196
7055,70199,35956,511,2373,474,603,2220,876,34243
7703,57,17,0,17,0,0,0,0,40
93434,7350,3799,81,201,14,87,244,34,3551
93620,8889,4421,23,236,113,43,272,62,4468
53510,1498,729,0,45,26,2,49,27,769
53544,799,427,3,18,7,2,11,13,372
59079,3327,1778,11,178,54,93,164,56,1549
59260,166,75,0,0,0,0,9,0,91
64772,13547,6317,57,384,160,158,346,172,7230
65279,1769,842,0,76,53,0,55,1,927
65322,581,289,7,7,12,0,19,6,292
67455,2086,1054,0,70,9,22,73,61,1032
68659,160,83,0,0,2,0,13,1,77
75001,15000,7479,30,605,78,95,506,134,7521
75436,2159,1079,7,64,12,2,50,22,1080
75568,2459,1276,5,106,4,11,100,0,1183
76534,2857,1384,0,62,28,25,64,31,1473
77301,33660,17384,280,1115,240,257,1177,278,16276
78723,34569,16993,155,1755,161,53,1739,448,17576
62912,1338,597,0,36,18,12,48,15,741
63440,990,514,0,7,6,0,11,29,476
71105,21353,10271,46,826,222,122,642,218,11082
71106,35923,16878,121,1138,380,116,1106,583,19045
71343,6833,3230,87,69,134,110,153,126,3603
83657,324,123,0,0,0,0,9,0,201
84018,119,67,0,13,0,0,0,0,52
97535,5400,2661,14,161,61,97,109,131,2739
98407,21240,10180,28,690,329,120,844,415,11060
98686,20021,10031,99,437,381,43,652,259,9990
99121,175,60,0,0,0,0,0,14,115
95969,27967,13348,73,535,351,226,654,610,14619
97109,484,249,0,17,6,0,16,0,235
82925,275,190,0,0,0,0,0,0,85
95004,3956,2141,13,96,16,0,61,32,1815
36575,21095,10451,43,718,182,82,697,384,10644
37134,3049,1589,19,93,36,0,81,62,1460
32305,20659,9690,105,657,217,133,651,465,10969
32780,35399,16671,109,970,632,287,787,650,18728
33324,48807,22604,177,1759,327,217,1777,678,26203
54867,468,220,0,2,3,3,6,3,248
45225,9418,3968,29,210,24,185,346,75,5450
13830,5196,2756,54,134,61,17,99,101,2440
13846,351,171,0,0,0,0,13,14,180
14225,33328,15595,173,823,389,149,864,583,17733
15732,1500,771,5,35,9,7,44,17,729
20228,0,0,0,0,0,0,0,0,0
23454,59699,29144,361,2023,591,400,1690,805,30555
24090,4934,2387,52,103,91,52,72,27,2547
25028,346,143,0,0,0,0,31,11,203
25149,266,118,0,0,19,0,0,0,148
25420,4201,2098,62,118,68,0,71,33,2103
25958,864,530,0,41,0,10,3,0,334
29105,1098,495,1,28,13,0,60,28,603
17920,353,161,6,8,8,0,0,4,192
19444,10911,5337,26,345,78,118,364,203,5574
19604,28319,13835,389,889,190,292,883,188,14484
35619,4428,2294,27,178,39,0,129,86,2134
35648,3250,1540,2,44,25,28,61,47,1710
36009,2278,1096,31,27,26,9,51,33,1182
13317,3954,1860,0,106,37,0,52,18,2094
4108,896,376,0,10,12,10,21,23,520
4443,2430,1245,0,53,29,0,70,48,1185
4679,1722,797,19,29,26,12,0,17,925
6610,23275,11329,303,778,222,217,684,420,11946
10590,7060,3566,20,135,75,0,119,97,3494
2203,25,25,0,0,0,0,0,0,0
48877,2346,1164,19,57,46,8,115,21,1182
43074,13229,6539,15,424,161,67,646,185,6690
43543,7785,3889,45,226,161,9,188,91,3896
43554,2371,1203,27,82,35,22,58,6,1168
44625,1918,1037,35,35,0,8,80,37,881
45426,15730,6921,124,277,155,40,483,248,8809
46076,1431,742,14,18,16,13,29,36,689
46115,1873,883,20,56,9,9,37,42,990
50847,112,52,0,6,0,0,6,3,60
33905,37081,18843,183,1232,361,239,1264,357,18238
92656,52124,24554,275,1730,291,281,1990,626,27570
93250,16088,8760,59,695,30,199,610,149,7328
82005,574,499,88,0,0,22,0,0,75
95694,10386,5146,45,278,160,141,427,111,5240
37663,14689,7084,74,328,245,43,354,202,7605
38863,21115,10314,84,683,199,68,618,185,10801
58079,503,230,0,11,13,0,17,0,273
58105,2387,1263,42,0,0,31,0,0,1124
54024,4778,2433,26,100,64,9,96,84,2345
54512,831,417,0,5,11,0,13,37,414
46405,11455,5794,100,412,136,50,272,136,5661
47306,4982,1789,244,0,0,181,0,0,3193
49348,12300,6069,22,390,140,56,406,94,6231
49801,11349,5710,61,335,192,16,266,276,5639
51029,268,151,0,15,3,3,1,12,117
53040,8154,3984,29,381,130,9,252,140,4170
43028,8335,3911,33,219,81,83,246,89,4424
43205,12725,6583,106,523,162,65,480,171,6142
61754,1063,515,0,19,27,4,22,15,548
64021,597,282,0,21,4,0,22,9,315
64055,33633,15336,242,955,245,123,1055,589,18297
48096,3989,2016,27,56,67,73,110,59,1973
48921,0,0,0,0,0,0,0,0,0
30668,1452,726,8,9,20,7,17,4,726
30828,4205,1988,11,193,84,40,95,103,2217
31788,10587,5326,61,354,158,120,236,108,5261
32310,15864,7659,388,371,122,170,396,169,8205
23336,2899,1298,0,28,86,0,104,53,1601
16156,2889,1482,15,73,66,6,74,28,1407
16426,3629,1831,8,92,37,28,84,62,1798
17064,806,369,0,16,58,0,18,0,437
25831,1911,925,0,131,0,50,26,12,986
36054,16080,7208,96,630,60,192,840,113,8872
37330,6979,3507,85,178,66,31,358,197,3472
19390,14195,7010,87,506,133,131,302,56,7185
28280,0,0,0,0,0,0,0,0,0
29842,7462,3661,26,251,136,54,160,200,3801
97374,4993,2567,0,217,85,0,136,49,2426
95018,7060,3537,40,298,114,20,250,62,3523
15925,206,118,3,5,2,2,11,1,88
18321,1859,629,0,41,0,0,43,68,1230
33062,22014,11094,0,490,367,32,396,450,10920
35475,15583,8013,67,487,164,58,529,229,7570
77564,1678,780,0,129,10,15,33,11,898
59846,1174,537,0,81,36,0,83,36,637
59920,1689,897,23,53,45,0,77,35,792
62424,2445,1273,42,59,27,0,85,27,1172
68874,887,412,0,17,7,8,20,9,475
71827,774,383,0,2,14,0,38,6,391
77423,11901,5834,61,384,108,37,403,159,6067
78069,6376,3107,85,85,12,3,108,69,3269
64850,23730,11676,136,813,226,205,731,275,12054
67353,603,296,0,6,41,0,3,19,307
67566,637,321,6,22,3,15,32,17,316
56187,14589,7473,80,487,86,160,455,109,7116
56357,1080,549,0,23,7,0,33,15,531
56725,973,511,0,40,7,18,36,15,462
63330,162,77,0,3,0,0,8,1,85
63638,2698,1362,8,110,58,11,97,48,1336
72083,196,90,18,7,0,0,10,0,106
74136,31835,15635,341,929,267,312,900,380,16200
80624,1180,641,22,34,8,6,87,32,539
87004,11319,5564,58,299,150,68,264,152,5755
89883,4320,2304,0,171,34,46,124,12,2016
92405,30511,15051,176,892,223,278,1103,164,15460
3910,294,134,0,0,28,0,0,0,160
4410,1150,604,0,43,22,5,33,9,546
4758,1368,619,18,44,33,21,28,7,749
906,184,108,0,0,0,0,13,0,76
1229,70,50,0,0,0,0,0,0,20
1516,8794,4294,127,232,0,43,243,75,4500
37305,868,462,9,30,2,16,32,16,406
4281,5131,2610,0,197,135,0,405,150,2521
4657,313,161,0,7,11,0,3,13,152
6013,9607,4602,113,224,145,27,229,159,5005
61345,835,443,4,25,31,0,22,11,392
84102,18099,10327,578,569,125,228,620,187,7772
74727,1810,874,7,36,34,10,29,35,936
75708,8417,4307,7,223,51,81,264,141,4110
76233,3327,1759,25,78,42,11,110,28,1568
77022,28277,14417,80,707,225,102,798,130,13860
80749,274,162,0,5,2,0,6,6,112
92301,33967,17614,289,1284,158,260,1393,252,16353
78589,41628,20327,749,1402,275,366,1334,316,21301
94574,8677,4059,30,213,184,46,286,169,4618
65262,995,407,0,26,0,0,74,1,588
67631,149,76,0,10,13,0,0,4,73
30248,25161,12195,49,560,227,249,1244,217,12966
8753,63026,30872,286,1764,802,417,1767,1146,32154
39176,2247,1170,0,142,9,0,55,59,1077
40205,24366,11641,216,862,390,171,896,352,12725
12177,305,153,0,0,0,0,0,34,152
12578,2206,1120,7,50,16,0,58,29,1086
13651,153,67,0,0,3,0,0,0,86
70080,1759,747,70,16,0,84,54,87,1012
58056,168,103,0,7,0,0,12,0,65
58212,535,324,1,5,28,0,5,6,211
23867,2018,949,0,26,60,23,82,30,1069
54868,15383,7851,106,594,64,98,443,218,7532
74332,1679,872,0,8,38,14,65,1,807
49726,1104,585,0,9,30,0,22,9,519
49892,1853,949,7,28,40,6,36,34,904
30666,10214,5247,82,208,73,11,324,125,4967
37303,24146,11438,114,536,278,139,662,349,12708
39653,2515,1319,35,7,90,3,113,31,1196
46763,1838,912,14,99,9,0,70,20,926
36345,8845,4268,0,473,77,48,393,118,4577
43152,787,386,0,0,25,10,16,10,401
72412,492,301,0,0,0,9,0,0,191
70448,25702,12304,104,792,172,78,755,293,13398
70503,30957,15268,410,1096,269,188,749,393,15689
70512,10109,5084,67,415,39,18,504,77,5025
24311,1624,804,10,74,21,16,50,56,820
24815,715,322,0,8,0,0,16,0,393
25559,1924,930,0,54,50,0,0,21,994
26572,204,146,16,0,0,0,0,0,58
27022,1099,571,0,75,8,0,55,0,528
5445,3839,1987,10,58,104,0,96,70,1852
6060,2949,1463,0,56,61,23,53,29,1486
6492,44841,20912,189,1445,415,270,1611,762,23929
4628,757,407,17,19,12,6,28,15,350
5151,1542,795,0,73,23,0,71,9,747
71446,22127,11521,130,943,226,99,710,248,10606
72530,1282,584,0,25,18,0,31,34,698
73724,1173,572,0,17,18,0,7,7,601
49047,14693,7378,162,406,124,29,220,137,7315
88040,105,61,0,0,12,0,18,0,44
89084,27218,13336,320,867,285,201,1186,321,13882
95439,774,472,0,79,42,0,41,0,302
96049,87,43,0,9,0,0,0,0,44
75942,222,88,0,0,0,0,0,0,134
67573,187,95,0,0,3,0,4,3,92
68382,27,9,0,0,2,0,2,0,18
85640,255,143,0,0,7,0,0,0,112
38864,1887,900,52,84,25,18,69,50,987
40328,1275,752,4,26,22,0,55,0,523
46984,209,101,0,24,8,0,24,0,108
64681,177,103,0,13,15,0,3,8,74
75065,12389,6080,31,459,87,62,473,214,6309
76035,1654,931,5,26,49,42,17,51,723
77031,17536,9130,343,421,136,167,541,101,8406
77094,9710,5019,0,210,122,31,320,255,4691
77358,5480,2658,41,102,59,12,98,49,2822
80911,35170,17198,152,1052,373,320,1200,404,17972
84525,960,474,6,48,26,19,43,4,486
62078,78,36,2,4,0,3,4,1,42
62278,6543,3303,70,119,60,65,159,71,3240
57104,26046,14405,219,1121,145,185,866,218,11641
58257,2081,1089,29,59,26,11,35,28,992
59035,182,92,0,6,6,0,11,6,90
80021,33725,17019,189,1183,223,220,1152,449,16706
63015,2318,1041,0,0,62,24,57,36,1277
63025,14334,6999,81,421,162,26,451,194,7335
63301,50675,24450,636,1412,604,1491,1344,551,26225
63384,1707,818,3,48,5,4,38,31,889
72416,5344,2727,28,215,124,18,146,20,2617
70128,19500,8397,130,401,204,165,631,212,11103
13603,9589,5148,186,517,0,136,363,13,4441
15462,676,351,0,10,0,0,18,0,325
15695,488,301,0,0,0,0,12,0,187
33070,5518,2841,27,102,60,0,90,126,2677
11423,31400,15291,221,1030,379,180,1046,529,16109
27946,1052,481,0,14,6,21,14,23,571
18636,1327,695,3,56,26,31,42,19,632
12492,210,95,0,0,3,0,0,4,115
55395,2898,1349,18,91,19,46,91,50,1549
38565,1367,847,0,106,0,0,121,5,520
7849,8915,4782,23,322,101,55,234,108,4133
17935,1493,735,12,31,14,0,12,6,758
1718,813,349,0,23,0,0,47,0,464
4046,7818,3760,33,168,136,57,203,209,4058
66769,382,206,3,2,10,3,19,6,176
67065,256,158,0,24,2,2,4,0,98
67868,318,201,0,29,52,0,12,0,117
68981,389,203,0,7,4,9,15,10,186
72137,2589,1374,0,42,17,1,12,48,1215
63061,169,116,0,0,0,3,0,0,53
70126,28173,12542,202,602,164,253,1029,353,15631
71857,4851,2421,0,236,65,1,110,44,2430
27616,53364,25255,274,1968,154,282,2986,561,28109
54554,960,500,11,9,20,0,8,31,460
54813,555,294,3,15,1,0,7,8,261
45414,20403,9926,17,652,285,210,690,250,10477
45711,1232,567,15,21,4,0,28,15,665
47978,11324,5723,51,308,153,69,424,160,5601
47340,2848,1435,10,77,36,10,89,57,1413
13205,17479,7986,64,433,262,60,442,244,9493
13784,106,56,0,0,3,2,6,2,50
5836,1111,512,0,18,9,13,80,33,599
6757,2124,986,13,45,0,0,45,57,1138
81323,4418,2177,0,96,100,58,123,71,2241
84337,12422,6615,22,542,64,48,287,150,5807
29015,1691,730,1,49,9,8,31,34,961
95014,62430,30611,316,2143,405,190,2349,528,31819
26351,4846,2872,83,325,40,53,55,68,1974
27405,48990,23193,196,1750,445,251,1970,500,25797
10006,3454,1633,0,214,16,19,237,48,1821
40077,382,202,0,7,13,0,0,0,180
38007,36,13,0,0,0,0,0,0,23
56245,630,341,2,20,11,8,12,13,289
17019,18392,9281,175,621,277,88,598,277,9111
48437,666,289,0,0,0,12,20,0,377
17076,14,0,0,0,0,0,0,0,14
17229,1220,581,16,10,10,10,20,13,639
45459,26979,12634,72,649,289,58,814,384,14345
20784,30184,14841,198,1141,217,177,1126,478,15343
6063,3160,1652,15,38,34,37,50,40,1508
14787,4739,2349,21,131,81,36,121,89,2390
15902,11212,5371,44,186,113,46,212,205,5841
12844,269,154,4,23,0,0,8,0,115
23072,11677,5877,20,323,164,92,265,126,5800
2128,46927,24990,392,2234,356,285,1738,359,21937
3276,8263,4299,79,264,189,13,214,140,3964
2650,845,420,2,31,25,0,0,42,425
80439,24687,12408,98,541,466,27,672,475,12279
10604,11045,5418,17,270,112,117,253,119,5627
11373,93967,47038,615,3493,832,481,3249,1365,46929
92337,38868,19537,510,1064,170,338,1574,347,19331
18969,15400,7521,74,391,143,62,532,313,7879
88003,500,264,27,3,0,13,0,0,236
88345,8418,3993,51,241,179,144,293,83,4425
32567,3104,1484,4,85,39,0,111,47,1620
76676,297,126,0,7,3,2,10,9,171
46733,18715,9459,78,509,165,43,622,366,9256
26519,2120,910,16,84,11,0,47,46,1210
52307,249,166,0,34,6,0,0,0,83
27596,18359,9077,80,535,203,144,465,250,9282
67844,830,401,0,17,12,1,19,20,429
24317,3912,1963,0,126,45,16,0,62,1949
60472,4870,2537,79,110,78,11,66,35,2333
47863,246,130,0,0,0,0,0,10,116
57455,88,26,0,0,0,14,0,0,62
98010,5485,2673,31,105,42,38,136,131,2812
49434,6,6,0,0,0,0,0,0,0
83549,737,398,17,12,22,0,4,2,339
76252,2834,1491,7,46,10,12,62,33,1343
91708,3892,1156,0,149,24,21,335,51,2736
56551,2033,1038,14,52,34,7,35,27,995
95829,28134,13865,175,755,205,202,826,302,14269
59844,668,304,7,15,23,0,7,4,364
60450,20460,10200,71,709,191,38,773,265,10260
81321,14758,7403,114,382,155,34,529,252,7355
63343,4403,2202,50,183,33,11,137,111,2201
86042,2181,1126,0,59,10,0,117,23,1055
76427,760,368,14,14,0,0,18,4,392
54566,1322,655,7,21,19,11,30,27,667
76943,3527,1740,10,74,2,18,132,86,1787
93410,0,0,0,0,0,0,0,0,0
96008,1328,520,0,6,12,6,51,22,808
79762,43881,22116,376,1591,257,450,1605,475,21765
81137,5745,2897,39,162,90,18,201,161,2848
43619,7296,3843,21,150,121,0,256,69,3453
72004,1020,486,6,5,3,0,32,24,534
13660,1558,800,14,46,17,13,31,27,758
38965,8664,4356,120,234,128,21,205,123,4308
12074,2895,1448,8,120,56,17,84,50,1447
5827,365,218,0,4,3,0,4,0,147
16125,17246,8335,138,327,238,210,434,250,8911
26147,1965,907,32,50,60,0,73,11,1058
1355,949,534,0,8,27,0,17,27,415
43773,3668,1943,12,104,47,19,45,50,1725
74030,3771,1732,10,63,59,22,98,54,2039
28173,56910,28318,372,1580,358,224,2033,419,28592
93442,10976,5367,62,291,215,0,246,184,5609
48427,2673,1307,5,80,40,19,73,32,1366
96122,3044,1439,0,100,71,15,55,69,1605
97225,26117,13139,86,1102,230,97,1143,463,12978
5667,2200,1065,13,58,47,5,64,22,1135
12729,1791,943,4,33,23,4,30,69,848
23505,29524,15169,325,608,252,307,963,405,14355
13795,3424,1593,0,79,14,35,64,81,1831
3604,269,133,0,0,0,0,0,0,136
4864,4718,2878,30,258,43,0,99,109,1840
15206,30014,14484,195,947,354,72,1007,523,15530
74871,2483,1215,3,93,57,10,65,32,1268
78611,13313,6752,117,389,190,30,332,241,6561
79013,3708,2042,0,123,22,0,104,13,1666
75959,678,294,0,0,0,0,0,14,384
98272,31416,17109,150,1506,252,140,879,396,14307
58762,206,117,0,8,15,0,6,10,89
18212,199,103,0,0,0,0,0,0,96
89509,34956,17094,142,883,464,197,942,380,17862
27312,20368,9491,90,497,332,146,532,349,10877
11103,36140,17586,95,1691,271,170,1475,320,18554
31001,4563,3199,42,441,56,19,91,61,1364
32129,22149,11142,291,520,159,204,613,345,11007
24124,5007,2270,92,77,45,96,75,18,2737
35907,8511,4182,24,354,131,21,156,102,4329
15344,1408,753,14,52,21,8,39,14,655
37337,1750,727,0,19,6,0,59,18,1023
38015,2195,1247,4,84,18,7,81,40,948
25985,489,200,0,0,23,0,9,21,289
4624,185,84,0,0,0,0,0,4,101
4764,30,15,0,2,2,0,0,2,15
38685,1557,811,0,24,0,15,86,0,746
22150,27860,13743,112,1034,334,216,1011,272,14117
46175,616,312,9,12,5,2,11,14,304
28469,6128,2914,19,38,226,91,78,184,3214
31047,14625,7053,186,569,75,0,636,205,7572
15535,2171,1142,7,68,32,8,33,36,1029
27025,11387,5624,37,407,169,53,332,168,5763
32639,123,70,0,0,32,0,0,0,53
94553,49699,24308,230,1539,552,182,1524,925,25391
80834,218,119,0,2,6,3,2,7,99
76305,4352,2178,10,99,75,10,89,116,2174
77055,44680,23208,209,2295,304,227,1434,545,21472
61438,917,511,13,9,8,12,43,7,406
89039,140,62,0,0,7,0,0,5,78
79247,68,35,0,0,2,0,9,0,33
62568,15787,8055,139,658,154,24,467,210,7732
62868,1735,918,8,55,43,18,53,4,817
63961,1631,863,11,77,17,0,43,14,768
68658,714,362,0,10,10,1,14,4,352
67861,1903,898,0,13,4,0,27,16,1005
60056,55250,27755,330,2306,741,237,2086,731,27495
70549,3591,1846,0,47,0,56,127,38,1745
71109,21010,9912,313,774,229,158,592,352,11098
62967,237,116,0,4,1,0,12,11,121
64109,9647,4897,89,440,57,87,271,146,4750
58646,1210,619,3,42,21,0,16,43,591
78408,11787,5733,71,253,57,36,325,123,6054
78548,727,353,0,42,20,0,17,4,374
48621,1176,553,0,28,36,0,12,25,623
49337,11732,5990,77,276,187,69,223,193,5742
75078,23580,11773,27,979,105,96,1279,235,11807
38870,2840,1271,5,44,6,21,43,41,1569
95012,10792,5646,37,394,111,136,175,77,5146
31569,5831,2802,38,219,95,25,173,179,3029
62297,251,114,0,0,0,0,0,36,137
32603,7195,4301,436,118,46,305,44,2,2894
62828,1334,589,2,21,21,3,37,18,745
14428,7439,3627,106,161,30,38,145,129,3812
72438,2946,1474,15,122,21,0,138,15,1472
74114,16175,7738,20,546,181,34,705,315,8437
79754,102,58,0,0,0,0,0,0,44
65275,2601,1304,0,52,28,32,45,41,1297
66616,5455,2827,19,154,153,48,38,70,2628
17060,1174,586,15,42,19,6,42,5,588
67838,968,468,0,15,13,2,25,11,500
18324,9110,4406,15,212,112,46,282,281,4704
69348,1561,780,0,33,30,0,22,30,781
27408,18090,8432,20,637,221,13,638,356,9658
76871,700,343,3,56,23,0,21,4,357
71473,423,202,0,17,18,0,8,3,221
71659,80,38,0,0,0,0,0,0,42
80133,2558,1239,6,113,18,33,45,32,1319
73569,540,274,0,26,3,0,11,23,266
89018,4837,4466,127,537,35,6,20,0,371
83604,535,228,6,14,0,0,33,17,307
85348,2295,1114,0,0,73,0,61,17,1181
98294,7127,3903,57,329,43,7,351,62,3224
99676,1353,655,1,60,31,37,72,44,698
95974,64,47,0,0,0,0,0,0,17
97116,26767,13180,228,887,173,324,977,317,13587
50665,3053,1518,0,142,29,0,78,21,1535
67737,416,208,0,14,11,0,9,4,208
69046,128,70,0,0,4,0,0,0,58
53004,3350,1732,11,138,51,43,117,19,1618
15957,644,317,0,19,5,0,17,0,327
16677,263,111,0,0,0,0,0,9,152
17762,561,306,7,18,6,0,14,13,255
76537,5631,2686,39,239,77,60,210,48,2945
60948,1496,779,9,19,21,23,18,10,717
60968,335,163,0,10,1,0,8,1,172
61849,1999,1098,31,51,0,18,112,14,901
63114,35487,17032,391,1249,315,152,1195,515,18455
68445,105,58,0,3,0,0,1,6,47
69219,170,76,13,0,0,0,0,8,94
65270,17122,8993,168,700,191,90,378,96,8129
66835,1082,542,2,38,30,0,20,7,540
84621,91,64,0,0,0,0,0,0,27
72633,1348,619,10,8,8,0,21,25,729
73550,2313,1093,0,79,33,19,82,36,1220
16738,2507,1900,0,345,16,0,53,8,607
40816,15,15,0,0,0,0,0,0,0
30630,2264,953,9,5,35,27,29,22,1311
45304,7084,3512,42,186,87,24,185,68,3572
24486,3640,1743,0,111,85,0,185,112,1897
24836,630,292,3,5,0,10,4,0,338
17702,10480,5090,50,340,105,58,408,270,5390
18507,5165,2635,62,52,20,0,279,126,2530
8641,4478,2446,62,221,0,21,216,9,2032
28582,2734,1467,51,60,35,61,147,27,1267
28740,759,398,0,7,7,0,33,0,361
29388,15721,7476,102,523,112,85,511,181,8245
13420,933,414,0,11,16,12,6,17,519
27009,2596,1347,16,52,0,0,106,50,1249
27916,885,459,0,12,20,0,32,25,426
53599,39,18,0,0,0,0,0,0,21
38485,6487,3197,52,174,100,32,164,41,3290
8553,598,305,0,12,13,0,18,19,293
1034,2179,1068,29,70,51,0,73,38,1111
14621,33264,15452,271,803,249,126,1165,300,17812
4363,2572,1342,0,67,20,0,92,20,1230
4855,195,109,0,0,0,0,0,0,86
89052,54586,26530,101,1665,766,177,1683,660,28056
98245,3646,1724,20,50,69,36,63,108,1922
98571,472,187,0,0,8,0,0,44,285
73768,1666,846,20,36,22,23,64,24,820
75944,1265,649,12,47,5,0,25,35,616
65630,333,164,0,2,5,0,4,6,169
76180,36964,17894,171,914,376,200,1262,543,19070
76884,148,73,0,0,0,9,10,0,75
60932,92,37,0,0,0,0,0,0,55
71302,13365,6181,193,382,191,171,229,220,7184
71472,497,208,0,0,0,0,0,0,289
72025,837,377,13,11,6,8,30,0,460
35677,1799,782,28,33,16,2,79,45,1017
35975,463,179,0,22,0,0,0,11,284
48183,42544,20726,247,1124,617,223,1173,519,21818
48316,27594,13572,119,716,318,96,931,338,14022
22740,1103,559,0,7,9,0,16,23,544
23416,253,61,0,0,0,0,0,0,192
45656,6364,3131,54,180,75,44,99,84,3233
54547,1390,721,2,23,47,28,13,27,669
15680,162,83,0,8,13,0,8,0,79
16157,3076,1479,30,77,28,25,50,31,1597
17093,1421,692,54,40,0,15,65,43,729
20636,11523,5866,14,332,105,145,357,249,5657
21648,256,135,0,0,0,6,0,6,121
22946,208,89,0,29,0,0,0,9,119
4473,8151,3921,338,159,62,601,110,91,4230
4616,713,360,9,11,14,0,13,9,353
7027,4334,2264,12,221,48,64,163,89,2070
8861,53879,26863,553,1745,275,462,2015,427,27016
10996,6673,4334,785,212,0,100,163,0,2339
25508,9025,4491,103,229,143,147,319,166,4534
26155,7849,3712,26,210,71,44,228,92,4137
30105,1776,860,32,54,18,30,18,38,916
11801,40340,20246,416,1039,578,427,818,709,20094
12745,143,61,0,6,0,0,0,0,82
13029,7243,3497,104,201,66,8,178,150,3746
26743,1200,546,0,48,40,0,0,0,654
17812,1276,621,0,31,9,7,26,15,655
75926,1103,515,0,21,32,12,38,17,588
76255,5444,2663,47,148,48,29,85,82,2781
84754,3841,2010,30,133,52,13,145,67,1831
65580,701,369,0,16,8,0,17,0,332
66046,19456,9486,480,786,68,271,669,205,9970
17318,541,241,0,23,32,0,24,0,300
3750,879,483,0,25,0,26,18,0,396
3851,4072,2066,0,93,65,60,73,109,2006
4859,890,464,24,13,50,0,24,20,426
7751,19715,9520,143,432,204,120,470,364,10195
21750,3732,1872,18,99,87,17,111,98,1860
21853,11693,5729,260,342,67,127,328,181,5964
23938,360,229,0,0,14,0,0,6,131
24088,5025,2481,124,117,75,84,38,32,2544
75692,4747,2472,29,292,62,14,179,42,2275
77871,2841,1497,2,62,33,0,32,104,1344
96813,25219,12737,129,1034,460,93,1133,137,12482
87567,1378,586,0,0,0,6,15,43,792
88422,61,33,0,0,0,0,0,0,28
93463,8025,3874,10,252,120,66,111,225,4151
92806,39719,20050,293,1502,200,313,1402,331,19669
78598,88,32,0,0,0,0,0,0,56
49325,1950,1013,17,67,23,3,64,40,937
65608,9103,4667,12,277,147,78,288,38,4436
60188,42602,20943,229,1348,373,151,1483,597,21659
67355,160,82,3,2,0,0,8,0,78
68062,295,157,0,11,1,0,10,5,138
76939,10,5,0,0,0,0,0,0,5
78938,387,179,0,13,0,0,0,5,208
79064,2382,1179,29,75,25,19,83,29,1203
79324,37,17,0,0,0,0,0,0,20
80908,17807,8709,86,657,259,47,782,392,9098
84105,22477,11198,197,1308,204,133,993,329,11279
65735,51,30,0,0,0,0,0,0,21
72934,778,411,0,26,21,0,29,31,367
46349,2838,1511,47,73,13,22,24,74,1327
47501,18001,9102,118,532,165,55,374,198,8899
47836,0,0,0,0,0,0,0,0,0
48238,27051,12747,183,691,255,120,958,408,14304
41815,1045,569,28,0,0,0,0,0,476
59008,490,254,0,16,20,0,17,8,236
60911,1308,673,5,36,11,11,28,17,635
61458,669,341,0,8,1,0,3,8,328
61477,573,237,0,20,11,2,25,14,336
63623,861,462,0,36,27,10,26,20,399
55428,31222,14751,132,1271,302,98,1080,394,16471
56035,354,162,0,6,3,0,10,9,192
54139,3216,1670,15,88,62,14,123,59,1546
49649,7406,4284,68,268,100,0,207,73,3122
3602,2568,1195,21,81,38,0,54,22,1373
6117,16165,7564,211,268,104,132,317,313,8601
17251,137,71,0,3,2,0,0,3,66
25306,7250,3724,29,207,110,49,130,131,3526
21784,38390,18998,146,1213,411,258,1163,640,19392
22066,18332,8960,86,235,391,147,476,278,9372
26323,458,251,3,14,9,0,26,10,207
28704,19060,8679,63,450,230,39,638,218,10381
11769,8706,4049,20,156,117,64,155,119,4657
11952,4841,2481,71,7,88,33,128,92,2360
77515,32554,16894,184,1240,319,212,1081,319,15660
77521,59722,30206,461,1694,361,909,2470,925,29516
78590,366,164,0,0,0,0,8,3,202
79063,669,332,0,19,2,0,9,7,337
53046,1177,611,4,32,14,0,64,28,566
64505,13017,6331,61,490,199,42,315,163,6686
68317,1891,970,8,123,14,0,54,22,921
56579,1184,631,0,36,13,3,38,18,553
72149,0,0,0,0,0,0,0,0,0
73106,12683,6529,196,320,123,144,276,139,6154
73433,3002,1519,17,110,34,14,85,52,1483
73449,3106,1587,16,69,25,1,31,68,1519
15733,159,77,0,5,0,0,2,0,82
16501,1910,1084,18,14,40,7,22,26,826
11741,27149,13921,201,764,235,176,781,384,13228
13438,3253,1631,12,59,59,11,44,34,1622
14513,13970,6692,58,231,155,84,394,200,7278
18352,817,408,0,33,51,0,29,31,409
19442,0,0,0,0,0,0,0,0,0
76935,1912,856,11,30,24,0,42,31,1056
77098,13549,6448,22,494,110,35,668,207,7101
78016,10026,4569,24,295,108,94,193,368,5457
84086,421,169,0,3,19,0,5,2,252
64641,563,275,0,0,13,0,7,7,288
64701,14225,6456,64,519,131,161,392,240,7769
68461,611,299,0,0,13,0,17,12,312
68701,30531,15018,289,1019,341,152,803,320,15513
86411,217,110,0,3,5,0,4,20,107
72341,203,112,0,0,0,0,5,6,91
90245,16850,8117,46,552,132,12,689,221,8733
59434,644,305,0,18,3,4,22,17,339
51654,432,194,0,8,5,0,15,10,238
53210,27188,12162,209,823,131,224,994,460,15026
38066,2757,1481,15,46,45,20,27,66,1276
29432,3594,1638,47,108,33,18,165,24,1956
13731,880,420,0,7,18,25,13,3,460
15047,133,52,0,0,0,0,0,17,81
23354,149,77,0,0,11,0,0,0,72
43953,11656,5569,142,220,186,17,238,207,6087
44087,20595,9431,56,557,233,131,570,129,11164
97525,4450,2286,22,107,56,40,159,101,2164
61878,1310,630,0,21,15,0,32,18,680
62281,2712,1307,0,93,39,3,48,32,1405
62414,1993,1025,3,80,13,0,122,39,968
63140,276,130,1,2,1,10,4,4,146
45766,1000,461,0,12,0,0,29,19,539
50120,328,178,2,7,3,0,3,4,150
34773,3771,1849,19,171,14,0,168,75,1922
40324,47244,23407,389,1860,407,310,2028,476,23837
40729,4879,2532,55,84,34,66,148,115,2347
90071,0,0,0,0,0,0,0,0,0
97484,184,98,0,2,4,0,4,12,86
4944,37,18,0,0,0,0,0,0,19
5148,941,525,0,3,48,13,5,11,416
6330,3290,1636,35,146,16,34,131,43,1654
6511,52669,25220,810,1644,340,820,1926,336,27449
2045,10424,4834,44,172,202,45,223,295,5590
30068,32613,16181,233,784,453,135,1026,325,16432
47959,2898,1478,12,61,42,18,142,57,1420
38663,12375,5969,79,359,201,89,314,193,6406
22734,3067,1347,40,94,9,19,101,22,1720
28619,1537,702,22,38,0,15,37,30,835
31301,4006,2086,74,139,0,17,59,57,1920
34473,19522,8977,0,462,125,65,389,376,10545
50575,1017,476,1,29,22,5,40,14,541
53132,35940,18350,216,1235,433,130,1248,408,17590
23062,2427,990,0,24,0,0,19,0,1437
53570,2491,1306,15,77,35,8,73,36,1185
54470,2005,997,6,78,28,5,75,16,1008
40161,217,87,0,0,0,0,0,0,130
50551,94,48,0,3,11,0,3,5,46
32960,20960,9590,92,414,383,50,447,275,11370
56243,1685,883,16,58,12,12,51,11,802
36274,11295,5342,106,271,86,149,345,243,5953
57540,111,51,0,3,0,0,2,0,60
37019,548,325,0,9,5,0,0,0,223
47362,30010,16118,213,914,309,206,747,384,13892
66542,3097,1599,19,100,42,10,26,70,1498
62901,26217,13349,809,691,126,708,576,301,12868
12057,2036,949,35,15,54,9,76,89,1087
55009,7761,3976,44,340,61,40,230,115,3785
98195,51,17,0,17,0,0,0,0,34
33843,11136,6256,86,375,79,68,210,119,4880
93015,17817,8590,184,674,97,56,538,275,9227
37825,8288,3953,43,261,188,120,113,119,4335
57725,273,122,0,0,10,0,0,13,151
99750,688,349,3,23,2,7,8,2,339
62265,4391,2185,33,102,15,71,119,46,2206
79549,16024,8844,103,849,96,164,497,145,7180
61440,690,350,9,9,26,0,21,6,340
71454,1800,1013,22,63,27,9,28,24,787
49644,2222,1184,0,31,71,6,17,49,1038
85619,157,66,0,18,0,0,17,16,91
99335,257,119,0,7,5,0,8,9,138
92384,13,10,0,5,0,0,0,0,3
68790,862,428,0,37,6,2,25,3,434
65756,746,429,0,15,11,1,13,4,317
74010,10669,5073,68,244,66,67,277,86,5596
73735,694,273,0,23,0,7,16,14,421
74869,684,339,0,39,9,0,24,3,345
50102,146,86,0,0,0,0,0,0,60
63044,10536,4881,17,256,124,0,292,79,5655
38382,9191,4594,178,194,106,100,244,129,4597
63785,879,434,7,33,7,0,34,8,445
39739,2338,967,30,38,38,75,73,53,1371
54540,886,489,8,22,28,1,12,28,397
61931,1080,521,0,30,4,16,22,10,559
56033,386,202,10,25,4,9,9,3,184
83705,27808,14386,59,1195,309,299,1025,366,13422
48446,31008,15902,273,795,365,125,812,484,15106
85601,646,357,0,0,21,28,0,0,289
44836,2330,1176,27,88,8,22,40,31,1154
78254,58540,27552,156,2352,355,253,2793,538,30988
80211,34144,17046,51,1936,219,45,1856,310,17098
13666,228,99,0,11,0,0,17,2,129
17362,13300,6954,91,403,163,28,429,151,6346
92627,63212,32493,331,2768,534,523,2507,650,30719
25705,21825,10522,152,941,256,187,605,422,11303
8108,18252,8679,35,750,282,61,534,251,9573
99777,242,137,0,5,4,0,2,7,105
20769,7439,3638,38,218,125,0,259,121,3801
36323,7810,3876,64,150,100,94,203,228,3934
23050,852,393,0,0,17,0,0,0,459
29353,4199,2175,11,98,38,26,91,57,2024
38132,0,0,0,0,0,0,0,0,0
12090,6139,3040,0,172,119,76,192,81,3099
39563,13487,6650,74,332,137,76,442,277,6837
18340,248,110,0,0,0,0,0,0,138
18356,78,32,0,0,0,0,0,0,46
2021,23134,10857,126,660,249,101,930,346,12277
94065,12579,5756,26,521,114,43,561,113,6823
18974,41173,19768,227,1249,437,131,1123,717,21405
99033,878,454,0,18,10,4,2,25,424
19310,3149,1572,28,62,21,31,78,24,1577
2725,2421,1104,0,68,0,0,71,74,1317
19940,5538,2586,0,118,116,8,112,101,2952
57070,1537,749,9,48,18,0,61,29,788
13692,64,29,0,0,0,0,0,9,35
43072,5701,2912,47,100,126,29,78,110,2789
14720,597,290,0,25,9,0,3,13,307
32814,7155,3412,0,387,221,0,615,29,3743
32720,31819,14943,289,561,313,323,717,399,16876
50309,7008,3653,43,381,88,57,151,51,3355
20629,374,143,0,36,0,0,12,0,231
50454,73,32,0,0,0,0,0,0,41
22033,40170,19834,236,1723,344,164,1441,460,20336
17744,3132,1595,0,56,51,39,64,41,1537
48173,12631,6375,98,556,135,8,506,145,6256
12770,293,164,0,15,0,0,0,0,129
38021,20,4,0,4,0,0,4,0,16
38365,53,32,0,0,0,0,0,0,21
28330,444,195,0,0,0,0,0,0,249
46530,31593,15665,76,855,453,109,997,452,15928
74431,889,441,7,41,9,0,30,7,448
80476,178,103,0,15,0,0,2,2,75
61738,4395,2225,26,170,42,41,203,90,2170
76207,14342,7071,100,434,250,268,387,180,7271
55795,1686,933,26,83,21,0,55,29,753
45388,853,465,0,43,3,7,15,0,388
39483,6265,2899,29,174,87,92,196,99,3366
31503,20624,9769,69,470,161,53,931,343,10855
45833,10605,5075,95,358,154,92,265,172,5530
95717,106,62,0,0,0,0,0,17,44
98849,1078,508,0,57,0,1,44,7,570
36201,18052,8445,51,526,173,140,443,338,9607
80126,43801,21499,225,1495,356,281,1481,420,22302
76061,39,20,0,0,0,0,0,19,19
5448,941,475,9,35,20,4,18,22,466
94564,19200,8796,92,635,243,95,677,384,10404
7452,11826,5954,63,366,89,27,445,167,5872
89409,162,110,0,0,0,0,13,12,52
25044,291,135,21,14,8,15,33,0,156
23071,1641,777,0,86,16,3,25,27,864
56570,1165,648,9,33,22,0,30,17,517
57055,1231,676,0,33,32,0,52,16,555
11757,44115,21898,338,1067,552,348,1128,712,22217
66758,219,113,0,0,3,0,4,12,106
59318,143,74,0,8,0,0,5,0,69
68784,1981,924,28,56,26,5,36,15,1057
61475,203,113,0,13,0,0,7,3,90
59911,8226,3983,29,202,175,20,188,225,4243
55092,10836,5549,80,373,52,35,229,143,5287
35565,13266,6555,26,455,186,56,381,243,6711
64843,3372,1653,9,90,42,5,131,96,1719
65692,1424,733,0,62,16,0,38,42,691
76102,9417,4955,46,406,107,42,155,114,4462
46741,4591,2336,17,110,8,33,155,67,2255
71340,1875,1380,61,207,2,0,74,18,495
49505,32068,15693,112,1030,332,305,977,373,16375
72116,22337,10896,124,586,203,201,550,322,11441
25003,2662,1328,0,157,26,29,53,62,1334
72660,508,247,0,27,8,0,18,21,261
91605,52210,26082,440,2043,494,255,1532,788,26128
83537,1097,600,12,19,3,4,8,19,497
83861,6426,3298,36,134,109,3,211,136,3128
87527,761,370,0,0,21,0,9,21,391
6807,7390,3599,80,198,59,57,221,82,3791
95019,7703,3850,110,185,114,123,161,93,3853
4779,310,164,0,3,10,0,0,23,146
96728,453,216,8,7,8,0,15,27,237
65790,929,468,0,0,17,0,20,7,461
15537,7882,3969,51,171,69,49,187,144,3913
34669,12752,6345,21,445,204,73,277,174,6407
37721,12916,6167,30,446,120,24,447,249,6749
13310,624,328,0,13,14,0,13,0,296
74034,122,69,0,6,0,0,4,0,53
23040,4444,2061,14,37,121,30,243,45,2383
80223,20650,10814,123,1285,140,27,651,212,9836
29372,4164,2157,10,109,31,54,144,58,2007
70767,15708,7739,188,634,86,129,474,260,7969
6040,34602,16894,244,1009,172,236,960,400,17708
95125,53574,25637,189,1722,594,117,2156,939,27937
6705,24861,11767,295,584,206,0,592,409,13094
98247,9433,4858,68,269,122,73,224,67,4575
32040,7570,3701,16,116,60,0,121,136,3869
40145,698,402,0,0,12,0,0,8,296
33755,25445,12068,187,676,170,80,1000,371,13377
62530,1458,671,24,63,10,0,52,21,787
63118,28324,13676,107,967,138,165,1343,378,14648
54746,727,367,0,36,11,3,13,12,360
21903,6067,3123,136,138,104,60,139,65,2944
55706,1612,835,4,35,33,3,23,26,777
56464,4603,2364,13,145,66,9,110,82,2239
14812,3366,1727,21,117,33,10,125,33,1639
93953,4117,1937,12,30,62,0,97,68,2180
48840,12381,5901,136,212,102,35,306,311,6480
68660,1163,555,23,40,12,15,24,19,608
98004,35034,17588,29,1453,302,101,1159,497,17446
59076,88,41,0,0,0,0,0,0,47
98125,42475,20891,233,1783,492,318,1579,769,21584
63877,3671,1674,45,76,58,24,171,38,1997
72734,8469,3951,131,323,36,47,288,140,4518
92037,39724,19366,236,1103,462,432,1197,552,20358
70836,0,0,0,0,0,0,0,0,0
73024,785,359,0,9,10,0,21,5,426
79058,0,0,0,0,0,0,0,0,0
73573,2479,1229,0,56,35,9,67,42,1250
1330,1367,712,17,14,32,0,16,25,655
75035,69802,34389,252,2808,264,86,3858,586,35413
98274,17636,8940,94,522,334,153,437,188,8696
66621,689,215,23,0,0,23,0,0,474
95363,26900,13889,351,740,380,91,706,326,13011
64111,17801,9403,113,740,109,110,542,182,8398
77071,28558,12929,120,888,327,52,798,490,15629
46063,502,281,3,3,6,6,13,5,221
62943,360,188,8,0,0,0,19,0,172
49232,2557,1296,7,40,24,21,91,37,1261
17888,273,136,4,0,0,0,2,15,137
41760,5,5,0,0,0,0,0,0,0
61102,17760,9110,123,649,121,124,542,203,8650
45103,32525,16225,375,1021,405,413,1028,559,16300
53706,6072,2992,110,0,0,105,0,0,3080
37803,32158,15787,251,970,391,211,955,344,16371
38119,22947,10415,135,799,105,221,877,434,12532
38253,888,447,6,21,1,2,29,20,441
56557,2835,1400,15,86,38,21,62,32,1435
58048,399,196,2,17,4,0,29,11,203
58368,3691,1822,11,120,63,6,77,67,1869
39183,14173,6460,47,482,181,69,610,149,7713
41517,148,86,0,0,6,0,4,0,62
55772,174,84,0,2,0,0,6,0,90
54915,43045,21123,183,1532,423,136,1605,543,21922
28520,322,147,0,16,0,0,27,0,175
30055,3306,1576,24,72,77,60,77,36,1730
30553,7994,3929,33,259,117,46,175,131,4065
32148,10450,5305,5,244,92,133,237,90,5145
15108,41524,20493,241,1349,427,256,1495,749,21031
32792,50991,25062,595,1989,478,662,1887,655,25929
33179,45243,21302,306,1750,364,343,1714,553,23941
33196,51752,24552,316,1127,398,734,1783,646,27200
22842,5195,2694,55,154,60,22,231,38,2501
23607,23030,11021,337,637,225,120,517,375,12009
24651,5650,2790,26,134,29,0,102,80,2860
25511,1043,458,0,17,13,0,25,0,585
1982,8020,4057,35,212,57,66,238,108,3963
2184,37207,17588,149,1255,265,121,1500,646,19619
11729,27419,13263,152,1038,237,155,631,316,14156
1373,4634,2234,0,158,39,8,144,95,2400
93516,2335,1162,29,17,29,26,43,34,1173
54703,44093,22209,1370,1516,468,1508,1248,585,21884
14305,16683,7302,93,391,162,137,571,207,9381
15689,290,189,0,67,0,15,0,0,101
17331,51636,25048,368,1709,476,241,1500,601,26588
30360,15927,8331,138,734,86,38,513,71,7596
30477,2911,1404,48,69,10,14,84,52,1507
32303,50436,24079,411,1673,470,1151,1835,462,26357
33406,26858,13808,137,962,344,233,1145,272,13050
20778,1972,960,0,21,66,12,39,10,1012
21234,68938,32220,515,1937,845,445,2408,1249,36718
26294,947,454,0,47,23,0,30,24,493
29206,19182,9370,56,761,229,11,690,209,9812
35570,11270,5498,13,226,147,113,333,160,5772
28144,25158,12330,251,718,390,241,600,390,12828
28320,9919,4386,0,216,166,108,180,250,5533
11691,67094,30803,490,1783,570,424,2250,759,36291
12981,2301,1126,50,106,0,3,101,100,1175
5069,548,224,0,3,5,0,16,19,324
6420,4200,2068,11,104,24,14,59,71,2132
8022,8905,4453,18,193,120,56,176,103,4452
42450,3947,1829,22,86,55,0,147,49,2118
43440,4738,2441,11,17,123,18,13,137,2297
45694,11618,5226,37,283,87,80,366,192,6392
38379,1499,814,0,64,13,2,38,13,685
38580,1575,679,0,59,16,17,108,0,896
34677,22152,10485,82,579,335,192,575,363,11667
87931,768,355,0,0,0,0,15,0,413
90701,16858,8145,95,754,96,71,697,257,8713
91214,30654,14256,247,794,371,82,882,499,16398
55345,21905,10582,59,696,286,73,710,320,11323
58544,582,326,3,13,7,0,11,9,256
61523,11191,5630,54,192,198,114,329,248,5561
62076,112,60,0,0,2,0,4,0,52
65712,8588,4182,108,136,149,5,321,170,4406
67753,540,298,0,8,6,1,8,3,242
74630,752,352,11,60,7,13,23,6,400
76682,2817,1385,42,67,38,10,169,73,1432
58008,209,112,0,11,2,0,6,3,97
72167,1502,718,0,46,6,3,27,24,784
72856,285,147,4,16,0,0,11,0,138
70640,291,137,0,9,6,0,14,4,154
85346,4493,2435,0,6,0,0,143,109,2058
98103,51377,25798,88,2353,529,195,2495,568,25579
99140,422,200,4,6,4,0,9,5,222
80809,1185,639,12,9,51,0,33,55,546
82523,885,458,0,33,14,2,51,15,427
89423,10345,5094,18,192,230,26,230,201,5251
91354,32096,15824,136,1046,180,143,1397,363,16272
92325,8621,4306,74,424,117,72,127,134,4315
29129,2855,1597,13,99,3,9,9,31,1258
30230,9470,4391,37,408,143,49,361,107,5079
36726,4884,2462,31,110,23,14,147,40,2422
37311,27752,13711,394,949,248,455,958,340,14041
38240,2474,1267,11,92,13,8,67,42,1207
38641,2267,1163,33,46,7,0,52,3,1104
38659,3186,1561,30,82,0,6,204,45,1625
44115,8284,3805,59,233,81,91,191,60,4479
44125,27939,12639,89,826,246,165,850,349,15300
45011,71451,36006,714,2575,838,296,2296,805,35445
47453,770,419,0,66,0,7,15,17,351
34655,39385,18636,73,882,483,77,1128,593,20749
98830,581,283,0,26,11,3,0,17,298
99167,492,251,0,2,22,0,8,18,241
84313,89,40,0,0,0,0,0,0,49
84515,0,0,0,0,0,0,0,0,0
80123,46586,22763,249,1534,532,157,1441,767,23823
80827,717,341,0,0,41,0,0,12,376
82329,366,193,0,7,2,0,13,5,173
97423,6703,3462,95,245,36,0,217,102,3241
1029,651,331,0,11,13,10,22,3,320
40863,530,263,20,40,0,0,8,9,267
56441,3848,1869,44,128,68,52,65,91,1979
56639,436,237,2,6,6,0,17,10,199
54534,2284,1158,5,60,43,1,73,34,1126
55366,541,272,0,24,4,62,14,2,269
45005,31371,15857,211,944,220,295,781,341,15514
45867,1113,640,2,41,14,15,52,9,473
46356,17822,9207,68,519,245,63,493,230,8615
49836,863,453,0,11,10,8,25,11,410
51558,374,202,1,29,0,4,17,20,172
52002,16729,8206,83,560,256,31,536,306,8523
41005,24458,12466,121,859,183,149,897,316,11992
59480,678,288,3,44,4,0,0,10,390
61564,962,440,9,25,6,6,33,0,522
31778,2316,1089,0,40,29,13,51,49,1227
33647,67730,32934,510,2375,529,423,3010,730,34796
17002,769,421,0,13,9,0,11,3,348
14005,1973,1021,0,87,6,6,73,18,952
24185,563,281,0,14,13,36,14,0,282
24326,1286,627,0,14,8,13,18,34,659
17763,161,70,0,0,0,0,4,0,91
95815,25224,13072,263,1027,280,81,861,201,12152
99357,4396,2561,105,105,0,66,112,38,1835
94062,27757,13496,42,723,336,84,614,343,14261
16801,44641,23738,2407,786,253,2100,721,396,20903
17067,15259,7296,145,289,93,106,349,186,7963
18239,412,155,10,0,0,0,0,0,257
35460,864,446,0,2,0,6,12,12,418
35584,387,226,0,9,6,0,18,8,161
26815,754,418,0,30,16,0,8,0,336
27613,42933,21062,159,1538,364,126,1568,390,21871
8879,22733,11675,83,695,173,76,861,337,11058
925,6924,3234,168,218,69,167,141,29,3690
72685,1246,629,0,20,40,0,28,46,617
73109,23144,11780,143,1061,139,70,812,197,11364
73450,1344,701,0,15,25,8,17,25,643
49304,3839,1945,17,107,81,4,108,73,1894
90302,30828,14160,316,1235,251,176,1173,387,16668
97103,17907,9012,81,592,302,77,570,413,8895
76123,34056,16582,341,1344,81,189,1545,467,17474
83616,28275,14131,99,482,499,57,648,374,14144
85007,14751,7211,133,543,91,62,540,164,7540
38630,291,102,0,0,0,0,0,12,189
38858,6613,3410,53,150,100,8,104,66,3203
65329,427,230,0,6,0,0,0,3,197
66079,737,342,0,24,8,9,22,56,395
66440,1737,842,2,52,7,17,66,35,895
80721,295,158,0,0,8,0,0,0,137
83839,1165,585,0,0,69,0,48,0,580
59525,298,144,0,10,3,1,9,5,154
61234,1267,606,6,30,16,6,34,28,661
61739,4577,2225,73,106,22,7,113,91,2352
61815,259,133,2,8,2,11,12,7,126
56545,657,339,3,11,6,0,13,10,318
62854,1716,858,11,89,12,14,45,33,858
64136,2220,994,0,96,0,0,37,38,1226
70053,16310,8316,127,778,211,82,535,342,7994
25183,44,25,0,0,0,0,0,0,19
14743,1780,889,12,41,7,0,28,45,891
33438,265,121,0,12,0,0,0,37,144
21036,2275,1158,24,67,39,0,74,21,1117
21237,30286,13966,84,1131,267,133,1160,605,16320
21538,408,200,4,5,0,4,4,4,208
23032,304,143,0,0,0,0,0,0,161
19040,20586,10045,92,582,192,110,606,284,10541
53018,7936,4050,19,125,121,21,157,125,3886
54889,2536,1300,15,97,35,13,54,38,1236
55991,1383,676,10,51,30,0,47,19,707
36858,260,141,16,0,10,0,0,2,119
75407,16582,8083,131,669,109,69,669,117,8499
75638,5777,2819,0,68,81,16,164,117,2958
76263,158,96,0,3,0,0,0,8,62
66417,395,204,2,15,0,0,16,12,191
72333,709,323,0,57,4,19,61,15,386
74572,633,303,2,22,3,8,24,3,330
43032,19,19,0,0,0,0,0,0,0
43153,742,396,14,8,10,19,27,24,346
44138,22378,10884,105,636,303,185,688,297,11494
65603,172,98,0,8,6,0,8,0,74
71373,6252,3095,64,182,61,95,171,93,3157
28365,16886,8327,246,501,143,106,373,193,8559
49612,1164,596,0,60,31,0,19,28,568
50624,1657,803,9,42,17,9,40,32,854
51334,7014,3582,40,167,64,40,157,117,3432
53050,6679,3185,25,154,106,42,202,90,3494
96051,1351,656,0,38,34,17,48,6,695
79042,1046,613,13,21,8,8,42,2,433
89450,61,28,0,0,0,0,0,0,33
91355,31455,15712,276,833,338,164,985,416,15743
92004,2414,1249,57,0,23,0,39,16,1165
20628,279,166,0,0,28,0,25,0,113
21226,6257,2589,4,144,12,39,225,36,3668
3449,1785,846,0,30,41,19,34,46,939
5855,7147,3703,49,341,88,8,223,150,3444
12534,17967,8843,62,570,201,209,500,214,9124
12814,1354,709,0,21,25,0,15,39,645
13031,15451,7509,106,356,143,21,371,189,7942
18085,966,490,7,16,3,7,22,14,476
1344,1459,661,10,67,20,0,53,19,798
38547,1935,982,0,127,15,0,40,78,953
40245,34409,16624,56,798,247,116,1261,593,17785
33334,29478,16136,139,1168,308,141,1195,464,13342
47460,10916,5363,46,311,197,35,359,135,5553
34731,13218,6245,147,406,350,201,416,438,6973
35033,3107,1602,15,109,24,26,128,44,1505
24539,121,57,0,0,0,0,0,8,64
25159,5121,2373,11,93,17,23,126,55,2748
25862,130,73,0,18,25,0,0,0,57
42634,1839,806,0,87,32,24,47,12,1033
48152,31194,15091,137,737,444,39,925,641,16103
95632,31431,15447,104,962,298,45,933,283,15984
95667,36620,17439,252,1035,759,119,788,617,19181
97826,1017,526,0,32,23,0,31,8,491
82604,27148,13411,208,1152,259,77,1004,377,13737
85542,3623,1564,9,87,40,34,171,50,2059
86322,12002,6371,105,400,192,50,279,249,5631
76627,1574,683,8,60,16,0,42,24,891
66423,973,417,0,12,0,5,21,5,556
68112,11574,5367,42,436,76,50,406,121,6207
57233,152,75,0,4,1,0,4,9,77
57741,84,63,0,0,0,0,0,0,21
58854,8529,4749,77,238,110,41,177,79,3780
59050,1541,736,19,28,0,8,35,14,805
49666,202,133,75,0,0,0,0,0,69
54151,3318,1636,21,103,58,8,89,85,1682
45230,27778,13418,184,929,317,151,908,266,14360
45368,4907,2485,21,109,104,20,195,39,2422
45624,0,0,0,0,0,0,0,0,0
46348,1116,538,0,27,11,14,31,7,578
70789,566,270,0,36,10,4,16,4,296
55124,51931,25818,202,1837,514,368,1723,998,26113
48088,21844,10608,85,616,157,72,747,371,11236
49101,3025,1456,7,120,12,0,80,73,1569
29051,2007,1635,171,161,13,0,28,17,372
44250,1110,638,0,40,54,0,29,25,472
37098,6802,3234,65,281,0,0,370,48,3568
38541,1659,744,0,44,37,23,18,38,915
28318,4371,2226,0,145,21,5,177,86,2145
30522,897,490,14,0,39,0,0,27,407
73032,214,122,2,6,0,1,4,2,92
73162,29747,14068,250,940,376,195,1081,486,15679
73758,93,51,0,8,6,0,5,0,42
74104,11454,5850,287,338,47,200,398,139,5604
74734,1157,559,3,40,18,12,20,21,598
75148,6060,2968,37,191,89,27,194,121,3092
81655,105,57,0,0,0,0,0,0,48
96061,19,8,0,0,0,0,0,0,11
96145,2151,1130,0,81,45,0,62,39,1021
15468,2288,1225,1,48,15,0,74,32,1063
16311,505,225,0,9,5,3,8,2,280
17215,304,143,0,8,3,8,7,16,161
18655,5694,2815,0,106,106,17,139,62,2879
20020,56131,24907,429,1723,368,381,2194,547,31224
20120,41733,20715,264,1690,401,139,1694,616,21018
23112,53162,26111,334,1845,523,79,2114,736,27051
24018,37584,17913,134,1264,384,76,1203,698,19671
3229,5670,2759,0,144,48,45,94,121,2911
74760,335,164,0,0,6,8,5,5,171
75104,49341,23360,223,1740,241,211,2373,738,25981
77006,22632,12071,83,943,238,200,856,341,10561
80108,27101,13375,86,842,228,169,605,298,13726
78941,3143,1578,33,169,115,6,176,77,1565
79233,116,69,0,0,0,0,2,0,47
98547,1265,655,0,5,71,5,0,11,610
87752,355,180,0,28,7,0,0,0,175
93247,18522,9855,182,492,197,154,455,148,8667
28460,10490,5991,271,286,102,72,335,88,4499
28705,7139,3627,66,211,149,29,86,103,3512
30609,2291,935,0,0,0,0,0,0,1356
34237,17307,8871,75,661,252,164,488,257,8436
35452,3061,1410,27,79,7,0,54,75,1651
41713,107,0,0,0,0,0,0,0,107
43947,5297,2546,63,86,113,0,90,75,2751
4655,1050,617,0,21,35,0,19,21,433
5035,693,354,0,19,7,0,27,46,339
1119,13626,6196,116,218,171,183,352,232,7430
1523,7749,4587,61,362,119,0,233,49,3162
1571,11682,5655,86,222,150,221,366,169,6027
1835,13166,6271,71,468,119,109,478,216,6895
22003,59586,29933,270,2875,635,563,1900,893,29653
22645,4395,2333,25,95,71,29,87,88,2062
22719,271,167,72,0,13,0,0,30,104
23224,40445,19689,470,1108,161,123,1235,564,20756
26275,515,201,0,18,0,4,4,0,314
16625,3738,1752,50,39,90,14,83,29,1986
16141,1817,953,1,48,8,5,49,15,864
10170,0,0,0,0,0,0,0,0,0
91762,60699,29786,537,2149,573,389,2184,764,30913
97438,1098,549,0,19,22,6,16,24,549
97842,134,69,8,0,6,0,0,4,65
98650,916,419,0,15,22,0,29,12,497
98663,14318,7250,61,623,159,35,582,183,7068
21654,960,461,0,6,30,6,8,14,499
36541,15635,7151,110,274,262,144,469,377,8484
79001,200,98,0,3,0,0,11,4,102
79532,696,342,7,31,13,2,16,10,354
80222,23044,11676,87,1089,183,28,814,410,11368
81052,9060,4522,92,195,118,8,363,171,4538
82944,118,38,0,0,0,0,8,0,80
83523,755,398,0,25,16,2,15,25,357
68010,900,230,0,2,0,0,2,0,670
68333,8565,4278,63,371,97,189,200,40,4287
68364,110,63,0,5,1,0,9,1,47
70780,1325,760,0,53,25,0,31,24,565
71046,1135,538,2,3,24,0,11,53,597
71968,4067,2124,225,167,24,0,202,92,1943
72374,731,320,0,28,33,0,92,30,411
72801,19689,9586,279,451,108,339,440,152,10103
85933,2659,1439,28,55,86,0,36,131,1220
64653,704,326,0,9,1,10,33,8,378
64763,1418,689,0,13,2,0,20,38,729
56729,119,69,0,4,0,0,3,2,50
48739,3940,1888,41,50,90,9,80,83,2052
49614,2824,1420,20,57,54,17,51,60,1404
50273,8339,4212,82,431,107,0,434,131,4127
39766,3424,1721,115,191,19,0,178,23,1703
34681,775,399,0,0,28,0,37,0,376
35559,12,6,0,0,0,0,0,0,6
43821,4389,2216,16,105,43,26,97,46,2173
53581,10131,4992,36,249,129,20,252,126,5139
54827,253,144,0,6,8,0,1,3,109
62264,3745,2042,7,95,12,15,120,52,1703
70743,163,97,0,0,3,0,0,5,66
79785,77,39,0,5,0,5,6,0,38
80303,24631,13049,396,592,254,613,552,268,11582
75205,24879,11651,288,695,213,303,600,360,13228
76018,31729,15167,416,1652,249,124,1271,312,16562
76798,1568,424,37,0,0,6,0,0,1144
76958,146,56,0,0,0,0,0,10,90
58472,479,234,10,18,7,4,18,11,245
17943,105,60,0,23,0,0,0,12,45
15377,594,303,8,3,3,3,7,8,291
16331,63,30,0,0,0,0,0,0,33
28227,55769,26697,339,1509,568,156,2097,910,29072
32439,9964,5053,130,424,148,43,401,149,4911
32820,9240,4558,43,291,66,116,526,125,4682
33578,49634,23414,433,2167,288,293,1994,530,26220
34108,16636,8232,0,324,342,14,261,287,8404
36870,21208,11059,175,528,160,111,860,456,10149
40763,398,218,0,0,0,0,0,6,180
44275,3280,1687,17,139,40,32,71,43,1593
44718,11895,5611,65,322,171,19,288,285,6284
54525,243,119,0,7,0,0,21,4,124
55379,44986,22423,214,2219,351,308,2035,368,22563
49745,1013,486,0,9,38,3,34,16,527
49838,507,296,0,14,10,0,8,2,211
30340,28028,14777,195,1084,201,166,972,193,13251
13680,1460,682,27,13,9,11,32,15,778
16613,1379,649,8,32,31,3,35,27,730
20622,6301,3624,50,177,116,29,140,68,2677
20724,17736,8259,155,794,170,88,972,208,9477
23065,1685,855,0,48,22,0,93,88,830
4497,283,139,0,0,5,0,0,16,144
10710,26410,12254,149,583,239,182,983,284,14156
11803,28018,13835,60,839,436,146,984,464,14183
75435,1271,648,7,42,11,15,67,15,623
75974,3411,1612,48,80,10,0,122,78,1799
76459,241,135,8,4,0,0,0,4,106
65283,429,225,0,9,36,2,0,0,204
16112,1588,847,6,48,8,5,52,2,741
3293,195,62,0,0,0,0,0,0,133
6456,304,109,0,0,0,0,27,26,195
7041,7075,3424,18,205,100,16,302,62,3651
22920,3612,1759,0,88,72,5,105,115,1853
23950,3733,1814,43,85,28,0,86,53,1919
76238,353,178,0,3,0,0,13,13,175
77539,44041,22529,296,1536,553,162,1314,897,21512
95941,497,218,0,0,70,0,0,0,279
6706,14191,6840,97,444,185,98,424,204,7351
61469,2248,1176,0,34,48,7,41,34,1072
61858,3017,1404,12,44,46,25,60,39,1613
19446,56398,26808,313,1934,687,324,1746,800,29590
21201,17136,7876,108,556,71,183,396,208,9260
60154,16573,7835,94,549,342,62,733,194,8738
4003,324,150,0,13,0,15,13,0,174
61764,14026,7479,121,550,137,38,398,190,6547
5055,3219,1562,18,110,31,0,110,55,1657
71452,146,59,0,0,0,0,0,2,87
14838,1786,920,20,42,15,19,34,17,866
87018,606,310,12,10,6,0,16,5,296
15448,316,201,0,38,0,24,10,21,115
88267,1233,581,0,32,17,0,42,9,652
75966,4619,2312,40,61,104,6,88,63,2307
13483,324,180,0,7,11,0,0,7,144
15551,751,392,3,19,24,0,17,5,359
15748,6699,3439,27,167,92,16,178,112,3260
17016,890,462,0,30,0,0,29,0,428
31005,17530,8183,0,497,180,89,558,170,9347
24646,785,441,0,5,0,0,7,29,344
26161,418,235,0,15,9,0,23,0,183
20853,31178,15417,196,940,260,158,849,543,15761
21675,108,58,0,16,5,0,0,7,50
22834,1063,531,0,34,20,0,10,64,532
18078,7501,3870,48,181,75,43,134,117,3631
19403,46165,23126,218,1663,462,144,1297,570,23039
11426,20801,10388,229,649,174,103,594,189,10413
28160,3586,1722,2,52,12,24,134,135,1864
53952,3244,1603,8,54,69,18,70,69,1641
55303,49377,24869,334,1584,388,266,1706,544,24508
55922,1028,547,7,34,7,18,32,11,481
37620,38969,19030,162,1102,586,162,1151,816,19939
38344,8016,3912,41,234,95,30,103,94,4104
12966,2685,1398,52,116,23,23,66,20,1287
13327,2056,1027,15,26,11,4,50,17,1029
14025,3223,1588,0,46,104,17,29,68,1635
18235,19059,9564,104,655,346,31,425,254,9495
77587,17040,9103,173,432,122,124,458,79,7937
82513,1585,794,0,30,39,0,45,56,791
83420,2295,1223,25,93,11,2,54,22,1072
67340,452,241,7,19,8,0,7,1,211
68865,1015,501,0,6,7,2,54,25,514
68942,315,173,0,23,5,0,9,0,142
69166,673,342,0,23,3,0,16,8,331
72937,3275,1622,5,68,81,19,78,60,1653
73543,1529,781,13,23,20,7,44,18,748
74002,1953,965,0,52,35,0,56,43,988
3259,336,168,0,4,14,0,2,28,168
8520,27093,13190,210,1058,156,210,952,208,13903
8831,50174,23924,119,868,828,73,1355,566,26250
921,33394,14751,338,1135,386,289,1125,676,18643
38117,25881,12339,179,998,352,114,969,459,13542
43154,3770,1901,24,221,20,0,174,37,1869
43345,742,386,12,16,11,2,37,6,356
43437,578,280,3,16,5,0,19,9,298
98267,346,144,0,22,0,0,0,32,202
54665,8035,3930,16,282,138,11,255,153,4105
61452,222,102,0,7,3,0,0,1,120
62964,1291,681,4,28,21,9,3,77,610
63563,834,444,28,9,3,12,33,0,390
43022,4500,2184,135,51,20,187,83,51,2316
43413,1522,723,19,36,16,15,30,24,799
87712,309,137,0,0,0,0,50,0,172
89110,71573,35611,668,2049,432,712,2125,545,35962
99022,8487,4170,64,122,104,74,246,13,4317
99658,762,403,14,14,4,8,16,7,359
92389,146,75,0,0,7,0,4,0,71
95465,2104,1041,19,37,45,0,80,34,1063
95589,982,580,0,30,12,0,56,36,402
95747,65335,31350,360,2259,482,483,2681,614,33985
2891,21085,9852,89,446,294,224,530,407,11233
6057,6371,3071,0,201,56,82,193,145,3300
6084,14766,7434,173,370,94,83,225,274,7332
96116,159,83,0,0,35,0,0,27,76
32210,61496,29477,292,1832,598,246,2176,917,32019
29692,4711,2361,16,135,70,29,58,72,2350
31829,956,447,24,14,16,15,12,0,509
35553,4422,2376,27,84,20,17,103,26,2046
36453,2423,1264,27,75,14,2,79,52,1159
37080,7349,3731,4,187,197,36,82,139,3618
37691,863,444,0,31,0,0,73,16,419
38029,0,0,0,0,0,0,0,0,0
17572,4893,2317,43,57,8,35,99,40,2576
20010,34713,17410,88,1862,77,117,1657,271,17303
20602,26078,12147,131,924,183,100,1236,432,13931
22015,44852,21948,342,1432,525,272,1745,720,22904
32712,46662,23827,562,1418,598,158,1501,607,22835
33410,35597,16036,104,1188,267,177,1452,540,19561
26623,1319,652,0,46,0,0,22,0,667
38645,1292,586,0,34,10,5,38,13,706
49419,8402,4398,73,215,82,61,336,91,4004
49450,3362,1446,0,122,13,0,186,116,1916
51016,1247,625,3,17,47,7,46,19,622
56167,762,452,0,10,9,2,18,7,310
58075,9231,4921,51,325,121,63,203,115,4310
58773,948,503,0,42,14,6,25,2,445
59865,3726,1902,22,154,35,6,118,92,1824
59913,509,284,0,33,8,0,16,8,225
60046,35286,17646,272,822,418,89,995,401,17640
44402,3228,1449,11,45,29,0,38,38,1779
44802,951,475,5,12,3,6,27,4,476
68933,898,465,0,17,19,5,21,10,433
62617,669,319,3,47,18,4,12,14,350
64865,6278,3234,6,110,129,104,130,133,3044
55312,1487,714,0,31,27,8,40,20,773
61801,31157,16296,1246,703,198,1140,461,303,14861
61956,2709,1370,43,79,33,9,74,69,1339
62410,1249,596,1,71,39,13,49,34,653
75154,39949,19474,273,1333,319,173,1609,408,20475
75572,4173,2149,32,50,39,36,133,22,2024
97544,2274,1124,22,47,24,9,37,26,1150
98312,31330,15601,174,1252,508,195,796,366,15729
32821,17374,8142,89,826,57,193,652,202,9232
33823,32139,15586,207,1053,186,93,947,509,16553
31028,6464,3225,8,224,99,0,249,15,3239
34432,12583,6115,62,151,218,33,266,213,6468
37165,43,26,0,0,5,0,1,0,17
38134,44853,23560,356,1975,388,284,1646,553,21293
56649,9210,4587,117,236,104,65,172,122,4623
56748,688,367,0,37,5,14,33,6,321
57256,102,52,0,11,0,0,4,0,50
58339,26,21,0,9,0,0,2,0,5
94015,64887,31685,458,2743,695,447,2436,949,33202
94576,98,58,0,0,3,0,0,0,40
94578,41059,19175,288,1166,419,219,1592,584,21884
95054,24264,12545,77,1390,128,358,1209,128,11719
87518,9,0,0,0,0,0,0,0,9
87569,460,206,0,0,0,0,0,21,254
65287,342,164,0,0,9,0,0,4,178
67523,562,289,0,29,22,0,9,0,273
68767,3398,1694,0,136,14,20,132,29,1704
61524,381,177,6,5,4,0,7,0,204
62352,232,110,0,8,0,0,0,1,122
50123,671,386,3,11,9,2,15,11,285
50524,650,363,3,25,3,0,7,9,287
52070,903,528,0,24,36,0,18,5,375
54622,2001,1009,7,53,45,0,48,46,992
54726,1850,952,2,50,13,14,63,14,898
54732,3091,1530,15,82,31,8,46,41,1561
57645,170,90,0,0,3,0,8,5,80
58033,517,263,0,6,12,1,35,6,254
62969,398,153,0,4,0,0,0,4,245
72519,3789,2221,52,185,65,14,46,47,1568
72642,2038,959,0,93,60,0,62,114,1079
74726,2345,1095,9,73,18,3,75,30,1250
71367,1494,821,0,119,52,0,62,28,673
97914,19211,10971,311,902,297,82,448,259,8240
78239,29255,14311,120,990,161,104,978,327,14944
77615,910,579,19,14,6,0,26,8,331
86547,1232,576,6,33,3,8,56,0,656
56294,76,41,0,0,2,2,0,0,35
59312,26,10,0,0,2,0,0,2,16
59547,63,29,0,6,0,0,0,0,34
59711,8905,4632,32,276,176,48,228,138,4273
73018,20214,9821,219,628,167,109,617,204,10393
75230,27872,13283,99,923,367,309,921,435,14589
49620,2707,1405,9,52,27,26,125,44,1302
53948,8108,4184,49,244,97,51,187,123,3924
63120,8691,4177,105,277,76,89,159,61,4514
98356,2245,1189,0,29,52,12,119,64,1056
99559,7888,4089,63,351,58,94,276,74,3799
93266,1406,637,0,51,11,0,60,0,769
79244,855,392,0,5,16,10,26,0,463
80018,13046,6721,70,518,102,37,638,191,6325
47977,2235,1128,13,104,20,15,54,21,1107
8352,615,292,0,31,6,0,8,6,323
1952,9227,4635,108,209,126,33,233,136,4592
2032,4455,2296,0,200,30,0,253,34,2159
28746,2371,1221,0,48,93,0,69,38,1150
64874,767,379,16,0,2,6,8,16,388
65037,4465,2158,13,182,101,0,114,81,2307
65624,1509,755,0,26,33,0,0,57,754
65740,3264,1591,4,64,48,6,157,27,1673
66735,513,250,0,9,8,54,25,6,263
59301,11492,5755,68,403,118,34,335,149,5737
96822,46645,22633,380,1487,741,589,1319,596,24012
67235,13210,6424,78,328,137,58,411,275,6786
67457,836,376,0,27,7,14,11,12,460
70067,2888,1531,0,145,61,11,84,97,1357
70648,8864,5359,220,474,94,50,223,82,3505
76472,1699,826,0,112,62,0,89,41,873
76945,1712,825,14,47,38,0,71,27,887
78102,28662,17830,398,1699,271,153,536,238,10832
93276,186,106,4,7,1,0,1,2,80
74701,25267,12244,335,848,187,270,637,302,13023
75080,51710,25822,544,1867,635,515,1782,526,25888
75254,26828,12897,84,923,60,203,783,205,13931
84655,12405,6494,141,645,70,73,556,144,5911
65738,18814,9496,126,399,130,73,778,132,9318
87104,13486,6860,91,419,150,72,431,206,6626
87535,1122,530,0,56,9,0,49,0,592
72081,7157,3936,0,266,46,6,141,152,3221
72738,2478,1345,0,56,8,0,79,17,1133
73716,497,246,0,0,3,0,8,4,251
40824,317,172,0,0,0,17,0,12,145
58576,954,476,3,16,9,2,18,26,478
61917,771,396,0,15,3,1,25,3,375
62312,1933,895,0,48,17,17,80,18,1038
52217,614,270,0,16,3,0,6,2,344
52748,10397,4955,20,257,110,95,392,102,5442
53920,401,224,4,23,8,0,2,7,177
54501,19858,9872,81,573,267,144,481,317,9986
4479,1272,638,0,30,18,8,21,27,634
5676,4862,2399,29,160,61,50,161,103,2463
15928,1475,595,0,25,12,0,0,16,880
23881,2031,1027,0,87,95,41,82,12,1004
10301,38733,18449,282,1071,444,404,1291,513,20284
76511,2753,1726,17,103,16,40,142,18,1027
76704,7538,3505,59,186,64,16,219,211,4033
77867,130,72,7,3,2,0,11,2,58
79014,4052,1966,0,176,63,33,176,18,2086
61912,1227,556,3,27,26,17,35,38,671
62097,3064,1511,33,42,75,0,123,34,1553
62353,5346,3612,66,397,64,6,175,23,1734
65649,1615,773,14,13,20,7,19,18,842
66015,841,428,10,15,9,0,31,5,413
66035,1284,683,6,25,10,23,20,9,601
67731,769,420,0,42,3,0,37,5,349
68378,722,321,0,23,12,6,44,21,401
56458,359,178,2,14,6,3,10,17,181
74722,272,121,8,9,3,0,13,4,151
33166,24830,13128,195,922,276,155,767,275,11702
33181,19986,10136,141,884,117,136,749,250,9850
53518,1353,723,4,27,24,9,34,15,630
53703,33467,17437,1825,922,176,2053,633,218,16030
56474,4080,2142,19,105,67,22,108,65,1938
56549,4824,2394,25,210,56,7,147,67,2430
41011,25886,13129,129,1035,276,152,1033,322,12757
42276,14272,6727,75,473,137,51,455,273,7545
44675,1825,954,4,27,90,26,24,61,871
38958,0,0,0,0,0,0,0,0,0
39730,11197,5336,28,354,141,87,365,133,5861
31721,20572,9317,214,607,242,43,608,347,11255
46382,1705,780,10,55,6,28,39,37,925
46532,1594,754,12,31,9,7,41,68,840
47394,8167,4000,26,178,96,69,184,157,4167
49251,6172,3009,20,150,104,32,215,56,3163
36532,33743,15598,10,839,560,108,928,524,18145
17885,214,125,0,0,0,0,3,0,89
6068,1396,660,0,14,10,0,12,27,736
10705,40733,19979,389,1400,433,570,1277,461,20754
11720,28556,13967,276,929,181,313,937,418,14589
12970,984,651,54,2,2,3,15,8,333
22309,36325,18088,151,1630,315,264,1231,294,18237
13605,4816,2370,16,84,34,9,179,34,2446
13801,1413,772,0,33,18,0,56,33,641
14479,146,82,0,0,0,0,0,10,64
15088,501,226,0,34,5,0,9,6,275
94513,62991,30581,588,1644,460,383,1986,736,32410
95006,9238,4712,35,525,232,28,354,262,4526
90802,39453,20958,211,1475,384,224,1655,564,18495
92404,61216,29977,456,1802,268,883,2076,682,31239
98390,11016,5209,0,277,68,8,367,111,5807
87582,460,182,0,40,21,0,46,0,278
2134,19424,10118,313,683,100,458,299,72,9306
1097,59,21,0,0,0,0,3,0,38
61349,863,434,7,21,14,3,16,8,429
63437,1510,783,16,41,18,0,42,27,727
79854,85,51,0,9,0,0,0,0,34
80729,669,344,0,34,15,3,10,11,325
71049,3503,1548,62,93,51,29,124,91,1955
72768,974,517,0,32,5,19,32,15,457
81227,6,0,0,0,0,0,0,0,6
85901,18344,9000,79,437,260,35,535,326,9344
68854,853,410,3,19,5,2,19,21,443
65010,6197,3139,8,200,78,40,284,47,3058
74636,285,149,0,16,5,4,17,0,136
46039,520,276,0,0,10,0,0,18,244
48070,6340,3014,30,191,70,0,198,106,3326
57334,969,475,1,36,11,14,34,4,494
51028,2337,1109,15,22,30,9,64,18,1228
35233,1715,1020,18,101,8,69,72,0,695
3814,2353,1122,0,33,14,0,100,4,1231
4105,11806,5686,50,409,125,46,339,203,6120
6752,1716,821,0,18,24,3,23,24,895
7072,6191,3029,33,305,47,112,219,69,3162
15447,92,36,0,0,1,0,0,0,56
17403,39641,18857,383,1140,365,408,1242,573,20784
30205,2864,1429,46,60,23,19,72,24,1435
30621,5726,2749,26,204,105,45,151,80,2977
24054,6740,3164,81,129,76,0,162,79,3576
24523,20085,9469,130,446,218,128,629,315,10616
8048,12227,5893,58,308,83,72,417,191,6334
20634,7334,3613,33,224,25,72,260,249,3721
20765,415,250,0,0,9,0,21,9,165
22031,32826,16508,150,1262,249,98,1405,368,16318
12409,771,401,0,21,21,0,0,8,370
29943,524,349,0,0,0,0,0,22,175
30046,37218,18429,235,1459,435,273,1373,405,18789
28103,11397,5714,46,345,171,28,287,118,5683
80733,450,219,9,23,10,9,6,30,231
83539,2293,1132,8,51,50,18,69,49,1161
63071,1075,534,11,31,22,11,15,20,541
64060,14357,7011,119,329,73,38,397,105,7346
64673,2402,1169,6,22,16,0,70,43,1233
64863,1694,921,12,65,30,10,73,39,773
73755,820,377,0,6,14,0,29,16,443
75028,46782,22831,292,1336,323,173,1772,526,23951
75683,3873,1910,36,55,38,26,109,107,1963
77480,8178,4301,10,124,129,0,77,80,3877
77950,160,88,0,8,5,0,4,2,72
78050,444,276,0,0,0,0,14,0,168
85342,1380,631,0,10,7,0,21,54,749
79738,270,129,0,0,0,14,6,9,141
95919,1182,702,48,0,50,0,65,14,480
93272,4454,2346,56,144,59,40,126,14,2108
47838,3585,2744,29,373,59,10,57,19,841
44128,28790,12453,136,583,296,196,582,523,16337
14060,289,165,0,10,3,0,6,9,124
16843,627,352,0,0,15,10,9,0,275
23824,6572,3238,30,103,52,0,269,67,3334
24813,192,75,0,14,0,0,0,0,117
8619,21013,9826,98,701,221,142,770,273,11187
29160,7833,4001,84,196,130,44,217,132,3832
29926,25875,12727,156,496,427,106,492,418,13148
19475,11239,5859,56,229,166,36,195,151,5380
27265,50139,23848,531,1532,497,301,1831,581,26291
28120,21119,10255,195,871,187,110,864,218,10864
24862,543,246,0,28,0,0,30,31,297
25067,1184,639,7,61,7,0,4,15,545
42088,2511,1135,35,34,41,20,94,32,1376
43555,313,152,0,11,0,5,18,11,161
736,47411,22932,267,1244,709,265,1476,588,24479
27316,7157,3709,4,101,57,67,103,70,3448
45750,26906,13211,275,897,323,281,718,410,13695
33542,21101,9890,85,521,252,104,355,225,11211
58463,649,302,0,15,8,5,24,12,347
61024,2534,1266,22,52,83,3,56,67,1268
61363,266,153,8,10,1,0,2,3,113
68850,12214,6458,69,400,144,46,260,136,5756
76371,1376,656,13,24,8,8,0,14,720
80030,16607,8329,121,785,121,128,767,202,8278
64485,7918,3786,22,203,75,0,147,73,4132
66522,58,33,21,0,0,0,0,0,25
67448,1206,636,0,48,35,0,56,4,570
68131,13502,6844,185,585,106,272,472,85,6658
56166,207,95,0,9,0,6,3,1,112
57571,4,2,0,0,0,0,0,0,2
63106,11409,4614,26,170,66,81,453,72,6795
63629,1422,738,28,25,24,0,34,17,684
72670,87,42,0,0,0,0,0,0,45
80453,237,159,0,0,8,0,0,0,78
82711,122,55,0,0,0,0,0,0,67
75025,53688,26840,266,1462,384,197,1986,714,26848
76058,18535,9393,139,481,164,92,529,171,9142
87516,102,32,0,0,0,0,0,0,70
92333,316,142,0,17,21,0,0,7,174
92596,30573,15808,171,1385,174,91,1357,400,14765
94512,16,16,0,0,0,0,0,0,0
98281,1191,580,0,5,32,11,24,24,611
99105,45,19,0,2,1,0,0,0,26
99548,51,27,0,2,0,0,0,0,24
2836,187,115,0,0,0,0,0,0,72
6441,5026,2482,0,165,48,23,132,52,2544
7719,21331,10531,45,607,335,122,392,369,10800
36507,22096,10943,145,560,259,124,477,204,11153
53227,23891,11271,116,812,389,151,736,408,12620
53533,7070,3706,62,311,112,30,278,56,3364
56673,719,401,0,11,20,3,20,4,318
72170,230,111,0,14,7,1,8,5,119
50212,2902,1448,51,59,30,9,52,41,1454
50275,566,292,0,21,7,0,1,5,274
39667,12418,6126,33,545,101,78,521,212,6292
46118,4944,2574,73,151,93,53,88,49,2370
29824,8253,4985,64,485,148,0,165,166,3268
25303,7071,3217,16,191,112,26,267,101,3854
49654,519,257,0,5,22,0,5,42,262
50450,2705,1325,0,61,28,14,86,28,1380
52594,299,147,0,14,1,0,5,7,152
54307,1105,1105,27,163,11,0,0,0,0
54812,5570,2661,19,123,38,53,167,75,2909
55011,10494,5398,47,374,139,32,270,146,5096
56036,1879,1008,8,61,37,6,27,34,871
56144,1107,532,0,22,5,0,27,7,575
56667,581,316,3,18,7,0,15,8,265
42001,28782,13679,162,636,298,81,815,402,15103
43443,1920,1031,5,52,14,0,80,29,889
38588,757,413,6,0,12,0,9,3,344
40025,48,20,0,0,0,0,0,0,28
33971,27255,13632,129,832,104,206,992,304,13623
34787,64723,30749,432,1908,227,305,2410,840,33974
37028,778,472,0,10,3,0,0,14,306
16621,715,341,5,11,9,5,28,0,374
11104,26119,12954,106,1634,264,77,1108,268,13165
11939,954,402,0,27,19,0,44,23,552
13030,4057,2269,15,196,44,19,80,16,1788
24586,6131,2718,57,77,36,25,202,22,3413
24602,676,276,0,22,13,0,63,0,400
19943,11590,5346,10,362,158,31,425,200,6244
20105,21385,10399,44,1438,104,59,1459,182,10986
20882,13450,6769,76,305,236,71,226,332,6681
21030,25637,12580,119,921,275,47,697,279,13057
95568,253,153,0,6,14,0,0,5,100
96782,38335,19578,618,1153,437,153,1329,548,18757
97001,354,111,0,17,4,0,18,0,243
92358,782,394,0,31,16,0,21,58,388
97523,5586,2641,0,82,157,0,101,122,2945
98565,769,404,0,43,3,0,27,8,365
88029,1244,689,0,0,21,0,18,56,555
2889,27333,13387,188,702,418,208,686,465,13946
3106,14203,6799,212,339,209,175,457,202,7404
769,39121,18989,238,1403,460,324,1224,652,20132
60552,4401,2303,35,156,34,19,129,68,2098
61519,230,119,0,14,4,0,0,0,111
64068,38439,18972,173,1403,357,271,1363,647,19467
79110,19138,9503,281,827,109,75,694,240,9635
80010,43477,22302,250,1991,224,305,1372,307,21175
70039,2691,1295,0,51,24,66,50,0,1396
70438,19009,9452,127,509,230,76,612,410,9557
72846,4455,2141,22,106,12,0,197,37,2314
85719,48369,26107,2162,1070,347,1519,908,416,22262
59752,3378,1611,10,173,31,16,194,95,1767
67834,988,491,0,25,10,0,21,23,497
68860,300,136,0,2,12,0,23,0,164
64722,512,251,0,4,0,0,29,3,261
73446,8482,4321,77,265,87,60,253,92,4161
74105,25046,11987,85,837,295,153,744,391,13059
75447,1256,687,11,57,14,0,34,15,569
77665,6236,3078,58,168,28,0,345,125,3158
78009,8620,4308,71,187,201,62,469,44,4312
78039,1747,821,0,21,28,80,29,26,926
54610,1601,779,8,41,32,12,28,23,822
56044,2178,1122,18,35,21,14,47,32,1056
38459,398,196,0,28,6,0,24,0,202
47834,19215,9407,73,551,257,22,580,342,9808
60901,35509,17115,225,1219,361,241,1150,392,18394
61262,1123,564,17,68,2,0,32,18,559
57584,57,31,0,0,1,0,0,0,26
50214,939,415,0,62,0,0,54,32,524
42724,5171,2868,124,73,36,28,81,108,2303
48759,3200,1521,0,47,26,49,77,48,1679
44110,19116,8612,75,392,235,157,472,229,10504
49920,4212,2130,16,80,87,9,107,82,2082
50057,266,138,0,0,0,0,23,0,128
34120,32502,16801,70,866,427,114,1302,515,15701
39160,2513,1313,0,34,75,22,101,95,1200
30568,1645,909,11,32,0,16,23,11,736
32615,14630,6910,73,272,110,11,439,105,7720
25123,3255,1708,0,13,44,21,109,101,1547
8854,56931,29016,1525,2074,469,1073,1526,660,27915
29316,26719,12514,99,695,269,165,1031,396,14205
12061,9325,4506,28,349,170,0,328,188,4819
18944,25710,12745,131,682,339,175,816,445,12965
27980,1758,908,0,38,77,0,62,50,850
48821,6065,2948,22,100,95,23,271,93,3117
37167,59055,29324,332,1958,492,438,2187,649,29731
37357,5653,2823,23,201,46,19,305,85,2830
24168,361,135,0,0,10,0,0,0,226
24801,4969,3035,28,296,48,29,48,62,1934
41149,513,244,15,1,0,0,0,30,269
2459,19463,9091,102,286,262,214,649,257,10372
46172,2293,1146,3,66,43,15,94,42,1147
46304,24906,12714,106,882,283,0,851,444,12192
32219,11931,5942,160,185,164,41,361,248,5989
33570,27821,14080,186,1185,356,79,972,316,13741
4444,8946,4534,9,204,93,30,271,226,4412
4949,818,415,0,22,12,0,7,13,403
15615,295,129,0,0,0,0,0,0,166
16110,285,146,0,8,5,0,4,9,139
24142,2870,1318,85,0,0,73,0,0,1552
26075,331,154,0,6,2,6,4,1,177
8247,984,471,19,0,19,0,2,38,513
20740,31848,16989,1415,971,184,1077,734,222,14859
19094,3770,2043,30,113,24,0,109,83,1727
29658,491,233,0,13,0,0,2,9,258
30070,484,210,0,0,0,4,11,10,274
28210,48304,22858,246,2057,382,304,2019,437,25446
28304,36404,17553,258,1054,356,279,1022,505,18851
62941,895,419,0,12,10,2,47,14,476
64834,10164,4752,20,301,96,66,513,133,5412
74755,111,75,0,0,0,0,0,0,36
77076,34985,16805,229,1331,186,303,921,524,18180
67074,1469,768,3,44,76,0,50,3,701
68360,550,280,0,8,1,9,18,25,270
86030,1531,764,9,35,25,0,60,15,767
87029,260,146,0,0,12,0,25,0,114
90023,46780,23778,516,1830,263,488,1648,410,23002
78749,37774,18716,138,1873,296,132,1602,325,19058
92706,35083,17072,315,919,237,147,1035,329,18011
97490,258,136,0,14,0,0,17,0,122
97371,647,307,0,61,13,0,28,2,340
93652,426,233,0,9,3,4,22,3,193
58344,924,448,0,22,16,0,13,9,476
58377,301,156,0,9,3,0,2,4,145
61733,831,406,5,13,6,0,16,15,425
61771,743,380,0,37,5,0,17,11,363
68825,1241,570,3,46,9,7,50,22,671
71039,1350,597,27,50,16,2,71,28,753
78026,5935,2968,17,112,60,79,235,46,2967
78413,40778,20256,204,1211,472,262,1230,409,20522
67137,424,210,0,20,4,0,14,11,214
67738,581,277,0,6,0,2,7,5,304
56655,1612,742,1,19,30,7,10,22,870
57794,489,216,15,11,0,0,11,0,273
58224,75,29,0,0,0,0,0,0,46
62902,4568,2257,21,79,66,4,65,91,2311
72212,12766,6492,45,438,131,0,442,109,6274
72368,1122,645,0,43,26,1,16,1,477
80906,36199,18193,404,1034,392,271,1260,552,18006
81526,5582,2818,5,111,106,15,211,79,2764
75217,86896,41526,742,2527,555,856,3267,862,45370
75661,2917,1621,0,12,36,99,16,43,1296
75752,7222,3652,86,171,131,24,131,210,3570
85301,68300,33652,387,2191,502,403,2337,620,34648
90021,2922,1837,23,213,14,17,85,84,1085
96740,39694,20483,102,1267,679,370,1190,586,19211
4854,1537,773,22,31,25,0,15,29,764
6883,10288,5361,0,235,207,35,245,158,4927
7004,7331,3636,0,197,52,0,276,99,3695
53086,8221,4175,24,259,92,19,244,85,4046
55420,21970,10874,92,610,122,49,700,287,11096
55919,1028,517,3,30,16,2,29,26,511
55982,459,237,3,17,2,3,17,8,222
41332,868,476,0,6,42,0,36,5,392
43119,28551,13770,169,1025,125,46,1220,329,14781
43467,85,40,7,3,0,0,1,0,45
37862,23425,11715,103,577,359,51,685,343,11710
21521,1104,542,3,46,3,3,31,26,562
24058,135,43,0,15,0,0,17,0,92
54447,436,222,0,14,4,3,8,10,214
55090,280,162,0,7,16,0,2,1,118
49263,82,29,0,0,0,0,0,0,53
56554,2759,1339,2,57,53,7,79,43,1420
57349,1449,769,2,40,13,21,39,33,680
57570,2019,1042,31,42,6,10,51,9,977
51104,22924,11432,255,541,158,60,542,282,11492
30901,16398,7976,100,289,113,42,488,279,8422
33534,16487,7974,71,725,48,125,815,99,8513
37375,4022,1778,187,101,46,244,38,38,2244
39115,68,20,0,0,8,0,0,0,48
39401,42522,20471,488,1300,249,673,1110,535,22051
40010,736,292,18,28,0,0,77,0,444
45113,3610,1839,12,75,37,21,128,50,1771
46952,18823,8558,92,528,228,96,511,355,10265
35019,1991,979,3,55,14,2,21,73,1012
36310,6055,3022,27,154,118,50,73,62,3033
28631,818,375,0,20,17,0,0,12,443
28702,560,319,0,11,0,0,16,0,241
25617,814,315,0,0,4,0,0,47,499
70355,1210,594,10,37,36,9,35,24,616
12483,285,77,0,0,0,0,0,13,208
2857,8733,4508,34,62,214,61,184,186,4225
4742,3333,1556,0,37,95,16,96,68,1777
5650,1213,542,7,21,22,10,41,41,671
15780,149,70,0,4,0,0,8,9,79
59034,5549,2776,25,203,48,35,134,51,2773
60621,29042,13184,237,415,213,268,875,496,15858
62313,378,192,0,7,10,0,21,1,186
88344,25,12,0,0,0,0,0,0,13
75856,98,39,0,0,0,0,0,0,59
83435,648,324,1,37,0,8,45,0,324
91748,47084,23324,315,1296,641,248,1240,859,23760
92352,5729,2586,27,110,132,0,138,120,3143
72379,0,0,0,0,0,0,0,0,0
93283,2343,1357,0,11,111,0,50,48,986
94116,47823,23025,121,1883,609,179,1457,881,24798
95587,49,10,0,0,0,0,0,0,39
96755,3010,1442,12,52,18,0,19,86,1568
30032,49456,23467,488,1913,402,373,1715,609,25989
11351,0,0,0,0,0,0,0,0,0
13355,897,434,0,54,20,10,17,19,463
62622,71,30,0,0,0,0,0,0,41
62635,705,370,1,29,9,0,19,4,335
49938,7514,3787,53,228,168,39,180,145,3727
50050,721,350,4,8,14,0,18,11,371
50518,442,234,0,12,2,0,11,2,208
57720,726,380,0,22,10,0,21,9,346
22943,295,130,18,0,0,0,0,0,165
5150,702,251,0,20,29,0,100,40,451
15866,275,155,0,1,2,0,2,6,120
12943,373,145,0,0,4,0,26,5,228
11550,57652,27389,573,2181,395,481,1870,740,30263
18434,3899,1847,18,91,43,0,74,89,2052
82223,1261,673,4,14,29,7,12,19,588
84006,1041,552,0,12,11,0,12,63,489
90012,35913,22055,473,2280,295,95,1056,370,13858
97011,556,262,0,11,9,0,30,0,294
97202,42822,20389,197,1930,369,323,2157,393,22433
55812,11808,5894,304,272,64,408,279,81,5914
65588,2791,1338,9,39,55,10,66,78,1453
67214,14680,6759,89,462,117,101,591,122,7921
67230,11072,5458,89,213,133,25,188,199,5614
60189,30427,14713,195,647,393,85,820,609,15714
60612,34311,16680,274,1117,323,341,1160,265,17631
61486,1469,756,14,72,7,6,75,9,713
47833,961,495,0,23,17,0,20,0,466
48064,4048,1999,18,136,66,20,163,61,2049
48301,14797,7277,62,332,223,32,301,300,7520
15005,9272,4596,66,230,116,44,290,168,4676
15204,8589,3956,10,283,88,10,286,193,4633
18962,332,176,0,7,0,0,7,6,156
19128,38309,18261,256,1504,358,203,1288,468,20048
17406,23710,11361,135,675,184,159,601,397,12349
28551,15104,6761,48,413,179,108,557,119,8343
12722,92,63,0,0,0,0,0,0,29
12769,160,88,0,0,15,0,0,27,72
45826,484,258,3,33,4,0,7,5,226
48732,11330,5536,0,313,80,47,220,139,5794
40046,1351,700,0,20,4,25,43,3,651
42273,540,294,0,9,5,0,20,8,246
43015,55462,27199,521,2474,548,423,2135,544,28263
53218,42780,19203,357,891,311,226,1699,378,23577
20637,5682,2933,73,202,49,110,121,51,2749
12543,3395,1594,57,71,27,19,183,58,1801
13324,2382,1115,17,34,50,2,63,43,1267
13460,4279,2034,8,202,78,59,99,106,2245
15059,4250,2110,109,99,64,13,168,37,2140
15621,91,22,0,0,0,0,0,0,69
16826,433,209,0,21,0,0,21,11,224
32355,224,119,0,9,0,0,5,0,105
33548,7063,3440,0,177,176,53,263,113,3623
27314,1339,689,0,70,0,0,40,17,650
27455,29020,14215,145,689,231,83,1004,474,14805
28403,40919,18723,879,1079,301,1531,1040,329,22196
22060,9858,5261,133,364,20,56,508,45,4597
1776,18940,9475,26,517,293,77,473,300,9465
10512,24716,11647,31,488,384,150,679,342,13069
12184,6871,3361,83,179,109,37,248,241,3510
5464,3306,1697,13,81,62,2,123,50,1609
55339,1085,526,11,31,8,9,29,12,559
55977,203,121,0,10,1,0,4,1,82
14039,92,49,0,4,0,0,7,0,43
14466,1482,770,0,79,14,0,45,9,712
31320,8258,4074,38,266,99,29,159,139,4184
32707,35369,16928,233,1429,505,170,1259,651,18441
20895,19637,9497,80,565,200,45,557,369,10140
21017,6597,3023,67,136,70,29,186,35,3574
29838,408,194,0,0,14,0,0,7,214
19025,5526,2446,28,120,74,33,156,104,3080
19609,10316,5116,84,220,64,56,325,86,5200
34479,13533,6166,56,282,150,64,253,156,7367
35549,3512,1677,20,60,29,9,120,69,1835
26678,1089,523,0,36,0,29,54,0,566
3227,979,470,3,20,31,0,6,17,509
4073,16302,7381,91,574,178,72,531,230,8921
6111,30323,14257,149,929,362,145,824,344,16066
7439,2396,1252,15,60,22,0,76,16,1144
8034,18444,9028,110,572,170,40,566,256,9416
2135,44760,21717,350,1801,264,471,1300,345,23043
41268,512,293,0,33,25,0,22,0,219
55769,2339,1084,24,41,36,6,73,24,1255
59808,19018,9207,161,768,197,230,663,158,9811
50201,8303,4292,11,399,74,55,379,99,4011
86335,5364,2760,82,2,80,0,34,138,2604
25611,1205,551,0,60,0,14,19,16,654
26676,417,202,0,0,37,0,0,0,215
44417,1736,866,7,0,23,27,0,11,870
6796,931,448,0,12,9,0,12,14,483
46957,612,292,0,13,9,9,19,0,320
2828,7863,3627,17,146,50,28,363,111,4236
46635,6901,3087,68,218,130,20,186,169,3814
37918,44791,21348,330,1463,444,391,1418,532,23443
88430,93,21,0,0,0,0,7,0,72
68310,13749,6710,107,405,256,120,308,212,7039
76887,110,56,0,0,0,0,0,0,54
78884,1224,483,0,12,0,59,6,8,741
63662,1660,771,0,27,11,48,0,10,889
64053,5461,2415,0,122,21,0,136,145,3046
57449,195,103,0,0,3,0,8,2,92
72087,2103,1221,3,92,17,0,88,82,882
72325,69,39,0,0,0,0,0,0,30
73048,2438,1194,29,122,24,10,50,18,1244
71333,580,320,0,25,1,0,25,4,260
85712,33612,16012,191,673,329,167,937,439,17600
87549,518,244,0,0,0,0,16,0,274
87824,83,59,0,0,26,0,0,0,24
97222,36988,18601,228,1320,350,117,1276,471,18387
93603,183,93,0,0,0,0,0,30,90
30646,6506,2996,71,110,55,18,235,130,3510
44260,13166,6475,72,253,126,170,391,200,6691
32937,27126,13259,150,595,260,123,726,536,13867
34762,484,263,0,12,12,0,0,14,221
80294,0,0,0,0,0,0,0,0,0
81036,1059,549,0,25,28,3,11,18,510
97383,9952,5245,98,285,168,0,306,178,4707
775,1299,667,0,20,17,18,21,14,632
37915,5283,2227,124,107,52,85,103,48,3056
39097,598,398,10,19,0,3,29,8,200
56116,767,414,1,16,18,5,28,15,353
58325,36,20,0,3,0,0,4,0,16
58558,1073,546,4,7,6,1,23,9,527
54454,1405,742,10,32,19,5,37,17,663
55354,2783,1475,3,102,40,2,80,22,1308
44601,34740,16892,307,701,446,343,987,415,17848
50168,780,410,0,19,6,2,7,33,370
41183,1598,762,6,43,34,0,34,19,836
41776,1370,739,0,41,0,0,45,0,631
59648,506,250,0,17,17,0,14,6,256
62996,464,205,0,14,0,0,7,0,259
48117,10218,5250,76,283,166,21,203,200,4968
48832,1421,658,0,35,8,11,35,34,763
30605,41451,19411,1114,1224,282,1028,1200,426,22040
32817,35317,18308,754,951,216,684,982,428,17009
15678,724,340,11,17,0,0,10,0,384
16746,1291,701,14,12,23,5,12,23,590
14221,54081,25222,303,1566,703,304,1593,884,28859
14551,5426,2714,12,141,55,72,135,69,2712
26059,2644,1322,7,46,50,14,85,57,1322
26201,19904,9934,201,454,252,137,542,504,9970
18704,30662,14987,132,969,395,85,1140,644,15675
19103,24219,10699,43,860,202,8,993,253,13520
28752,30591,15429,89,857,443,199,928,363,15162
28805,19818,8946,96,698,336,91,531,304,10872
99581,761,407,7,13,7,7,19,2,354
17527,6310,3224,47,116,113,21,100,127,3086
18372,2735,1401,0,57,16,0,57,9,1334
19141,34784,15735,278,879,323,479,1309,489,19049
33917,29439,14539,133,355,513,163,604,535,14900
32072,299,146,97,0,0,0,0,0,153
5763,2652,1227,35,39,42,0,48,44,1425
6002,20952,9651,33,397,273,171,499,465,11301
6071,11289,6458,27,500,232,79,339,161,4831
8067,1591,796,3,44,29,19,63,36,795
10461,50348,24497,246,1833,397,502,1941,649,25851
11208,98660,45869,596,3337,698,835,3359,1288,52791
2715,3519,1686,39,73,17,0,178,122,1833
4929,845,432,3,6,14,0,6,10,413
47859,821,420,14,8,2,0,1,13,401
49834,233,120,3,7,2,0,11,6,113
80111,32864,16242,86,908,398,34,1230,472,16622
89410,11172,5630,52,201,191,14,299,116,5542
89460,13619,7029,85,242,228,65,313,189,6590
95204,28425,13382,146,888,383,226,938,322,15043
95828,60270,29564,292,1878,445,344,2127,866,30706
74843,370,166,1,3,1,0,50,6,204
75643,2421,1130,15,84,16,10,58,7,1291
77466,401,268,51,14,5,0,5,5,133
77975,1714,785,3,27,24,7,67,32,929
40361,18529,8787,80,560,212,162,580,280,9742
40363,19,19,0,0,0,0,0,0,0
47250,21984,9981,75,726,334,245,660,276,12003
67211,18974,9607,85,702,206,119,719,306,9367
75705,3555,1672,0,68,0,0,215,0,1883
76877,4332,2219,56,189,33,14,69,69,2113
81643,561,297,0,0,40,0,0,12,264
60619,61258,27681,493,1671,771,378,2020,1027,33577
61536,2918,1437,34,68,64,24,65,33,1481
62363,5758,2943,36,220,79,0,107,46,2815
58276,559,293,1,16,7,0,13,8,266
58641,87,52,0,0,0,0,0,0,35
62985,712,351,0,6,17,0,13,24,361
23850,1268,543,20,18,0,0,16,27,725
24476,169,68,0,0,0,0,0,0,101
16749,4141,2035,27,149,64,26,155,64,2106
20005,13222,6589,65,885,53,0,731,185,6633
20390,359,340,78,0,0,0,0,0,19
21042,40980,19921,135,1193,506,153,1486,711,21059
21663,3356,1552,20,18,49,0,57,71,1804
11213,66295,30437,475,1880,370,674,2352,720,35858
27278,26054,12641,154,714,323,111,782,387,13413
17731,245,124,0,5,7,0,3,0,121
12916,2056,1005,0,25,21,10,18,24,1051
55387,13344,6623,33,501,85,61,536,68,6721
55965,2541,1285,11,63,38,29,96,46,1256
37813,17303,8054,22,759,163,64,583,370,9249
47136,4711,2160,50,139,44,8,197,85,2551
12166,1193,596,4,18,45,4,29,28,597
13357,10855,5331,141,286,121,21,272,128,5524
15767,14362,7058,97,357,174,61,407,231,7304
1876,30807,14935,105,716,339,142,579,564,15872
66073,2611,1267,2,148,12,0,41,63,1344
66533,1943,1009,0,49,13,0,71,9,934
66856,1714,977,45,43,27,1,44,21,737
67664,287,148,0,10,0,0,12,5,139
67801,30842,16010,120,962,265,392,944,298,14832
68065,1444,776,18,29,25,15,8,12,668
68858,315,151,0,6,2,7,2,7,164
68932,475,239,0,12,4,0,6,13,236
73641,599,313,0,13,25,3,7,26,286
74358,245,128,4,18,0,0,15,3,117
41397,33,13,0,0,13,0,0,12,20
62879,117,70,0,3,1,2,0,0,47
64788,1732,839,12,34,29,0,100,20,893
65256,1695,858,0,41,14,0,65,8,837
70125,18792,8722,204,515,150,186,612,191,10070
28904,8759,4165,0,220,69,4,113,147,4594
55406,33456,16708,66,1692,435,79,1630,449,16748
44874,331,170,6,19,1,2,4,4,161
46254,40603,18064,156,1363,328,256,1671,322,22539
46759,382,174,0,21,9,0,8,10,208
21762,167,65,0,11,0,0,12,0,102
52355,300,151,8,23,0,0,3,3,149
53151,31360,15438,144,1036,463,41,784,717,15922
93647,10896,5607,128,478,10,95,349,69,5289
94933,671,306,0,3,54,0,26,12,365
78257,6521,3380,0,176,49,31,249,129,3141
90015,21801,10915,74,1209,139,263,1040,203,10886
62367,1033,550,0,28,21,0,6,9,483
14507,1236,567,9,49,19,11,13,26,669
16130,2129,1069,21,27,18,14,49,39,1060
16415,9523,4539,35,338,116,29,339,138,4984
22637,2419,1131,0,63,0,29,113,32,1288
22656,3331,1586,19,132,71,3,119,108,1745
4856,3384,1532,0,51,87,39,64,77,1852
12725,130,55,0,0,0,0,7,2,75
12783,1992,1110,5,116,27,17,93,14,882
12924,88,50,0,0,0,0,0,0,38
13214,8685,4243,98,257,103,142,199,168,4442
17889,2537,1260,3,79,40,18,108,35,1277
19611,10543,5080,105,240,105,90,334,69,5463
1460,9935,4914,40,449,83,36,369,171,5021
39069,5672,2891,17,116,67,0,199,77,2781
39117,10842,5517,0,240,118,61,382,122,5325
39191,8379,4167,63,277,114,111,222,120,4212
40475,61474,29719,1318,1701,561,1138,1811,791,31755
31566,4839,2498,0,76,20,0,76,95,2341
32667,4090,2057,49,134,53,42,74,111,2033
33036,3274,1780,0,48,100,29,127,127,1494
43985,93,41,0,0,0,0,2,0,52
45335,6781,3295,0,253,64,56,249,123,3486
45770,596,360,0,39,8,7,0,0,236
46919,2644,1256,15,72,20,3,65,10,1388
35463,1794,904,0,32,52,12,68,37,890
27851,5356,2816,0,64,54,46,107,88,2540
28647,71,19,0,0,0,5,0,9,52
29135,8387,3802,0,194,103,0,368,97,4585
53572,10671,5312,47,496,112,7,536,74,5359
55025,24679,12523,258,687,213,78,836,253,12156
36561,6803,3407,31,185,172,26,178,142,3396
39474,5463,2376,71,139,45,86,125,80,3087
49344,3420,1767,8,64,47,47,79,45,1653
38949,304,166,0,13,0,0,8,0,138
46783,6631,3299,26,238,101,44,239,112,3332
47802,35054,18215,491,1639,486,295,1117,482,16839
48655,5799,2972,7,185,99,32,170,108,2827
49120,36490,17795,297,1286,415,258,1164,459,18695
44319,22647,11195,190,706,245,205,807,293,11452
44406,21749,10671,43,589,306,127,636,460,11078
46229,28755,13023,185,930,367,79,1177,341,15732
56728,1455,758,25,56,19,24,13,33,697
57452,271,137,0,0,10,0,0,10,134
41129,10444,5213,55,278,144,125,377,224,5231
49415,6863,3373,21,140,75,62,148,128,3490
39156,376,181,0,0,0,0,39,0,195
3441,185,80,0,0,0,0,0,0,105
4667,1430,666,3,56,30,10,78,31,764
5257,2818,1369,71,31,44,96,53,42,1449
950,0,0,0,0,0,0,0,0,0
1068,1840,911,4,33,23,17,33,51,929
2702,4366,2053,16,159,53,38,83,80,2313
94949,17452,8864,69,634,299,0,337,278,8588
97834,900,456,0,17,10,0,6,12,444
85029,45958,22719,449,1445,482,262,1445,546,23239
77377,37016,18290,300,1376,547,62,1617,446,18726
95209,44313,21756,171,1449,377,288,1387,801,22557
95231,5092,3404,106,409,5,40,107,61,1688
95314,95,67,0,0,0,9,0,0,28
95986,53,38,0,0,8,0,0,0,15
78931,253,115,0,0,0,0,0,0,138
79024,475,255,0,12,1,0,6,3,220
79356,6100,3964,34,364,50,20,77,56,2136
80207,26592,12726,105,1482,189,143,1405,359,13866
87412,746,415,0,58,0,4,0,0,331
88132,249,147,0,11,6,3,4,0,102
88346,2874,1064,0,21,21,0,62,19,1810
91046,143,77,0,0,0,0,0,8,66
12974,1602,787,0,18,28,0,14,33,815
14041,166,102,0,11,8,0,2,0,64
4083,4665,2357,41,158,129,68,59,81,2308
7838,3161,1647,3,89,45,10,52,13,1514
43358,2588,1304,26,59,35,23,71,19,1284
27258,7011,3517,47,212,90,18,161,82,3494
27950,2073,1169,89,57,12,14,8,39,904
27956,423,208,0,27,0,0,24,0,215
28508,2699,1186,45,140,33,0,63,58,1513
32428,17179,9664,104,675,154,98,363,267,7515
33773,17768,8528,151,422,323,97,489,289,9240
47930,1374,677,3,18,32,0,39,21,697
48710,0,0,0,0,0,0,0,0,0
49092,1960,950,10,72,23,14,88,23,1010
17040,2247,1179,7,70,49,16,49,21,1068
18031,9974,5188,31,410,186,14,486,195,4786
6385,15370,7140,148,390,208,56,417,262,8230
7870,28,13,0,0,0,0,0,6,15
14066,1286,633,3,34,28,4,37,17,653
14706,6189,2852,95,118,74,58,152,98,3337
19809,15065,7499,14,584,104,116,478,151,7566
19977,25568,14003,185,1179,295,78,800,250,11565
1243,257,111,0,0,8,0,3,26,146
83841,302,161,0,0,0,0,0,0,141
84327,841,442,0,38,14,10,37,12,399
84526,3794,1888,6,131,63,0,99,36,1906
76875,522,263,0,20,0,0,14,5,259
66090,2755,1348,12,87,4,36,91,127,1407
58282,1460,804,6,23,8,0,47,10,656
58496,188,115,4,0,8,1,4,1,73
59222,136,80,0,0,0,0,0,0,56
15940,4021,2462,105,276,16,101,38,30,1559
17931,8761,6223,76,618,64,15,118,44,2538
18346,2453,1244,23,84,24,0,64,52,1209
36793,229,48,0,0,0,0,0,0,181
38039,1750,867,0,11,11,3,15,26,883
24577,4808,2325,15,189,29,0,158,58,2483
24817,767,392,0,0,3,22,25,4,375
43011,7722,4027,73,194,91,26,344,117,3695
39201,501,316,5,35,0,0,4,13,185
7677,5816,2711,11,108,71,11,181,93,3105
47537,998,457,0,36,60,0,33,6,541
4535,842,443,3,11,5,0,46,16,399
32407,10433,5433,146,357,122,46,281,215,5000
33471,7155,3996,10,451,70,75,110,65,3159
33604,38690,19431,390,1398,464,207,1534,487,19259
95678,43132,21397,325,1775,377,364,1716,476,21735
95937,1442,691,14,36,33,17,0,27,751
96096,732,394,6,19,16,0,19,16,338
96817,56496,27676,420,1428,581,319,1594,908,28820
82212,547,301,16,2,3,0,0,2,246
85750,24535,11820,134,485,520,116,493,451,12715
75654,12450,5684,8,384,94,96,369,162,6766
76205,22093,11327,450,662,165,719,515,258,10766
88038,341,175,0,0,0,0,13,30,166
62630,365,207,0,14,0,0,1,10,158
62849,2100,1044,11,48,13,10,43,20,1056
63868,687,295,0,31,21,0,28,24,392
65001,239,133,0,9,3,0,9,2,106
57260,910,477,2,26,7,6,23,6,433
57355,1165,556,0,51,11,0,51,9,609
67466,840,468,15,34,12,8,31,14,372
67511,272,129,0,0,9,2,0,4,143
67865,1209,585,12,21,19,0,34,17,624
68437,258,129,0,12,0,0,5,11,129
68930,1517,797,9,39,9,12,47,14,720
61016,4962,2528,0,114,107,15,109,134,2434
62271,2153,1036,6,55,52,10,59,25,1117
62444,331,169,0,11,6,0,13,5,162
54658,2592,1270,13,72,27,9,69,44,1322
54966,1981,993,0,38,39,7,53,36,988
78067,648,390,0,0,0,0,18,35,258
65076,746,370,0,30,3,7,33,16,376
65230,754,361,0,15,7,1,20,14,393
66933,396,193,0,24,3,8,7,8,203
68716,1015,470,1,33,5,0,24,28,545
75630,2178,1147,2,32,59,0,12,42,1031
77025,28955,14175,259,1096,237,132,1032,466,14780
71763,1604,806,0,57,36,3,18,39,798
63021,56233,26612,219,1709,590,263,1838,916,29621
80482,991,654,13,172,4,0,14,55,337
80823,163,74,0,0,1,0,4,5,89
82714,77,51,0,0,0,0,0,0,26
57024,488,236,0,15,8,4,20,0,252
94038,3687,1933,58,50,95,0,269,126,1754
97639,857,389,0,18,0,0,20,52,468
97839,312,168,0,10,0,0,19,12,144
96749,17484,8594,128,483,228,81,587,341,8890
68420,1307,599,7,45,20,0,11,12,708
65559,8611,4421,39,307,145,82,204,167,4190
66427,1116,591,4,22,6,0,30,22,525
53528,6258,3190,9,228,56,3,136,54,3068
59645,1717,826,6,18,16,8,31,26,891
99769,921,496,6,15,2,9,20,5,425
17316,8385,4008,30,239,68,74,268,130,4377
11706,68773,34199,825,2738,601,659,2174,858,34574
12480,733,362,0,11,22,0,28,39,371
68725,516,245,0,15,12,0,17,13,271
70360,29215,13660,123,796,428,252,1017,296,15555
62628,766,400,4,24,11,0,21,12,366
64434,455,228,0,4,8,6,10,9,227
76636,1404,626,4,27,32,11,34,30,778
59546,87,27,0,0,0,0,0,0,60
60446,40085,19166,225,1350,215,211,1326,243,20919
84783,849,412,11,0,40,0,49,62,437
81223,1439,744,0,0,52,0,6,58,695
65333,583,320,4,7,5,0,16,26,263
1056,21336,10947,151,682,118,62,441,206,10389
1453,41579,19528,293,1091,341,127,1361,591,22051
30241,25266,12635,352,908,194,175,878,178,12631
31764,1514,684,0,36,16,48,37,18,830
14086,32671,16058,241,1064,523,201,1068,656,16613
23150,12606,6004,0,378,129,43,406,177,6602
23875,12121,6020,129,582,106,142,516,218,6101
25520,1883,768,0,60,0,23,149,0,1115
77611,8633,4439,75,397,46,92,266,92,4194
78063,9591,5118,0,442,211,65,180,207,4473
61332,77,39,0,5,0,0,2,2,38
64765,30,15,0,0,0,0,0,0,15
65078,4037,2038,16,111,72,12,120,100,1999
67134,509,228,0,19,13,4,19,10,281
87566,3612,1988,17,97,10,9,59,54,1624
74347,2927,1356,20,94,40,3,131,32,1571
75650,9493,4560,0,295,158,49,322,38,4933
15322,2050,918,0,70,18,0,61,34,1132
15745,203,100,0,8,0,7,5,0,103
16946,2467,1221,7,86,49,32,107,51,1246
17364,3732,1792,43,75,49,10,64,59,1940
24594,1557,730,0,11,50,16,10,49,827
17729,53,30,0,0,5,3,0,0,23
18458,2574,1350,18,81,41,7,44,80,1224
29563,2192,1018,0,55,61,11,61,94,1174
29639,1642,823,69,24,7,63,6,18,819
13138,0,0,0,0,0,0,0,0,0
54115,45700,22843,454,1531,318,192,1779,447,22857
55084,1653,827,0,79,11,6,63,43,826
37055,27011,12566,135,1017,340,100,761,305,14445
2457,1715,699,133,0,0,254,0,0,1016
15330,5171,2739,60,118,45,37,98,84,2432
3233,101,41,0,0,0,0,0,0,60
4969,1270,710,4,24,17,7,33,15,560
98040,25492,12375,139,591,277,43,646,350,13117
98260,5577,2507,37,119,166,12,99,139,3070
91104,37974,17888,170,1238,286,280,1457,590,20086
74468,316,158,0,11,4,0,10,16,158
83814,26607,13235,137,692,387,138,906,325,13372
77335,2912,1473,0,34,50,8,15,73,1439
78735,17923,8587,24,649,109,13,787,226,9336
70465,639,325,11,46,9,0,20,7,314
50061,1678,785,0,41,25,6,55,4,893
50251,1426,707,20,26,9,3,38,28,719
50645,1113,534,3,19,32,0,38,26,579
51031,12152,5994,19,568,121,38,577,173,6158
42367,796,401,8,2,11,7,2,7,395
23163,81,31,0,0,0,0,0,0,50
23237,23252,11417,169,907,162,219,909,202,11835
23508,22433,11999,980,388,188,828,519,127,10434
23509,13671,6598,93,493,109,99,429,205,7073
4438,1001,521,5,29,13,0,59,29,480
4643,1053,553,0,25,19,3,3,4,500
4740,1109,536,0,43,24,3,60,23,573
16211,126,68,0,3,0,0,3,7,58
13775,1769,918,17,67,36,0,37,22,851
13787,3502,1484,0,96,15,15,19,55,2018
99674,1444,692,7,39,32,5,21,35,752
75667,1142,600,3,89,30,3,52,10,542
76017,47355,23923,390,1403,382,67,2018,686,23432
77545,24954,11316,42,961,47,117,900,105,13638
81027,187,101,0,1,0,0,10,0,86
82201,6471,3432,36,165,133,54,267,126,3039
83520,218,116,0,0,0,0,0,0,102
85938,2212,1124,60,58,40,0,66,51,1088
66436,6262,2990,13,132,71,2,161,97,3272
68304,360,171,0,11,0,0,13,8,189
89402,16,8,0,0,0,0,0,8,8
89430,393,185,0,40,0,0,0,0,208
78577,77835,36307,577,2244,573,671,2395,587,41528
78619,4476,2262,0,91,52,0,216,120,2214
70114,24115,10877,44,615,235,133,861,326,13238
70515,3536,1939,50,97,44,13,64,15,1597
71038,4376,2143,0,110,60,47,105,40,2233
71118,24481,11196,131,946,231,161,962,410,13285
6604,28436,14345,358,732,130,274,762,352,14091
8055,27355,13408,108,593,248,66,717,447,13947
48192,25138,12201,83,1061,226,116,914,395,12937
48892,4662,2396,48,90,47,12,127,100,2266
95471,470,242,0,0,9,0,29,0,228
98813,2972,1624,55,80,30,0,84,40,1348
80448,55,55,0,0,0,0,0,0,0
83001,17145,8916,136,768,163,55,744,280,8229
77660,1205,692,9,15,5,14,38,0,513
78402,231,101,0,0,0,0,0,0,130
68745,1433,668,0,36,25,4,36,23,765
57066,1592,754,3,43,16,0,35,42,838
58456,567,270,0,3,9,0,8,6,297
58835,421,199,0,0,10,6,37,14,222
60047,42637,21299,143,1091,491,199,1214,540,21338
53557,345,179,1,8,3,2,6,5,166
54010,8,0,0,0,0,0,0,0,8
47037,4534,2253,31,205,46,43,128,75,2281
47373,2468,1233,31,99,44,14,56,45,1235
29899,1120,1120,0,189,30,0,0,0,0
30038,39104,17695,307,1061,368,174,1504,578,21409
44080,92,56,0,0,0,0,0,0,36
34207,36738,18592,487,999,337,149,882,552,18146
37062,11736,5794,77,405,92,98,445,202,5942
40160,23116,11012,166,427,169,93,737,349,12104
22079,35592,16892,19,1162,308,226,1460,389,18700
26627,417,141,0,47,0,0,0,0,276
27357,8652,4246,19,250,76,37,271,46,4406
25059,448,254,0,19,14,0,18,0,194
26203,126,71,0,0,0,0,0,0,55
74531,1039,472,0,7,12,8,23,18,567
74854,1983,1015,23,41,35,13,42,24,968
75471,1488,779,0,4,8,24,74,8,709
80649,334,182,0,3,26,0,0,14,152
81121,333,193,0,0,16,0,3,2,140
81413,4988,2342,27,107,51,15,95,68,2646
82426,2728,1392,0,63,34,14,72,44,1336
93429,111,42,0,7,0,0,0,0,69
94605,43112,20613,93,1545,545,73,1794,575,22499
97444,5732,2775,0,148,126,0,98,128,2957
16146,13378,6228,89,393,144,59,400,202,7150
13035,8851,4364,79,150,78,164,155,171,4487
19551,4870,2578,21,110,39,9,105,86,2292
25206,377,162,0,0,6,0,0,12,215
26170,5951,3295,113,239,82,49,98,57,2656
15432,488,236,1,17,12,4,5,9,252
4605,13955,6691,29,462,281,46,426,247,7264
4745,933,470,3,14,16,0,18,16,463
4950,4683,2359,26,160,33,74,118,128,2324
617,23974,11396,33,641,194,258,813,251,12578
1840,5560,2684,29,163,60,0,115,58,2876
75431,2424,1182,2,70,19,6,97,19,1242
77597,983,542,0,27,0,18,36,30,441
80423,225,134,0,0,0,0,0,0,91
78205,1224,691,0,35,22,6,17,0,533
95372,2164,1257,0,151,13,17,75,16,907
98606,9058,4469,72,284,134,13,265,79,4589
87112,42041,20627,310,1221,453,307,1233,800,21414
87562,256,180,0,0,68,0,0,0,76
87742,481,205,0,19,0,0,12,12,276
91775,25192,12062,154,799,208,104,855,333,13130
99744,98,56,0,9,2,0,3,2,42
29125,2159,1253,0,14,80,2,10,82,906
34141,67,52,0,0,4,0,0,0,15
35481,3669,1851,0,102,80,25,73,77,1818
36603,10395,6339,119,590,68,63,356,123,4056
37129,58040,28272,519,2378,650,386,2379,950,29768
47115,2874,1181,0,138,34,11,118,55,1693
43805,81,73,0,0,0,0,0,0,8
4629,0,0,0,0,0,0,0,0,0
5089,4552,2078,16,87,42,32,140,51,2474
5732,792,261,0,52,0,0,48,28,531
17739,34,14,0,0,0,0,0,0,20
30557,4813,2338,2,55,135,17,40,132,2475
30664,28,15,0,1,5,0,0,0,13
31803,5487,2809,95,194,112,10,157,85,2678
31903,19255,8960,86,543,130,251,579,222,10295
13804,353,169,0,8,0,0,3,3,184
14898,1950,964,12,70,10,19,78,14,986
15220,17759,8540,120,688,245,65,479,311,9219
16245,209,112,0,3,0,0,6,0,97
92368,1100,555,10,23,12,5,29,8,545
94606,38303,18330,162,1601,354,304,1531,543,19973
88263,182,105,0,0,10,0,0,17,77
20687,449,256,0,49,0,0,16,24,193
38221,3326,1523,8,80,61,45,41,30,1803
62250,461,259,0,13,5,0,5,10,202
64131,22932,11323,159,953,224,234,869,362,11609
80131,295,154,0,17,0,0,18,0,141
80634,58208,28506,403,2002,494,338,1933,904,29702
80818,326,126,0,4,7,0,12,0,200
80861,240,126,2,7,4,0,11,13,114
81426,141,72,0,1,1,0,3,3,69
68840,3220,1700,6,89,41,2,73,49,1520
70740,1634,835,0,39,12,0,0,14,799
72038,52,21,0,0,0,0,0,0,31
74119,3157,1689,23,117,24,55,113,49,1468
76486,1105,585,0,8,21,0,4,20,520
84332,7570,3662,55,274,53,42,305,63,3908
65077,397,192,0,17,8,0,34,0,205
65583,11485,5636,0,216,58,36,375,40,5849
56734,463,222,1,17,20,0,16,5,241
57046,870,431,3,25,41,0,30,4,439
49326,4074,2068,7,155,76,8,101,62,2006
32322,4152,2774,19,178,37,0,72,34,1378
34453,11427,5709,63,397,125,26,663,79,5718
35453,10863,5077,202,370,65,70,427,239,5786
43528,15919,7824,132,497,213,44,395,213,8095
43537,27097,13201,73,640,277,30,731,508,13896
43935,8870,4317,30,406,92,79,257,73,4553
46795,6818,3645,111,204,115,14,188,90,3173
47274,30970,15388,172,1164,391,105,1161,349,15582
37419,6552,2994,44,95,131,0,201,91,3558
51462,1073,567,0,56,10,5,22,18,506
54761,1162,588,7,11,22,9,13,6,574
61489,870,403,0,30,14,28,35,11,467
71630,495,233,8,1,2,7,0,13,262
79777,236,129,0,8,0,0,24,0,107
81022,1628,880,32,56,26,57,63,71,748
81334,1422,561,11,49,8,35,27,7,861
74365,4479,2193,18,140,18,32,149,68,2286
77032,14093,6635,101,290,72,286,366,199,7458
77836,11913,6210,35,384,123,42,231,157,5703
67026,4802,2414,21,147,58,0,148,44,2388
60005,29539,15040,182,879,381,79,930,326,14499
60073,61706,31573,398,2734,538,386,2039,619,30133
68046,27811,13901,124,1330,210,174,1087,377,13910
19057,17468,8260,57,488,205,223,672,296,9208
19519,0,0,0,0,0,0,0,0,0
27557,7558,3334,23,360,117,67,197,181,4224
30153,18375,9073,94,606,92,1,853,162,9302
32052,9704,6128,96,452,135,37,141,59,3576
33857,2071,1007,0,60,73,23,26,73,1064
34251,5922,3133,9,121,153,0,186,136,2789
44440,4960,2441,39,191,69,65,132,75,2519
47162,673,273,0,0,34,8,3,27,400
47421,27370,13066,80,763,315,66,923,332,14304
54427,1145,598,0,61,12,1,32,15,547
55047,2372,1246,4,27,61,0,51,54,1126
55367,1004,518,5,39,13,2,26,8,486
47855,523,263,8,5,2,0,9,3,260
48730,4474,2234,26,75,71,16,98,94,2240
49886,597,333,0,0,13,0,26,10,264
50469,1517,825,0,79,31,0,84,19,692
19807,7075,3477,18,126,100,0,198,85,3598
20615,329,158,0,0,0,0,0,0,171
4578,4365,2245,51,100,62,5,88,80,2120
6770,31654,15884,78,1328,284,216,1151,429,15770
11001,27867,13692,162,616,339,120,799,552,14175
24834,303,175,0,24,0,0,42,32,128
29070,15914,7604,245,302,122,58,579,283,8310
11946,15145,7668,56,785,155,71,676,191,7477
28323,3899,1988,60,163,40,53,123,23,1911
17768,360,199,0,0,0,0,12,5,161
74561,1943,922,11,27,8,10,77,23,1021
75489,1122,559,0,56,0,0,53,5,563
77092,39035,20542,517,1647,286,207,1475,377,18493
83341,7718,3975,49,164,66,14,240,85,3743
83833,1492,719,0,8,26,10,54,61,773
66111,9986,4909,63,335,131,58,292,129,5077
66401,1483,753,16,0,25,9,25,43,730
13754,3233,1558,9,115,45,29,79,41,1675
16240,1407,712,7,28,22,10,37,48,695
4627,1657,736,30,9,10,8,37,30,921
7726,43870,20832,221,1136,435,222,1705,838,23038
23901,17722,9159,590,606,114,495,283,242,8563
75063,38952,18985,73,2086,140,147,2620,244,19967
84620,923,453,0,28,16,0,17,29,470
84721,23086,11273,122,681,190,138,832,325,11813
87524,92,39,0,0,0,0,0,0,53
95124,51170,26248,253,2270,510,185,2106,527,24922
47955,958,464,0,42,2,3,25,4,494
49087,6340,3200,87,248,71,57,175,89,3140
25241,2149,1046,26,108,23,0,72,11,1103
1452,4642,2292,19,72,67,0,77,61,2350
2026,25360,12010,159,741,235,92,750,435,13350
28604,7635,3606,94,173,100,183,114,85,4029
29601,11902,6538,27,451,179,29,253,171,5364
30028,24978,12659,55,744,203,154,1084,320,12319
26681,1474,800,0,46,0,16,42,0,674
26818,1061,517,21,32,6,0,44,40,544
27519,55111,26843,110,2110,344,112,2760,503,28268
67073,427,210,0,22,14,0,24,0,217
67516,413,212,0,20,8,0,13,7,201
59735,255,139,0,13,2,0,7,3,116
96067,6910,3277,74,91,55,0,129,240,3633
67647,251,114,0,3,2,0,12,7,137
69162,7442,3668,24,210,76,0,224,134,3774
77062,26358,12905,116,786,228,112,1065,276,13453
78227,49907,24527,287,1690,577,215,1914,523,25380
79201,7238,4471,34,355,32,16,224,47,2767
79414,18608,9230,252,572,95,167,568,139,9378
79508,1599,810,2,88,10,7,35,15,789
94044,39065,19313,255,1306,433,260,1318,726,19752
80822,196,97,0,6,0,3,2,5,99
75071,52939,26255,279,2478,265,191,2690,394,26684
75432,3509,1635,38,88,46,25,104,72,1874
66211,4731,2234,12,41,109,20,103,107,2497
45813,3616,1849,28,129,20,30,118,30,1767
46809,8365,4000,40,245,77,33,321,86,4365
40211,23215,9803,86,426,207,191,723,326,13412
37402,4199,2036,21,169,37,58,66,22,2163
58703,22581,11753,263,968,147,116,888,209,10828
59750,354,201,0,12,3,0,6,7,153
56295,291,146,2,4,1,3,7,6,145
53404,15721,7828,288,299,90,66,496,184,7893
53521,3716,1925,18,133,83,16,111,85,1791
49768,487,257,0,4,7,7,8,6,230
3280,1164,622,14,4,38,0,16,33,542
5868,334,177,0,22,8,0,13,3,157
13732,7796,3901,11,255,53,23,205,120,3895
14879,2090,1061,3,58,24,3,77,23,1029
16868,297,193,0,24,0,0,0,0,104
24260,5385,2736,48,93,41,47,151,94,2649
8202,1495,723,8,30,32,10,24,23,772
8611,26608,13875,122,1297,185,166,1137,183,12733
8865,28846,13563,180,761,353,139,794,448,15283
10167,0,0,0,0,0,0,0,0,0
10169,0,0,0,0,0,0,0,0,0
11358,37190,18368,160,1330,451,250,923,519,18822
19967,1425,701,4,15,60,0,13,28,724
23086,3685,1928,6,67,46,9,96,46,1757
29063,39090,19502,318,1366,327,171,1253,244,19588
29081,1317,571,3,39,15,3,26,25,746
29590,3288,2244,19,341,7,0,30,19,1044
12812,104,68,0,6,0,0,3,0,36
12977,1849,1815,27,357,36,0,0,0,34
77453,352,210,0,0,0,0,0,0,142
77614,278,157,0,0,0,0,0,0,121
61051,1688,937,21,72,26,38,49,38,751
61368,1428,718,8,36,3,11,43,12,710
61913,1463,707,15,49,15,5,63,40,756
65783,117,49,0,0,0,0,0,0,68
56160,212,98,0,5,8,0,11,3,114
56437,1458,757,0,46,30,12,40,22,701
56469,1091,585,0,15,17,0,11,16,506
1106,16022,7633,108,330,145,76,295,152,8389
60180,2077,988,0,16,72,146,11,6,1089
52038,653,298,6,8,0,2,16,8,355
38069,2286,1296,36,21,65,7,60,70,990
14871,4879,2616,40,139,71,27,108,72,2263
22027,2124,1053,0,10,0,0,28,20,1071
43070,159,106,0,0,0,0,0,0,53
99326,6241,4042,49,386,71,24,144,67,2199
99643,249,112,0,7,0,6,7,4,137
54904,21482,10767,112,646,310,57,539,291,10715
55360,2774,1395,35,125,17,15,114,22,1379
56301,35051,17804,1072,780,252,847,589,350,17247
56630,2216,1065,20,55,29,17,71,39,1151
61063,4260,2271,53,62,50,39,198,38,1989
63028,26452,13137,197,853,270,71,898,433,13315
47165,6330,3073,0,149,191,24,156,114,3257
47383,3098,1460,6,75,36,27,110,54,1638
48198,38797,18319,313,1047,264,495,1286,498,20478
44647,19172,9631,114,427,176,126,582,293,9541
45836,1344,666,3,43,25,14,37,15,678
49971,443,239,7,6,11,5,7,3,204
50112,11779,5429,230,238,131,263,200,88,6350
36444,924,361,0,30,33,0,32,27,563
54536,180,92,0,9,1,2,0,8,88
94519,20121,9870,146,933,159,118,784,212,10251
4421,1214,798,113,6,5,27,3,9,416
4746,429,241,5,13,8,0,8,2,188
6605,24822,11724,202,1012,184,171,1091,374,13098
7050,30324,12976,203,813,262,204,985,426,17348
7302,43770,22175,70,3520,209,139,2904,240,21595
771,37165,17835,164,1298,484,288,1547,425,19330
1541,3443,1751,35,46,59,25,102,93,1692
2630,2064,1041,23,39,46,0,49,59,1023
93067,454,179,0,0,0,0,0,0,275
31552,842,481,13,0,0,0,0,13,361
48320,4839,2387,0,193,56,13,185,61,2452
24579,1406,647,0,6,36,24,8,28,759
25501,1128,579,0,34,48,0,19,19,549
38674,717,259,0,0,11,0,0,0,458
22310,32195,15423,190,1121,326,150,1656,401,16772
22448,649,328,5,25,0,5,31,0,321
29649,26598,11802,245,540,259,399,905,439,14796
30084,38484,18771,90,1275,279,264,1378,383,19713
37729,1826,968,0,43,50,30,42,18,858
33065,57399,27529,494,2346,348,343,1975,440,29870
41121,1209,590,0,38,19,0,11,41,619
46968,26,9,0,0,0,0,0,0,17
62537,76,35,0,2,0,0,0,0,41
35981,1860,957,3,32,5,1,58,38,903
17823,1203,605,12,41,13,0,28,19,598
25672,384,210,0,10,11,0,0,14,174
33136,14839,7535,61,664,126,86,744,222,7304
43160,21854,10547,172,648,242,79,705,227,11307
28457,10303,5166,85,404,57,74,279,94,5137
39140,2368,1015,2,59,17,2,100,71,1353
52133,612,315,4,20,11,0,17,2,297
46721,4981,2614,67,88,75,22,123,56,2367
46992,16352,7868,172,333,136,91,399,268,8484
63787,823,420,0,51,13,0,11,20,403
48084,15725,7907,90,719,185,42,657,198,7818
48889,1327,674,10,40,15,0,44,14,653
55433,34606,16712,225,1278,339,233,1032,386,17894
61064,3640,1902,9,96,62,0,73,30,1738
62246,9916,5378,147,516,63,106,349,170,4538
54914,31030,15612,243,1190,339,276,982,367,15418
72150,12405,6155,171,455,201,150,346,175,6250
72540,217,110,0,5,0,2,0,0,107
72669,53,35,0,0,0,0,0,0,18
96128,674,410,0,16,24,0,17,11,264
98822,1909,927,0,19,59,0,39,21,982
98943,863,435,13,49,35,5,14,2,428
57359,848,410,0,14,7,8,25,11,438
57620,485,274,0,8,2,0,15,0,211
59347,262,132,0,10,0,0,8,3,130
59831,423,221,0,9,5,0,9,4,202
73038,1924,981,0,81,28,11,49,35,943
74360,29,14,0,0,0,0,0,0,15
62830,1245,661,5,29,6,2,33,27,584
66438,130,65,0,7,12,0,8,0,65
67020,1692,852,0,78,0,22,50,18,840
68621,589,300,0,62,34,0,61,6,289
55927,4296,2192,48,155,52,8,147,90,2104
60630,57344,27889,439,2244,396,219,2409,753,29455
85212,33724,16669,162,1196,209,251,1332,370,17055
86022,2053,954,0,104,25,5,63,26,1099
80019,2967,1258,8,83,0,0,166,24,1709
80107,12904,6364,76,292,143,21,369,203,6540
95991,40684,19788,219,1232,343,202,1582,517,20896
77530,32922,16374,308,1367,196,275,1238,248,16548
33948,16361,7577,106,312,240,99,327,275,8784
38251,2639,1313,14,58,65,13,113,21,1326
39218,7071,3375,87,239,94,64,324,86,3696
41099,1077,456,27,0,0,34,0,0,621
33626,29964,14202,102,989,305,230,1588,429,15762
14850,64484,31687,1646,1591,629,2374,1860,759,32797
6031,1476,715,4,40,30,0,20,24,761
627,32222,15424,319,1129,330,196,1177,390,16798
30310,29658,13939,255,1174,299,241,1228,449,15719
30474,16665,7439,252,482,177,140,442,273,9226
37110,33204,16400,177,1081,469,173,966,573,16804
99171,1068,511,0,14,2,0,55,21,557
56157,845,424,2,29,7,0,36,14,421
57270,939,506,0,35,4,5,13,3,433
57371,163,86,0,0,0,0,5,2,77
58031,442,238,9,18,9,1,6,31,204
87556,2378,1152,0,39,25,88,17,80,1226
92648,46890,24086,69,1469,476,169,1371,596,22804
61030,2302,1133,6,82,9,4,59,8,1169
49877,22,12,0,1,0,0,2,0,10
52721,832,460,3,36,7,4,21,22,372
52804,27560,13474,262,788,311,218,716,457,14086
57346,62,49,0,0,0,0,0,0,13
58338,71,37,0,6,0,0,7,0,34
58554,25735,13249,170,1212,261,185,1024,225,12486
72339,126,57,0,4,0,0,0,2,69
72461,3884,1996,16,75,51,23,113,94,1888
73102,4996,3671,121,474,0,43,208,6,1325
70092,7157,3302,16,194,86,42,199,102,3855
79843,2317,1202,0,80,11,0,28,24,1115
77041,34885,18022,240,809,303,211,1053,497,16863
96129,496,289,0,0,0,0,0,46,207
96785,3322,1772,0,139,101,0,53,232,1550
92373,33264,15257,109,772,422,155,1163,423,18007
94130,3064,1747,133,146,8,64,116,17,1317
89081,36060,17956,341,1487,222,234,1294,435,18104
98201,29484,15494,180,1135,233,126,1065,387,13990
99109,5234,2568,0,112,78,0,126,152,2666
99657,318,158,4,8,4,5,7,3,160
1473,7665,3782,52,232,148,7,132,218,3883
56139,451,233,8,11,7,1,5,1,218
57022,4831,2563,18,194,72,11,167,48,2268
57241,1210,599,1,84,20,0,63,25,611
57264,289,155,0,11,14,0,10,2,134
58078,34969,17852,265,1415,332,267,1608,321,17117
45349,380,200,5,9,7,2,7,3,180
32228,368,328,71,0,0,8,11,0,40
33029,47895,24524,851,1326,260,276,1546,949,23371
33129,13128,6146,25,276,124,129,533,194,6982
50667,738,320,4,24,8,3,32,18,418
50863,240,124,0,0,0,1,5,3,116
49286,14700,7178,30,374,214,50,481,181,7522
30238,39110,18004,247,967,184,339,1701,477,21106
37887,7655,5214,31,592,98,19,118,78,2441
40115,455,230,0,10,9,0,8,0,225
47620,13120,6434,93,371,125,64,411,242,6686
79086,2148,1173,9,79,52,15,62,23,975
79401,8295,4637,783,163,17,381,78,28,3658
82834,7487,3885,21,148,79,18,144,87,3602
73012,37639,19035,142,1573,159,102,1480,350,18604
68720,282,147,0,1,13,0,0,2,135
68779,2725,1320,24,103,17,0,91,17,1405
18351,428,209,0,8,0,0,18,0,219
2903,10542,5065,185,285,83,281,187,145,5477
12580,4434,2225,30,164,53,26,118,91,2209
12946,4790,2158,15,180,109,51,283,38,2632
44303,7766,3686,17,229,51,51,195,134,4080
38946,257,96,0,0,0,0,4,0,161
39428,10578,5175,45,483,104,17,425,137,5403
27023,13088,6383,27,387,146,38,365,301,6705
33170,13748,6408,67,643,90,67,517,108,7340
65083,336,163,0,42,0,0,14,0,173
66429,452,215,0,36,0,0,0,26,237
66948,480,227,0,2,8,5,11,3,253
63088,8376,4204,24,281,59,12,161,95,4172
63339,934,493,0,28,6,3,26,10,441
64433,302,250,33,2,11,0,0,4,52
57047,241,119,0,6,0,0,3,0,122
57445,1985,928,0,45,30,30,54,24,1057
58746,1348,734,0,44,15,7,45,19,614
59036,1433,715,16,59,18,0,53,20,718
62051,585,308,2,14,20,0,8,18,277
71055,19556,9562,177,530,216,169,773,267,9994
54466,2792,1412,15,72,62,7,74,35,1380
54561,0,0,0,0,0,0,0,0,0
72392,540,271,5,11,22,0,4,0,269
44629,2661,1298,19,77,40,53,59,54,1363
44857,23394,11153,102,718,401,106,733,357,12241
54440,2869,1427,26,117,34,16,70,47,1442
55439,8996,4477,76,209,162,4,261,161,4519
56560,43862,21682,875,1311,286,938,1390,383,22180
38879,661,430,10,40,0,0,0,4,231
40009,942,518,3,56,23,1,40,24,424
43976,1661,752,0,54,32,0,115,29,909
45439,10185,5161,16,399,95,41,192,112,5024
47260,1811,930,4,71,32,0,70,13,881
47454,7470,3669,81,237,144,0,268,57,3801
48651,4865,2444,45,80,82,28,54,61,2421
28761,7671,3859,42,182,106,43,302,239,3812
29860,15762,7539,80,664,288,93,653,253,8223
13736,2153,1004,23,36,50,1,42,42,1149
14216,22280,11073,110,1002,150,79,808,271,11207
15475,1368,621,0,73,48,0,22,25,747
16258,2043,929,12,62,12,61,45,67,1114
5161,588,312,4,20,8,0,23,12,276
6851,26671,12333,208,904,288,133,747,451,14338
23602,39391,18438,227,1419,366,252,1408,535,20953
24472,1900,935,0,2,20,35,55,33,965
24976,1178,446,13,35,0,13,16,0,732
20632,381,188,0,45,0,0,0,0,193
19029,4016,1860,13,143,102,6,211,98,2156
19526,11245,5386,24,277,143,118,343,178,5859
11424,0,0,0,0,0,0,0,0,0
2066,18101,8218,62,286,283,58,413,221,9883
60506,54216,27194,459,1919,353,644,2380,503,27022
41701,16445,8143,80,473,326,72,462,297,8302
43143,5762,2760,4,96,65,24,180,82,3002
45782,492,259,2,12,2,1,19,0,233
46379,134,112,0,44,0,0,0,0,22
49269,6177,3078,74,168,76,17,172,82,3099
11590,46560,22465,399,1745,399,201,1500,713,24095
12076,1514,814,3,51,26,5,23,19,700
54156,1522,758,6,23,10,3,30,34,764
28504,21852,10711,145,441,232,72,594,275,11141
28635,3162,1478,11,74,18,22,119,0,1684
29055,4037,1803,31,46,14,0,152,21,2234
26335,1665,857,0,27,14,7,28,46,808
31789,855,400,0,13,0,0,41,20,455
23952,215,94,0,0,0,0,0,0,121
12174,316,139,0,3,0,0,15,5,177
12490,28,14,0,0,0,0,0,0,14
12862,5,5,0,0,0,0,0,0,0
87508,19400,9767,121,571,381,46,349,274,9633
95453,11092,5337,122,283,222,93,349,262,5755
95814,11340,6741,139,579,160,29,297,143,4599
84029,10670,5852,47,536,57,41,521,47,4818
99158,586,333,0,6,6,4,15,15,253
7502,16791,8348,30,665,166,201,523,193,8443
3817,765,504,0,0,0,0,0,35,261
26298,94,44,0,9,0,0,0,0,50
28384,11199,5702,58,290,100,105,326,216,5497
32211,34607,16832,387,1045,155,205,1042,379,17775
34982,25981,12442,94,612,361,125,391,403,13539
37317,2643,1104,58,20,23,55,26,78,1539
22743,291,127,0,0,0,0,0,0,164
24121,11070,5353,18,152,244,43,229,201,5717
24657,308,140,0,0,0,1,0,0,168
72464,31,16,0,0,0,0,0,0,15
96786,44271,23159,731,1400,333,415,1408,244,21112
88063,13961,6463,191,323,65,174,408,99,7498
98901,32204,16936,247,777,463,186,952,305,15268
99126,1079,503,0,0,57,21,0,61,576
99547,35,16,3,1,0,3,1,3,19
83647,20310,10539,202,503,126,243,397,269,9771
77970,303,170,0,35,7,0,5,11,133
41840,861,430,7,46,8,0,19,12,431
62946,12662,6116,64,401,181,96,336,249,6546
56068,984,489,4,19,17,7,24,16,495
47305,3518,1776,2,77,17,0,52,75,1742
47546,21137,10143,87,636,248,67,639,267,10994
48667,0,0,0,0,0,0,0,0,0
67003,2494,1222,0,73,7,0,78,22,1272
59463,88,50,0,0,10,0,0,0,38
61929,683,395,0,43,5,1,33,14,288
62359,209,118,0,8,19,0,0,0,91
57435,245,128,0,0,1,0,14,5,117
57576,199,114,15,0,0,0,27,0,85
59258,94,45,3,0,2,0,2,2,49
62988,1570,769,0,11,43,20,42,24,801
72442,4355,2174,12,57,74,28,62,19,2181
2368,34232,15998,390,967,295,363,1146,769,18234
96135,230,107,0,0,0,0,0,0,123
97722,103,53,0,5,1,0,10,0,50
98840,4385,2267,6,131,10,5,163,99,2118
92561,1278,755,0,23,70,3,44,16,523
93960,26610,18111,181,1497,134,129,594,77,8499
94548,501,293,0,0,18,0,41,16,208
43767,986,513,0,4,15,2,24,19,473
47330,5509,2610,34,205,66,15,189,85,2899
47536,0,0,0,0,0,0,0,0,0
35643,3696,1895,10,209,46,23,149,27,1801
35956,9161,4423,55,232,73,21,224,141,4738
31016,2033,857,0,22,3,16,37,35,1176
31036,12322,5628,160,224,115,30,534,161,6694
18331,630,243,0,68,0,0,4,11,387
49613,687,344,2,5,9,0,7,16,343
50465,164,78,0,2,0,0,0,4,86
52158,238,132,0,0,6,0,2,0,106
44048,2529,1204,0,70,36,0,119,0,1325
44438,4300,2084,43,116,34,0,125,20,2216
44865,3208,1666,19,121,20,14,143,29,1542
45212,22529,11208,486,775,261,396,760,326,11321
45652,4120,1816,0,185,86,0,175,22,2304
46835,34749,16774,266,1200,328,266,1094,435,17975
47283,3227,1566,0,97,51,24,78,27,1661
52536,913,439,13,41,17,0,25,15,474
36480,1564,865,18,64,21,4,70,15,699
37228,1206,488,4,0,35,33,21,19,718
37742,6147,3176,18,110,88,85,153,81,2971
37866,1596,801,6,22,14,22,15,32,795
59215,920,466,7,33,12,0,34,18,454
39532,37122,18444,191,1088,416,261,1243,607,18678
41265,1392,711,0,46,15,0,79,0,681
42440,1041,519,0,25,12,12,12,12,522
29405,29677,15242,203,1000,339,73,854,525,14435
30257,4345,2270,16,198,18,3,170,57,2075
18936,0,0,0,0,0,0,0,0,0
50313,19073,10054,186,812,179,62,766,214,9019
48350,7281,3603,2,227,59,13,174,145,3678
40484,10905,5375,134,228,210,18,295,135,5530
13834,253,165,0,0,0,0,10,0,88
43359,818,422,3,22,3,2,26,11,396
15474,1875,849,30,53,12,7,46,20,1026
30547,3209,1548,19,65,91,34,118,73,1661
16858,3770,1721,14,136,29,12,144,64,2049
27882,7637,3744,110,188,223,50,292,68,3893
20520,0,0,0,0,0,0,0,0,0
3584,3686,1879,0,79,28,19,142,55,1807
4043,11343,5503,124,209,187,41,180,218,5840
8004,12248,6042,91,279,124,32,421,200,6206
11239,13244,5406,26,119,94,48,544,226,7838
62436,697,409,0,12,26,0,22,20,288
24377,306,147,0,0,12,0,0,9,159
78721,12492,5902,136,409,128,142,467,95,6590
79920,6,4,4,0,0,0,0,0,2
85012,7012,3399,10,390,87,0,229,121,3613
88325,808,509,0,83,9,0,61,0,299
45764,9418,4899,116,208,109,75,197,146,4519
46701,8008,4218,47,282,57,75,212,110,3790
92397,4571,2207,9,145,24,25,193,44,2364
32332,1315,694,19,27,14,0,63,15,621
33705,27596,13388,148,923,365,112,1114,460,14208
61346,67,33,0,0,4,0,3,0,34
45302,4172,2201,13,102,48,3,129,78,1971
61740,1536,706,5,44,21,0,19,33,830
31545,15652,7603,0,497,148,107,375,219,8049
31909,39309,19593,199,1398,193,314,1260,543,19716
32443,3322,1560,0,122,51,0,89,43,1762
32909,30798,14786,124,948,379,100,838,639,16012
34698,38909,18155,167,882,813,45,958,709,20754
72432,6693,3345,20,161,75,23,127,81,3348
16040,947,500,8,37,28,0,30,10,447
74120,4988,2704,37,224,60,9,155,69,2284
23055,989,494,0,0,0,0,32,10,495
25921,2263,1113,34,47,48,22,90,19,1150
28583,279,115,7,5,10,0,5,0,164
18411,21738,10587,63,528,335,69,648,372,11151
12493,233,113,0,0,0,0,0,0,120
12743,413,217,0,5,0,0,5,0,196
8107,12935,6520,48,539,67,82,449,191,6415
48363,6408,3262,28,225,30,9,144,157,3146
48822,2996,1594,7,51,58,6,98,40,1402
44130,49787,23730,384,1583,581,371,1479,780,26057
51363,226,136,2,4,0,2,4,4,90
1880,26648,12824,77,806,333,86,802,451,13824
53955,5745,2910,47,266,79,15,181,115,2835
54840,4393,2327,5,130,65,22,117,61,2066
56449,1789,935,16,76,21,9,64,18,854
56735,742,386,15,23,39,3,17,13,356
44632,9831,4795,43,324,118,126,255,234,5036
47282,339,174,0,9,9,0,8,2,165
62203,8264,3967,35,190,162,106,178,91,4297
48724,484,182,0,0,34,0,0,66,302
32224,43751,20022,437,1554,555,367,1638,606,23729
72324,2201,1139,27,36,18,7,29,47,1062
21727,6833,3304,81,81,76,226,45,87,3529
73772,3997,2481,7,286,78,0,91,39,1516
12518,5988,2678,17,200,74,20,198,149,3310
50662,6763,3269,45,160,93,18,218,89,3494
35188,4001,1908,12,189,58,64,95,21,2093
28115,37023,18572,359,1057,427,129,1358,469,18451
31793,9640,4459,126,343,42,188,252,147,5181
32157,202,103,0,0,0,0,20,7,99
33051,569,305,0,0,62,0,0,29,264
35746,604,322,0,0,0,42,0,78,282
39348,567,271,0,0,0,0,9,0,296
7407,20112,9622,130,863,212,147,765,274,10490
7836,11725,5962,0,384,90,87,440,92,5763
45203,2429,994,40,24,24,28,21,74,1435
2050,26152,12392,96,739,265,174,876,405,13760
72024,3592,1706,14,131,49,30,173,36,1886
91601,37085,19568,305,1698,354,155,1700,421,17517
25644,463,223,0,0,0,0,0,0,240
50248,4321,1848,22,61,30,32,116,48,2473
89701,26581,14190,109,981,351,84,665,420,12391
50479,543,268,2,7,8,0,16,5,275
52650,784,350,0,37,0,26,27,25,434
73951,1117,573,0,27,16,5,32,19,544
47853,110,51,0,3,0,5,2,3,59
47382,245,115,0,2,7,0,2,6,130
3570,10382,5860,98,611,76,38,235,144,4522
68838,233,122,0,4,5,2,3,1,111
6370,6932,3593,93,189,92,71,102,224,3339
80916,41098,20706,399,1457,132,254,1336,316,20392
60445,25930,12626,196,882,270,65,702,591,13304
60002,24066,12076,175,661,203,168,701,428,11990
62015,635,307,21,5,0,0,28,13,328
61605,15713,7422,23,553,262,178,511,189,8291
80727,460,286,44,8,5,0,9,2,174
61831,134,79,3,7,5,0,3,3,55
98647,261,147,0,0,0,0,0,0,114
23173,2219,1012,72,0,0,84,5,0,1207
72855,6049,2721,24,223,113,11,191,62,3328
26148,319,167,0,15,9,42,0,0,152
68753,131,65,0,6,0,0,7,2,66
32465,8179,5455,18,435,81,46,77,43,2724
30147,4339,2079,0,175,0,46,70,19,2260
8869,7797,3649,19,186,69,62,191,86,4148
30501,29629,14415,108,1145,222,275,935,262,15214
40110,59,25,0,0,0,0,10,0,34
18431,12078,5891,56,259,211,49,348,272,6187
48659,2711,1379,10,91,53,4,89,55,1332
12546,2815,1446,0,132,56,0,70,90,1369
5682,1226,666,0,29,33,0,32,10,560
54149,1285,668,3,20,37,3,16,26,617
55342,1800,946,10,31,25,10,36,29,854
15538,719,367,0,21,16,4,20,15,352
10115,0,0,0,0,0,0,0,0,0
11518,10101,5148,82,315,117,25,201,173,4953
14069,721,377,8,20,20,13,39,17,344
77073,41745,20754,353,1378,187,242,2019,209,20991
10509,19461,9902,66,604,290,78,437,198,9559
72152,308,169,0,1,23,0,10,0,139
92055,12120,11156,1864,93,0,110,0,0,964
73532,469,249,4,26,5,0,13,7,220
73661,403,185,0,23,5,0,14,15,218
74370,3594,1805,34,82,36,19,95,47,1789
74403,30573,14982,138,836,340,202,950,337,15591
41071,20793,10431,244,972,154,251,758,331,10362
42206,6206,3243,51,170,68,57,273,75,2963
43717,143,82,0,1,4,1,9,6,61
65246,33,14,0,0,0,0,0,0,19
65611,1966,846,13,36,91,0,53,115,1120
26812,1424,740,0,56,27,0,59,40,684
45809,163,76,0,11,0,0,0,5,87
19020,54827,27284,353,1862,537,309,1728,799,27543
21108,18938,9373,75,446,289,18,502,224,9565
21673,3423,1553,10,69,25,42,159,19,1870
49968,1929,976,3,55,21,0,20,49,953
52658,778,420,0,18,0,14,26,38,358
82801,25537,12509,103,623,328,113,771,468,13028
83111,712,312,0,0,0,0,0,0,400
93258,2075,1137,27,79,0,0,101,5,938
93662,30922,15515,272,1249,161,256,1035,243,15407
95650,14059,6965,46,482,85,26,464,265,7094
61019,3244,1624,13,61,49,31,28,0,1620
90715,20136,9624,173,644,153,125,859,273,10512
13614,333,142,0,5,0,5,6,0,191
14502,10545,5129,47,383,144,50,400,176,5416
14732,133,71,4,0,0,0,5,6,62
15145,7071,2860,21,121,121,12,310,164,4211
15650,26994,13348,163,640,414,103,694,489,13646
15752,55,31,0,0,0,0,0,0,24
22736,737,382,24,24,8,0,0,0,355
23011,1334,834,51,73,24,0,34,2,500
2826,501,281,0,0,26,0,0,0,220
5735,4211,2122,120,80,78,154,47,80,2089
7077,2318,1052,12,100,31,29,126,40,1266
12089,115,51,0,0,0,0,0,0,64
13146,2354,1176,20,49,41,8,79,38,1178
1012,560,279,0,11,13,0,25,11,281
1915,41731,19437,516,1167,625,554,1113,653,22294
38461,1245,672,0,48,42,0,27,0,573
38948,2166,1026,0,65,42,0,25,57,1140
40217,12679,6146,247,548,149,109,400,204,6533
30168,26301,11847,38,1017,131,166,1555,263,14454
31076,3414,1707,26,104,18,7,49,9,1707
32207,35917,17920,219,1690,422,356,1094,520,17997
33173,32307,15063,234,1111,340,281,1101,324,17244
33190,16305,7857,64,734,192,64,566,130,8448
43756,4834,2318,27,131,89,13,101,86,2516
45140,56933,28834,349,1995,678,284,1885,826,28099
46045,78,43,0,0,10,0,0,11,35
46125,5,5,0,0,0,0,0,0,0
47006,11499,5794,55,392,142,60,274,180,5705
28562,38598,18732,222,1168,424,92,1418,617,19866
48095,5797,2858,12,101,41,39,150,93,2939
97913,4947,2585,16,158,27,11,160,17,2362
98251,3846,1967,3,117,49,31,95,106,1879
80813,1589,868,0,103,52,27,17,53,721
84111,12134,6739,100,497,127,122,431,120,5395
84728,39,19,0,0,0,0,0,0,20
85641,26441,13335,61,952,352,148,1109,373,13106
66422,396,218,0,2,0,0,12,0,178
66603,1355,668,16,27,0,0,32,0,687
67212,44824,22050,305,1405,679,316,1094,630,22774
69339,1518,737,6,34,21,14,52,13,781
56170,633,335,2,7,4,4,7,6,298
58051,1850,950,17,56,5,29,70,26,900
53587,1181,616,8,22,15,1,34,30,565
64780,541,266,2,13,4,0,21,7,275
65650,1732,934,0,23,13,22,13,17,798
45319,378,184,7,14,5,0,18,17,194
46374,1115,551,7,26,0,0,7,21,564
47125,1646,821,0,24,11,0,63,9,825
47143,3012,1577,6,108,21,11,53,51,1435
70801,85,65,0,0,0,0,0,0,20
54820,788,435,0,26,8,6,35,6,353
48442,20839,10037,74,561,291,68,636,357,10802
30295,4352,2162,46,146,37,31,123,133,2190
41094,15769,7749,28,442,111,73,386,172,8020
41175,5429,2661,16,179,64,32,73,59,2768
43944,2221,1127,0,63,29,0,20,43,1094
44431,4514,2310,17,109,67,5,80,79,2204
92309,633,309,2,20,14,7,39,5,324
85622,6233,2899,0,0,189,0,0,94,3334
90010,3702,1857,8,104,60,0,201,68,1845
93401,28423,14497,814,757,367,351,698,451,13926
95822,45323,22328,364,1617,492,110,1385,635,22995
78029,0,0,0,0,0,0,0,0,0
78236,6882,4674,387,199,0,134,126,0,2208
52778,4588,2447,27,170,43,26,112,46,2141
55792,9807,4910,113,317,119,20,260,201,4897
64724,2147,990,8,59,11,3,81,27,1157
65059,845,418,21,18,0,0,24,1,427
60550,1454,742,5,36,8,0,40,40,712
61834,8778,5172,74,431,153,63,197,77,3606
62992,690,363,0,39,5,2,24,2,327
48414,2677,1329,9,65,37,46,52,49,1348
14057,8284,4270,64,167,76,52,178,196,4014
14102,1163,523,12,0,15,0,17,0,640
14778,1372,632,109,0,0,112,0,0,740
5822,1567,764,0,36,22,0,20,25,803
6389,15,8,0,8,0,0,0,0,7
2563,9573,4652,59,222,108,0,264,209,4921
2637,167,68,0,15,0,0,0,0,99
3033,5298,2465,31,196,34,18,151,68,2833
3872,3301,1649,0,107,94,63,35,43,1652
16022,320,152,1,10,3,0,8,4,168
8738,1164,598,0,0,19,0,3,21,566
11220,95643,48315,650,3939,719,569,3641,1050,47328
23035,1333,652,24,0,0,0,69,0,681
29826,119,53,0,12,0,0,0,5,66
27823,7890,3786,17,192,71,48,217,187,4104
27847,699,408,0,0,0,0,33,6,291
28343,1404,750,0,8,10,2,12,44,654
8311,2252,1113,0,60,19,39,57,43,1139
46070,2320,1190,4,61,21,3,31,26,1130
48186,34255,16717,190,985,323,267,1186,405,17538
42066,23285,11153,267,575,340,39,635,314,12132
54166,16615,8102,87,446,243,10,378,239,8513
36761,884,427,0,0,0,0,12,0,457
38569,124,81,0,0,8,0,0,0,43
56048,4180,2123,13,141,36,25,111,68,2057
56125,61,27,0,2,1,0,2,0,34
57225,1906,981,4,30,30,5,44,41,925
57566,1214,608,0,43,0,0,8,8,606
45209,11082,5462,35,428,97,47,270,136,5620
45365,30232,14927,176,796,397,242,854,294,15305
49876,1037,551,26,35,25,18,29,47,486
50439,168,89,0,1,1,0,2,4,79
50565,425,226,4,4,4,0,4,12,199
51249,3217,1555,42,100,36,19,102,40,1662
48870,201,83,0,16,0,0,9,0,118
49320,92,59,0,0,4,0,0,3,33
44030,15949,8569,189,601,255,133,532,246,7380
56098,2017,1001,14,70,26,33,55,26,1016
56552,451,240,3,19,2,0,19,6,211
57311,1607,770,11,66,18,0,29,19,837
49950,1238,630,0,30,14,0,39,21,608
33919,30764,14417,8,657,416,66,663,623,16347
6471,7676,3721,20,134,79,20,230,155,3955
34952,40063,19153,64,887,653,169,1039,492,20910
36877,13058,6406,23,428,107,83,338,151,6652
93224,453,239,0,14,7,0,9,4,214
38343,15436,7271,44,346,161,73,405,174,8165
95621,41757,20218,312,1433,424,185,1395,580,21539
99156,8280,4200,15,138,200,82,125,104,4080
26404,525,238,15,0,11,28,0,0,287
84782,932,498,0,0,23,0,9,0,434
30446,1251,578,0,27,15,3,52,30,673
77514,5102,2457,49,106,50,36,294,45,2645
72740,9674,4688,90,283,89,71,219,126,4986
95206,64034,32343,581,1893,288,567,2322,638,31691
86556,2073,953,7,59,3,37,45,11,1120
97376,1066,548,0,7,108,0,19,33,518
12785,1119,581,0,46,26,0,62,21,538
16335,27465,13347,427,678,329,224,779,541,14118
17027,2196,914,180,0,13,220,11,0,1282
12471,252,140,0,0,0,0,0,0,112
4492,145,65,0,3,2,0,6,2,80
6001,18532,8867,28,491,176,84,576,351,9665
21777,1951,1014,13,126,26,6,77,23,937
27890,2778,1233,6,46,36,23,85,28,1545
13905,26194,12507,585,670,177,456,798,466,13687
48049,5476,2651,0,197,62,39,149,121,2825
2638,3117,1467,0,98,79,0,51,42,1650
16120,2137,1115,0,46,92,13,47,32,1022
75853,538,284,0,0,32,0,0,24,254
5459,1737,867,0,139,19,20,45,29,870
80734,2973,1638,9,107,30,0,55,17,1335
26030,630,285,1,33,0,0,27,2,345
97004,4213,2188,18,130,83,52,74,100,2025
94954,38414,19095,288,1365,432,263,1331,549,19319
16656,1178,581,3,19,14,0,39,26,597
30004,64232,31671,423,2721,295,142,3116,576,32561
19018,23483,11318,204,854,136,187,875,259,12165
26714,401,250,0,0,0,0,0,0,151
36109,24907,12306,180,881,327,228,688,310,12601
45403,14159,7088,200,285,74,9,465,73,7071
27831,3199,1664,9,87,50,0,11,113,1535
24148,7916,3906,26,124,95,86,156,157,4010
42350,1578,741,0,73,18,13,36,41,837
2763,1771,877,20,49,0,9,36,23,894
2896,12058,5738,43,245,110,48,303,239,6320
34946,5950,3105,0,65,212,44,170,126,2845
18040,16568,8039,18,522,193,78,601,190,8529
25253,2230,1199,0,31,10,30,29,25,1031
42731,96,31,0,0,0,0,0,0,65
29580,1336,641,17,35,12,0,30,29,695
31537,10970,6313,34,451,121,26,222,93,4657
14024,1567,808,18,31,12,14,27,23,759
83703,16819,8457,138,781,130,195,812,262,8362
8733,2713,1331,13,123,13,24,92,58,1382
76827,391,187,0,18,5,0,10,2,204
95360,13029,6332,52,646,57,135,450,189,6697
93430,2947,1468,1,84,111,2,104,33,1479
87565,375,205,0,0,0,0,0,0,170
87713,170,77,0,0,25,0,0,25,93
92332,92,89,0,39,0,0,0,0,3
65338,2744,1347,40,47,25,22,39,41,1397
98940,286,177,0,0,0,0,0,0,109
58634,365,121,0,12,5,0,30,0,244
87072,643,335,4,17,8,15,20,3,308
59931,270,131,0,0,8,0,0,0,139
20152,34191,16942,113,1654,183,102,1697,325,17249
62207,8913,4309,78,126,116,130,205,202,4604
54970,3684,2355,17,237,51,9,34,54,1329
81006,11614,5654,37,371,201,67,356,139,5960
66432,317,135,0,5,11,0,10,3,182
77009,36260,18771,249,1200,346,176,1210,351,17489
68154,23154,11802,168,636,322,114,524,330,11352
84007,662,315,0,18,11,7,17,11,347
68821,64,27,0,0,2,0,0,0,37
65462,1451,686,0,15,7,6,29,23,765
71427,568,232,0,1,1,0,13,21,336
66526,813,462,1,19,3,0,40,4,351
64074,809,447,5,7,13,0,8,4,362
66857,1045,540,14,19,22,12,25,26,505
56121,604,287,8,18,8,0,10,2,317
54457,7936,4078,40,82,148,7,160,131,3858
85019,26659,13122,183,849,99,205,833,310,13537
54615,10692,5709,66,426,141,34,345,160,4983
56359,3563,1822,5,94,71,17,75,70,1741
99755,856,414,20,8,0,15,87,5,442
57641,354,199,2,9,6,0,10,1,155
48761,876,438,0,8,17,37,12,34,438
67660,55,25,0,0,0,0,0,0,30
49657,3709,1904,26,115,45,21,79,31,1805
50218,151,76,0,6,1,0,1,2,75
40906,11814,5498,177,248,98,98,351,426,6316
99785,407,196,4,7,0,6,8,1,211
10543,20715,10379,124,719,123,18,720,216,10336
33556,22978,11408,80,651,268,34,559,433,11570
12540,8071,4194,45,122,87,37,142,158,3877
43824,4116,2107,29,112,63,34,132,129,2009
45772,1623,714,0,71,19,0,75,42,909
8512,11080,5206,19,565,71,53,367,97,5874
52358,3525,1817,29,65,66,0,52,74,1708
72022,17042,8111,0,908,175,129,967,155,8931
62375,345,194,0,14,0,0,13,2,151
63137,20039,8897,164,432,197,50,619,227,11142
64448,882,378,0,38,14,0,56,32,504
70082,308,102,0,19,0,30,0,0,206
71745,391,168,0,4,21,6,33,10,223
60607,29591,14724,584,1686,137,436,1545,166,14867
73458,895,453,0,38,4,0,33,11,442
85037,55567,28546,568,2013,219,508,2156,525,27021
17404,35414,17315,182,1106,406,212,1319,207,18099
80433,8749,4610,27,343,132,16,219,193,4139
13841,634,288,4,21,2,0,15,4,346
65013,2727,1319,15,35,30,24,95,34,1408
33060,37168,18952,345,1077,345,211,985,380,18216
65470,955,492,0,52,0,0,21,8,463
43940,102,35,0,0,9,0,0,0,67
48370,1913,946,0,74,15,0,27,28,967
30707,15956,7863,207,767,129,142,598,361,8093
98110,24060,11687,145,549,359,94,670,462,12373
20770,24629,11823,156,792,222,144,1271,272,12806
86510,4693,2168,43,102,31,5,92,51,2525
4952,1886,987,12,54,19,10,64,36,899
687,31320,15537,229,1147,397,259,883,291,15783
8098,9145,4439,42,227,130,86,264,158,4706
10103,0,0,0,0,0,0,0,0,0
24983,2308,1213,0,37,19,8,23,18,1095
29702,9978,4783,61,372,103,47,294,104,5195
30118,2180,773,92,0,0,245,0,0,1407
12808,328,199,0,12,17,0,11,0,129
10005,8831,4003,108,427,0,53,668,0,4828
28107,7380,3591,62,379,44,106,451,122,3789
2657,2960,1627,46,130,87,0,51,73,1333
95619,5674,2893,72,198,98,12,215,16,2781
14072,20897,10499,51,568,253,28,726,351,10398
2812,1208,672,0,0,0,28,16,16,536
7410,33081,15736,162,898,314,110,1187,507,17345
98292,22547,11375,145,528,433,184,671,285,11172
77474,12825,6280,66,427,91,35,463,89,6545
92070,829,408,2,24,11,10,15,10,421
82935,13002,6436,81,457,191,85,290,180,6566
99662,594,314,11,12,8,9,13,3,280
83627,630,262,0,0,34,0,8,27,368
64133,35163,16833,303,1145,340,96,1302,467,18330
86029,175,113,0,0,8,0,0,0,62
88352,4812,2758,0,15,41,0,90,58,2054
77075,43933,21986,421,1340,224,206,1284,318,21947
98944,22788,11220,133,591,59,28,883,286,11568
77591,14447,6612,58,524,103,60,647,190,7835
95312,304,159,5,5,12,0,8,0,145
61046,2451,1181,10,39,44,13,23,7,1270
92259,94,39,0,15,0,0,0,0,55
48158,7398,3741,69,202,113,59,204,160,3657
70449,3870,2039,0,45,17,0,91,129,1831
26036,684,316,0,22,0,2,0,8,368
35058,9234,4391,24,146,81,65,169,80,4843
2052,12748,6405,68,262,85,50,329,286,6343
49405,1482,745,11,38,23,9,50,31,737
27313,7134,3415,22,242,26,21,147,111,3719
27205,34517,16608,276,862,439,140,1158,262,17909
64647,322,172,0,30,12,0,8,14,150
66617,8708,4370,66,226,74,39,157,172,4338
3785,2240,1069,0,45,41,21,9,56,1171
67361,1653,844,12,46,28,0,25,25,809
5758,640,338,0,21,10,0,15,11,302
15019,1695,799,7,28,19,0,16,15,896
61331,18,9,0,0,0,0,0,0,9
58343,63,37,0,0,0,0,0,5,26
62990,810,395,9,19,16,7,15,12,415
70753,1045,561,0,47,4,0,40,33,484
68457,340,197,0,8,9,0,0,0,143
74650,654,346,8,7,3,2,36,4,308
72528,7,7,0,0,0,0,0,0,0
71833,2220,1014,32,24,0,0,79,30,1206
77429,88344,41347,460,3181,713,367,3812,985,46997
15863,259,124,0,11,6,0,2,9,135
94947,26573,12931,93,789,444,111,656,693,13642
31078,2973,1328,37,25,32,8,137,19,1645
32333,10506,5460,71,211,104,43,179,226,5046
65654,179,92,0,6,0,3,1,1,87
24916,743,260,0,24,0,16,22,10,483
73151,1861,908,0,32,45,4,75,13,953
19027,19999,9228,120,582,274,170,715,366,10771
47326,2277,1207,0,53,1,10,53,0,1070
39654,5098,2289,45,100,42,10,193,85,2809
40422,25265,12478,228,770,340,325,662,249,12787
40820,876,434,0,28,7,0,28,19,442
40943,595,268,0,26,11,30,0,0,327
60659,41068,21031,257,1427,253,453,1581,332,20037
61025,4645,2525,22,109,80,0,122,62,2120
61723,2595,1322,13,62,54,11,84,29,1273
55811,27541,13344,440,803,250,410,639,249,14197
56214,703,355,2,13,15,0,15,11,348
52134,344,185,0,6,1,2,9,7,159
54963,6826,3520,16,271,134,23,279,91,3306
48849,5993,2954,38,167,68,29,191,62,3039
49058,19067,9348,116,619,228,145,566,203,9719
44439,147,87,24,10,0,0,3,5,60
5071,89,33,0,0,0,0,0,0,56
7724,21105,10464,100,617,233,85,538,400,10641
14418,1333,614,4,18,10,0,33,20,719
23453,36138,17571,282,1385,277,212,1610,299,18567
24464,146,76,0,0,14,0,0,13,70
24854,297,151,0,0,0,0,0,0,146
18923,911,432,0,48,18,0,53,23,479
19422,18991,9202,69,521,306,37,369,239,9789
77518,10684,5746,20,305,148,53,208,61,4938
79853,2624,1243,38,44,15,19,62,17,1381
53091,1855,942,5,44,28,2,46,30,913
55076,21681,10813,173,711,329,60,888,354,10868
55126,26736,12704,76,800,161,177,964,620,14032
58429,348,200,0,29,1,1,11,1,148
59635,6818,3631,87,192,75,16,156,82,3187
66428,383,215,0,13,9,0,12,19,168
67352,495,254,14,7,6,6,5,6,241
68462,4357,2164,4,133,32,7,87,27,2193
70560,40709,20304,379,1085,515,297,1153,566,20405
56433,1653,855,10,23,68,4,37,46,798
56450,933,445,2,9,24,0,21,17,488
56727,657,369,7,21,12,0,33,4,288
62914,2738,1257,0,120,52,24,136,48,1481
63445,3345,1666,36,108,67,7,37,56,1679
72658,1615,841,11,12,111,0,76,43,774
75237,20773,8748,65,686,105,273,877,307,12025
30534,28843,14404,211,761,388,139,807,430,14439
31774,6737,3347,23,268,138,40,256,87,3390
50276,2742,1556,12,67,62,11,83,31,1186
50472,2335,1124,7,54,18,7,36,31,1211
52210,708,335,2,25,3,1,29,1,373
55060,29020,14383,272,833,233,130,862,406,14637
41560,183,84,0,0,0,0,0,0,99
44313,24580,11504,162,750,291,143,626,467,13076
40228,16182,8238,73,557,205,49,494,165,7944
30734,3779,1970,75,175,7,8,124,38,1809
31524,0,0,0,0,0,0,0,0,0
35805,21200,10185,230,900,114,246,788,229,11015
5841,379,157,10,5,11,0,6,8,222
7930,8359,4101,58,211,68,24,120,196,4258
10527,774,376,0,0,7,0,0,4,398
13290,0,0,0,0,0,0,0,0,0
24078,6858,3277,32,339,37,36,280,92,3581
24401,35702,16685,108,1035,547,370,859,460,19017
24522,9246,4309,25,199,149,18,307,102,4937
21104,5300,2691,21,74,54,37,105,74,2609
25438,6721,3149,21,279,20,40,292,63,3572
14710,3268,1668,20,114,55,8,75,98,1600
95549,1050,558,0,35,15,0,36,14,492
92113,55623,29376,1170,1901,307,551,1577,305,26247
93602,3967,2047,11,180,57,2,54,108,1920
97625,319,182,0,0,2,9,0,6,137
90046,50587,27208,56,3331,571,120,1897,461,23379
3230,1280,633,0,52,20,5,37,25,647
61813,1656,821,9,58,21,13,30,27,835
62952,3141,1495,19,68,48,6,96,86,1646
63823,1177,544,0,23,9,7,21,12,633
72015,29822,14738,346,1036,286,169,1018,279,15084
86313,237,237,0,0,0,0,0,0,0
60077,28329,13285,56,770,380,78,1160,516,15044
60096,6803,3330,73,120,118,17,170,134,3473
65323,899,448,0,34,19,4,11,9,451
65656,4477,2348,23,90,142,0,130,133,2129
65754,1041,431,0,145,24,0,13,13,610
66523,3641,1760,0,112,37,5,101,108,1881
67047,675,319,0,6,8,0,1,13,356
76370,257,120,0,0,0,0,0,6,137
76824,11,0,0,0,0,0,0,0,11
39062,597,225,0,24,8,6,20,5,372
40052,569,348,0,52,0,0,17,8,221
44288,3521,1716,0,106,27,16,127,40,1805
44420,14796,7419,120,481,120,123,466,259,7377
45862,1524,767,0,41,15,10,35,20,757
46186,1759,899,0,93,12,17,80,26,860
49201,45817,26724,512,1663,582,246,1088,433,19093
49259,2145,1072,0,86,30,0,69,49,1073
60482,10916,5479,87,283,98,81,236,116,5437
56207,282,126,0,5,2,0,14,11,156
59414,1027,462,0,28,55,9,87,17,565
49766,2269,1099,4,22,30,0,44,61,1170
50233,1366,752,5,29,9,3,81,13,614
50583,2719,1277,5,40,53,19,70,64,1442
3908,7420,3510,27,140,52,101,325,175,3910
7080,23854,11871,94,713,242,203,790,455,11983
14139,2438,1314,0,80,42,6,60,28,1124
14855,1074,559,13,25,3,8,15,0,515
15063,11260,5664,134,428,201,13,356,185,5596
15717,9923,4760,73,223,169,24,267,150,5163
10523,9077,4788,99,313,59,71,229,137,4289
17922,4663,2233,0,168,66,10,185,110,2430
19564,181,98,0,0,0,0,0,0,83
11788,16228,8482,64,477,141,151,574,143,7746
12122,4313,2229,22,122,119,0,107,67,2084
12987,198,83,0,0,0,0,0,0,115
13087,66,40,0,0,0,3,0,4,26
13165,10559,4992,32,187,111,42,270,193,5567
13341,107,52,0,0,0,0,0,3,55
80427,781,448,0,29,3,0,12,12,333
84118,73078,36787,451,3064,666,700,3178,758,36291
62979,1134,563,4,27,10,11,9,9,571
72842,1313,553,0,17,17,9,99,30,760
74637,1706,834,14,74,20,0,55,23,872
76464,532,270,0,3,9,0,14,8,262
67484,948,503,4,4,16,0,52,14,445
88130,17696,8792,285,572,169,366,548,222,8904
89021,3400,1760,0,115,22,0,139,7,1640
98263,76,40,1,4,2,0,0,0,36
95659,861,449,0,63,12,0,28,22,412
42087,2401,1148,9,8,22,21,52,12,1253
48048,7689,3696,30,168,44,13,394,91,3993
48506,29238,14748,144,1059,223,148,888,481,14490
97136,1580,717,14,18,63,0,7,34,863
54854,1094,560,2,27,19,0,42,17,534
36467,9769,4631,109,205,125,37,323,169,5138
16116,2894,1463,13,88,10,15,120,77,1431
7922,12404,5975,35,266,131,99,386,119,6429
12459,196,105,0,0,0,0,9,0,91
12965,596,333,5,34,10,5,5,14,263
26276,227,116,0,0,0,0,21,0,111
2072,28534,13325,120,865,312,50,868,402,15209
2446,29834,14036,461,963,220,641,940,274,15798
99833,3255,1649,79,97,50,8,63,41,1606
76262,37183,18290,240,1435,292,104,1632,369,18893
81327,401,199,0,0,0,0,6,10,202
83850,1993,932,20,23,34,0,9,40,1061
65260,505,314,0,16,22,0,22,3,191
66733,2210,1159,2,71,19,31,41,11,1051
67480,1701,824,12,45,11,12,70,25,877
89030,48382,24585,471,1866,274,321,1640,486,23797
89801,26177,13510,289,1013,304,96,831,342,12667
79363,5611,2636,50,127,36,61,207,38,2975
72376,1755,869,37,5,17,12,23,42,886
73029,1632,761,12,38,12,3,65,43,871
90747,0,0,0,0,0,0,0,0,0
8535,4711,2354,65,135,24,37,75,18,2357
10002,74993,36230,362,2367,968,488,2199,1654,38763
693,54428,26062,347,1572,483,273,1794,624,28366
1531,1298,644,8,40,23,9,17,18,654
2127,36898,18032,106,1478,135,79,1194,412,18866
65320,45,11,0,0,0,0,8,1,34
66935,2216,1054,3,57,16,0,15,14,1162
52314,6123,3015,112,180,59,135,148,47,3108
37376,351,216,0,26,31,0,0,0,135
37730,0,0,0,0,0,0,0,0,0
21215,58448,25298,469,1159,650,375,1599,1001,33150
43988,2263,1099,14,36,53,19,42,57,1164
98012,64417,31983,334,2872,520,423,2937,710,32434
98106,26171,12550,142,1274,194,189,1221,324,13621
99113,719,370,15,23,12,0,16,18,349
99690,189,91,2,3,0,0,4,4,98
56626,285,142,0,25,0,0,18,8,143
62022,1060,546,34,46,27,0,51,10,514
62339,874,397,3,28,3,2,13,14,477
48910,35288,16459,258,1145,282,508,1129,557,18829
44308,943,567,23,24,5,20,6,20,376
49929,136,65,0,8,0,0,3,5,71
50602,1550,777,0,19,31,0,40,37,773
41055,2060,1164,65,48,16,15,75,12,896
43054,26953,13400,50,1311,83,136,1114,254,13553
35077,13547,7158,150,429,192,29,254,257,6389
40403,24333,11980,219,748,150,256,853,233,12353
97106,5125,2697,15,117,74,35,150,29,2428
47949,1247,616,9,14,32,2,24,28,631
48933,2311,1321,0,136,18,36,82,51,990
23523,8075,3730,51,130,7,63,173,83,4345
28662,114,57,0,0,0,0,0,0,57
29044,5852,2568,23,222,67,33,62,58,3284
33944,268,102,0,0,34,0,0,0,166
36079,10159,5153,245,266,125,17,457,169,5006
19002,32466,15432,99,802,362,144,885,499,17034
23954,2012,980,0,49,0,7,12,26,1032
24011,443,240,4,34,11,3,13,0,203
41240,6610,3239,106,221,101,15,250,123,3371
32463,171,86,0,8,0,6,6,1,85
32511,1034,770,70,0,0,13,0,0,264
32759,2787,1506,0,62,50,0,68,60,1281
33428,41189,20304,138,1223,308,273,1147,527,20885
26817,278,143,0,25,0,0,29,11,135
49959,362,169,0,0,0,7,0,0,193
50561,395,206,0,19,14,7,23,8,189
53119,5768,2906,33,139,61,33,106,111,2862
56448,285,160,0,9,11,0,0,7,125
60470,497,260,3,9,3,0,12,8,237
44640,235,146,6,5,1,0,9,0,89
47231,794,432,2,101,2,16,27,5,362
67021,40,14,0,3,1,0,0,0,26
67519,193,102,0,4,1,0,9,5,91
68833,380,199,10,17,9,0,2,11,181
64637,578,298,4,15,8,6,9,8,280
47918,5803,2883,70,125,111,63,151,109,2920
61607,10673,5317,36,331,131,50,358,259,5356
14008,1315,650,2,39,16,18,14,0,665
14127,30297,14819,187,549,256,79,955,504,15478
6033,29026,14187,131,829,328,235,772,662,14839
705,23176,11115,152,714,249,216,726,366,12061
33877,589,319,0,0,0,0,54,0,270
36874,7511,3641,30,154,72,90,145,168,3870
37246,0,0,0,0,0,0,0,0,0
98168,32738,16909,166,1863,264,195,1175,391,15829
56662,483,258,0,1,20,0,0,17,225
78802,251,79,0,0,0,0,0,0,172
66027,6188,3537,44,614,0,10,285,0,2651
61073,19165,9480,134,564,269,116,717,265,9685
49635,3454,1631,2,53,59,4,22,50,1823
53523,5136,2629,23,162,109,15,126,71,2507
53704,45770,22180,112,1908,459,532,1871,554,23590
54855,939,494,3,30,7,2,31,6,445
58275,745,359,0,37,5,5,10,8,386
63011,38436,18213,138,1114,380,192,1084,489,20223
64072,503,269,0,17,7,9,6,3,234
71045,642,306,0,23,11,0,85,6,336
78419,793,469,49,31,0,11,30,4,324
79248,1597,774,0,27,17,17,28,24,823
92234,53961,27550,288,1647,598,360,2000,650,26411
76571,7737,3962,86,202,123,0,284,88,3775
56145,535,257,1,23,7,0,15,12,278
58475,181,102,2,0,1,0,0,11,79
59349,1135,560,1,13,16,0,26,22,575
59461,39,16,0,0,0,0,0,0,23
49674,96,45,0,0,0,0,0,0,51
50238,1334,732,0,26,18,4,30,22,602
51565,448,220,0,1,3,0,13,1,228
62682,986,494,0,9,8,0,40,21,492
63468,2414,1213,0,33,14,8,92,31,1201
66041,671,356,0,15,32,0,15,12,315
67360,399,242,0,33,0,0,14,19,157
68370,2072,1037,2,47,24,14,47,34,1035
68748,2942,1523,18,73,3,22,117,20,1419
54728,6231,3121,31,197,84,10,130,140,3110
55987,34929,17070,776,795,517,853,737,441,17859
55990,977,500,16,52,4,8,37,21,477
70441,4357,2237,28,157,39,0,85,32,2120
71676,592,271,0,9,9,0,13,0,321
84324,604,306,10,14,9,2,12,5,298
78203,6403,3012,47,242,78,0,263,74,3391
30013,26368,12519,198,847,279,108,1002,435,13849
30064,49080,23693,402,1848,526,234,1903,327,25387
31647,3660,1818,57,133,18,12,107,41,1842
39144,786,333,24,23,6,7,48,22,453
39643,1275,526,0,38,32,0,36,70,749
45243,15075,7131,62,384,197,38,441,342,7944
47352,1064,538,1,39,0,0,48,9,526
94508,4298,2198,90,103,36,122,111,67,2100
97410,736,416,0,12,0,0,17,8,320
97458,4475,2220,25,80,103,18,86,262,2255
86436,1079,607,0,35,0,0,15,0,472
97477,37031,18510,292,1356,454,129,1084,391,18521
99780,1559,749,0,13,34,0,40,7,810
54489,1590,804,3,53,22,0,32,26,786
43318,4537,2387,69,115,60,3,192,24,2150
32931,14118,6799,11,310,369,61,260,171,7319
33304,18771,10493,9,986,195,138,593,258,8278
48042,30626,15250,223,727,306,164,887,503,15376
30683,6601,3399,10,258,123,0,221,200,3202
32147,556,272,0,59,0,0,0,0,284
37030,7063,3618,34,220,25,35,184,105,3445
78216,41765,20623,231,1590,351,459,1769,418,21142
82001,36154,18011,317,1242,328,278,1215,500,18143
60955,1614,840,6,58,31,3,40,32,774
61951,7956,3864,48,213,124,21,216,46,4092
62434,327,168,0,5,0,9,0,0,159
71941,2209,1221,6,124,17,26,38,4,988
72128,903,430,0,57,4,0,55,1,473
72340,222,105,0,0,0,0,0,0,117
69350,448,242,3,6,9,0,4,5,206
99712,14489,7988,19,679,189,50,351,268,6501
17878,1426,667,18,47,21,15,24,24,759
18323,131,71,0,0,0,0,0,0,60
18812,1681,879,3,43,25,0,45,34,802
2370,17909,9007,143,506,223,171,486,273,8902
4086,8763,4212,0,218,99,31,350,147,4551
5681,405,200,0,15,3,0,15,14,205
7704,5943,2872,11,130,50,24,165,115,3071
12768,794,307,13,0,8,25,19,0,487
14893,0,0,0,0,0,0,0,0,0
7980,2253,1249,19,30,33,0,42,15,1004
11221,83835,40147,599,2690,630,655,3527,865,43688
1030,11123,5581,30,130,198,79,308,182,5542
1605,28820,13854,132,790,271,338,656,245,14966
27549,25645,12562,117,792,351,231,695,397,13083
27703,51163,24058,103,1774,390,196,2146,699,27105
28078,60107,29612,114,2584,459,200,2498,514,30495
33076,36600,18880,243,886,553,103,1384,481,17720
54161,2809,1370,10,65,88,7,104,37,1439
65635,599,311,2,4,20,6,9,8,288
66092,3846,1961,20,171,58,13,139,41,1885
68508,16591,8733,743,317,47,698,258,90,7858
56367,6614,3325,51,232,71,14,258,96,3289
56455,1970,1065,15,53,25,13,92,23,905
57379,83,40,0,4,0,0,0,7,43
48150,25792,12460,198,948,256,184,814,363,13332
70394,15403,7724,116,570,202,42,583,243,7679
55604,3384,1634,55,66,52,4,81,37,1750
55753,904,474,7,32,12,11,11,11,430
73112,33335,16448,171,1244,360,284,1261,372,16887
73843,859,363,8,32,14,7,24,7,496
76055,2703,1298,19,37,7,0,78,36,1405
76109,23512,11517,295,755,187,483,744,234,11995
55110,40336,19594,216,1265,514,149,1129,620,20742
53943,1057,558,15,30,6,12,35,9,499
55013,6810,3331,114,215,37,71,207,84,3479
37091,22115,10854,126,778,299,141,783,372,11261
40216,41539,20174,234,1195,412,158,1371,668,21365
30311,36839,16049,206,719,216,198,1293,673,20790
31408,10516,6295,121,514,54,35,277,41,4221
46991,1637,824,4,31,23,0,46,2,813
47469,1800,983,0,44,2,4,98,22,817
40995,157,77,5,0,0,0,0,7,80
43445,1239,609,13,9,9,0,21,28,630
48609,12263,5991,59,302,243,32,407,235,6272
28622,2109,1096,27,113,9,17,34,22,1013
29104,1375,520,5,20,21,15,28,6,855
29384,4145,2097,3,176,46,21,29,73,2048
49962,240,113,0,7,7,2,0,0,127
50648,4536,2219,0,137,16,10,201,37,2317
14821,3186,1568,12,101,43,0,37,54,1618
7722,10094,4869,104,104,131,73,180,189,5225
23503,32080,17254,243,1147,348,142,1012,349,14826
21916,41,41,0,2,0,0,0,0,0
8248,242,136,0,0,0,0,0,0,106
60531,1759,907,0,62,24,0,54,45,852
60631,29529,14264,78,925,479,49,1058,371,15265
62282,406,185,3,0,5,2,15,5,221
62355,754,391,3,12,28,0,26,19,363
39175,4302,1852,8,96,153,53,207,53,2450
39482,11089,5509,57,397,36,22,497,172,5580
39750,2231,1082,20,65,16,0,54,19,1149
49442,41478,19318,477,1095,421,381,1144,484,22160
51528,762,370,0,25,8,3,16,10,392
53129,14213,6789,37,465,159,104,383,241,7424
27592,15588,7619,16,668,165,58,785,180,7969
32202,6165,3723,160,386,42,122,126,54,2442
28739,21474,9619,34,394,536,91,443,437,11855
91387,43717,21425,252,1464,218,179,1748,369,22292
91722,35708,17340,423,1260,253,291,1379,387,18368
90232,14660,7093,98,520,187,90,529,169,7567
96088,4419,2360,0,60,92,54,90,123,2059
84606,35744,17881,1384,560,36,2103,603,209,17863
85332,1693,880,0,18,43,0,20,44,813
99578,518,248,4,10,2,4,4,3,270
10033,59607,30216,293,2287,511,199,2268,721,29391
11096,8311,4130,56,319,117,6,420,32,4181
6332,642,351,0,0,0,0,49,0,291
1066,9,9,0,0,0,0,0,0,0
25201,32,0,0,0,0,0,0,0,32
36105,9815,4340,55,261,148,116,311,256,5475
36301,37527,17915,216,1054,351,293,1198,496,19612
30546,6969,3145,65,120,139,0,130,92,3824
31743,444,206,0,3,14,0,0,1,238
32053,3139,1498,0,33,35,3,49,76,1641
29438,2510,1179,0,59,98,0,44,58,1331
79366,1056,490,0,23,13,0,21,28,566
80011,50675,25643,434,1761,405,200,1602,509,25032
82941,5215,2528,0,118,74,0,343,89,2687
72136,1175,612,0,51,47,10,40,16,563
95377,32501,16694,218,1253,100,108,1458,209,15807
95698,179,100,0,22,0,0,18,0,79
89128,36753,17278,279,1004,268,140,1026,433,19475
98466,28465,13897,183,1020,202,272,849,361,14568
76064,1808,860,7,37,6,13,44,21,948
42653,4922,2493,9,167,47,0,116,97,2429
43615,39786,18657,487,1393,444,499,1011,563,21129
60964,5070,2607,64,161,60,29,233,84,2463
63565,3433,1656,51,121,57,35,77,35,1777
54420,1251,645,16,32,14,17,28,24,606
55981,4042,1985,5,88,84,30,79,57,2057
56051,660,329,4,16,3,0,28,7,331
46563,23820,11754,148,686,242,242,760,338,12066
1520,15645,7593,73,269,180,21,399,355,8052
68070,585,312,0,31,5,0,13,6,273
68106,20153,10052,165,675,177,179,513,300,10101
59837,511,225,0,3,21,0,4,0,286
63119,34119,15771,82,1129,305,216,1275,581,18348
72704,26832,13853,268,1187,322,331,939,208,12979
73838,345,181,4,0,0,0,8,7,164
79234,24,11,0,0,0,0,0,0,13
92679,32579,16081,127,625,393,175,785,497,16498
89831,0,0,0,0,0,0,0,0,0
99653,151,72,0,10,1,0,7,0,79
38321,2292,1274,10,23,15,30,57,63,1018
38625,1204,570,0,45,12,4,55,3,634
38944,454,259,0,4,0,0,9,11,195
44041,14321,7159,10,377,119,53,279,257,7162
46910,3412,1731,14,142,21,11,87,43,1681
33957,7224,3408,0,59,180,0,64,199,3816
34241,14675,7070,42,389,148,56,362,254,7605
35469,188,77,0,0,0,0,0,0,111
36441,4107,2017,24,110,19,19,158,84,2090
37175,970,570,40,0,8,0,22,34,400
31750,18322,8678,149,527,193,89,561,297,9644
18634,13114,6604,75,537,165,45,385,164,6510
70538,14464,7450,36,463,223,63,411,165,7014
56117,400,211,0,23,6,0,10,1,189
56592,496,248,0,13,14,0,11,14,248
73663,1384,687,0,16,7,4,41,17,697
51003,1737,856,10,38,35,13,47,22,881
52567,760,448,0,16,27,0,20,18,312
53717,12678,5868,25,711,229,34,364,181,6810
47264,1315,594,0,0,0,23,26,11,721
34236,12920,5871,0,177,369,17,176,147,7049
35544,476,225,0,35,6,0,4,2,251
36542,13932,6342,75,276,299,0,324,263,7590
96014,145,79,0,0,0,0,0,0,66
49512,16926,8323,201,555,126,138,531,267,8603
48722,3033,1489,11,68,43,0,79,41,1544
42210,4218,2108,11,206,63,25,195,74,2110
54763,1139,612,4,25,19,2,21,24,527
20818,2019,904,0,60,41,0,40,26,1115
16672,207,91,0,2,0,0,2,0,116
26238,901,433,0,5,6,0,0,6,468
22657,10402,5076,42,285,123,111,370,173,5326
28533,3248,3053,599,32,0,25,0,0,195
3871,115,39,0,0,0,0,0,0,76
10019,43703,22413,166,1975,575,95,1913,374,21290
29481,1603,701,1,28,12,28,52,49,902
12132,267,132,0,0,55,0,0,5,135
29546,2965,1357,53,54,33,0,97,133,1608
6413,12958,6444,40,295,94,15,277,211,6514
12571,9999,4967,175,189,117,126,254,144,5032
52224,2055,1068,17,70,20,12,29,32,987
28170,11861,5688,21,228,138,196,390,223,6173
64645,131,50,0,0,6,0,0,5,81
78584,19270,8717,87,415,185,263,436,180,10553
41563,441,190,0,28,0,0,13,17,251
62927,383,194,0,18,1,2,3,7,189
42286,1077,518,5,43,2,8,18,11,559
56572,5309,2787,25,93,88,14,97,90,2522
26691,485,222,0,0,11,0,31,0,263
44223,17722,8565,70,473,222,70,572,382,9157
88265,135,60,0,5,0,0,6,0,75
44430,4777,3049,19,310,110,17,89,80,1728
97205,7284,3716,17,308,167,27,127,107,3568
97434,930,440,0,47,8,0,28,13,490
81320,187,60,0,19,14,0,0,8,127
83466,193,109,0,9,0,0,0,0,84
92029,19149,9459,153,609,216,43,555,291,9690
29661,5885,2712,6,192,82,15,240,69,3173
44853,1372,682,25,15,18,4,44,41,690
45767,2489,1182,9,70,39,0,110,70,1307
46217,35190,16903,102,988,300,279,1181,437,18287
78610,35142,17343,55,2131,254,195,1535,461,17799
67439,3496,2246,11,168,29,8,83,56,1250
67442,293,185,16,0,0,0,6,10,108
33761,19744,9000,16,494,270,30,675,516,10744
55950,152,90,0,2,0,0,5,2,62
30711,3551,1741,75,51,0,3,108,71,1810
75038,30153,15007,140,1192,104,110,1529,114,15146
84036,7247,3781,49,308,61,14,250,60,3466
12832,6569,3078,2,130,142,72,128,112,3491
88049,357,192,0,0,0,0,0,10,165
612,60303,28488,341,1492,650,440,1953,697,31815
95403,45355,22470,208,1492,527,285,1327,647,22885
49064,3817,2042,7,84,55,0,68,41,1775
97346,897,491,0,15,26,0,2,27,406
3042,6919,3508,61,253,133,29,332,57,3411
43933,1875,929,23,56,28,24,80,35,946
3784,4004,2036,0,150,47,0,112,31,1968
6320,27074,13371,790,653,241,565,1026,464,13703
44902,4850,2546,50,159,16,62,154,35,2304
650,14760,7089,168,357,176,62,558,228,7671
38759,925,443,8,28,11,3,17,15,482
692,35840,17176,95,1171,328,255,1244,422,18664
50014,30231,16399,2391,848,185,1217,621,208,13832
1264,196,81,0,1,14,0,9,11,115
89022,0,0,0,0,0,0,0,0,0
85632,811,400,13,23,36,0,10,15,411
83124,127,66,0,3,4,0,6,10,61
40437,5394,2693,17,252,24,6,136,49,2701
42204,586,264,0,24,7,0,16,10,322
43071,1986,1031,2,85,24,32,68,35,955
38764,315,194,0,6,5,0,6,6,121
24079,1800,977,12,65,21,13,59,39,823
60010,46087,22253,204,1116,648,139,1336,830,23834
52312,80,34,0,1,1,0,1,1,46
55077,13474,6701,48,482,74,190,539,105,6773
31716,2960,1526,0,109,9,0,63,18,1434
15010,27736,13246,273,768,289,318,832,271,14490
17011,36306,19460,190,1511,415,88,957,490,16846
13032,12057,5895,63,230,157,46,377,230,6162
96011,162,90,0,2,4,0,1,3,72
33056,36409,16638,301,1022,308,243,1693,353,19771
33527,14850,7698,54,479,135,81,334,148,7152
33547,24813,12136,85,962,161,116,976,188,12677
37820,8171,3851,75,172,76,32,147,117,4320
36083,7542,3582,61,176,191,69,243,134,3960
39162,63,13,0,4,0,0,4,3,50
40223,23329,11475,83,472,272,106,671,217,11854
7073,9466,4620,59,478,47,53,348,135,4846
45674,651,350,49,8,9,53,2,2,301
1832,23419,11524,276,640,211,66,775,489,11895
46807,17348,8327,137,970,64,73,549,206,9021
35756,14202,6763,31,365,72,73,536,83,7439
2908,37549,17497,529,1309,292,674,1196,425,20052
26378,4438,2270,26,126,73,0,148,122,2168
74048,6213,3029,30,198,66,43,147,82,3184
41262,1001,467,0,38,0,18,80,15,534
41740,1090,666,0,67,8,0,42,8,424
91709,79298,38601,637,2405,750,546,2637,1031,40697
42151,240,130,0,0,0,0,0,0,110
94132,31488,15008,517,802,382,563,865,359,16480
95501,23467,11889,119,705,292,98,814,379,11578
97391,5559,2693,39,252,75,16,161,149,2866
46747,2467,1289,32,30,36,2,73,27,1178
47161,3197,1872,30,49,30,0,161,80,1325
66109,22433,11052,128,701,240,123,778,425,11381
68628,782,417,1,26,14,7,47,23,365
4739,870,431,0,22,26,0,34,21,439
4772,825,410,2,11,27,0,8,28,415
5905,711,363,1,6,18,0,23,26,348
75847,1856,856,2,36,27,0,120,18,1000
61251,337,172,0,52,0,0,16,0,165
61455,20698,9693,643,496,144,625,493,264,11005
83423,1003,523,4,23,20,0,6,8,480
72035,1671,715,40,0,0,67,0,0,956
72573,250,116,0,0,0,0,18,0,134
24202,11319,5976,73,188,107,38,323,152,5343
73016,1714,885,0,94,32,12,54,26,829
93955,34395,16999,250,1205,288,191,1063,403,17396
16150,6989,3346,42,174,60,47,165,82,3643
68730,1782,913,7,47,27,1,33,30,869
20612,358,177,0,0,0,0,0,0,181
30224,25142,11968,137,933,174,73,864,257,13174
28133,2383,1072,6,35,29,14,38,18,1311
64061,3028,1524,16,83,20,7,72,74,1504
29640,30295,14818,99,911,297,258,921,414,15477
22580,5291,2414,31,110,48,55,71,87,2877
55356,5429,2793,43,122,50,10,140,28,2636
17238,1612,849,24,37,14,18,45,38,763
12921,2464,1209,13,66,9,13,80,55,1255
4645,26,20,0,3,0,0,0,0,6
8901,57659,27716,1716,2111,190,1882,1729,341,29943
10922,1562,754,0,54,0,0,70,0,808
68344,400,180,0,12,0,0,16,11,220
68870,620,329,0,18,18,2,14,9,291
1037,798,466,0,0,19,0,7,13,332
89403,15775,8213,61,463,230,60,479,155,7562
39113,666,470,0,19,0,1,4,0,196
95968,1287,711,0,34,16,0,57,59,576
83860,6161,3216,52,88,94,56,151,285,2945
27253,30544,14811,132,921,371,137,1073,504,15733
77077,58131,27385,353,2555,595,302,2755,570,30746
24935,404,215,0,0,13,0,0,0,189
77351,33740,18667,213,1265,465,162,731,470,15073
95140,115,64,0,16,0,0,0,9,51
72841,195,99,0,9,0,0,0,0,96
80116,4014,1993,0,72,78,13,102,116,2021
92536,3028,1589,29,40,11,0,81,93,1439
15554,2130,1040,0,11,44,0,72,17,1090
14415,205,100,17,11,0,0,11,0,105
14892,8084,3939,28,264,50,37,318,100,4145
7417,10883,5433,141,166,146,10,350,112,5450
4021,6483,2885,29,204,56,25,332,148,3598
13335,1519,829,38,34,6,31,22,18,690
5154,519,245,8,11,0,0,11,27,274
15762,908,488,0,19,3,5,11,10,420
23359,1128,417,0,38,22,0,70,9,711
33476,8618,4819,71,337,54,38,147,169,3799
33621,2533,1451,41,136,0,24,140,21,1082
3740,656,382,8,21,24,0,28,29,274
16424,4712,2423,40,116,98,6,93,57,2289
8805,11974,5873,33,542,112,80,215,166,6101
96859,111,64,6,0,0,0,0,0,47
84780,24872,12301,118,788,386,39,691,253,12571
93222,1481,806,0,5,16,0,26,9,675
58735,308,161,3,25,9,0,9,4,147
28905,2995,1470,0,56,92,41,38,106,1525
17009,1987,1012,21,97,15,3,69,15,975
35464,690,378,0,6,0,7,2,0,312
45039,25142,12217,89,933,257,55,1124,445,12925
12969,410,216,0,10,19,0,18,6,194
46135,20800,11190,295,962,172,327,508,328,9610
41653,10404,5152,201,318,77,63,425,174,5252
14131,5039,2626,21,146,91,3,141,98,2413
23324,24126,10937,103,550,203,217,997,349,13189
25502,1126,480,0,17,16,0,61,0,646
36481,522,240,0,0,1,0,9,0,282
16441,10226,5268,41,304,96,82,312,202,4958
38255,2252,1126,15,98,14,0,54,38,1126
17516,4286,2165,34,183,73,9,149,34,2121
24251,8407,4204,14,326,133,5,317,136,4203
19560,7750,3635,20,268,109,104,295,141,4115
47040,5025,2643,0,170,98,0,138,96,2382
13748,3779,1898,41,65,56,0,73,53,1881
8054,41518,19626,190,1173,511,241,1454,648,21892
8824,12301,5988,86,393,110,89,284,188,6313
94124,35363,17037,121,1240,350,233,1376,401,18326
92672,34110,16798,261,861,390,195,1063,504,17312
95376,53542,26525,425,2161,302,519,1972,622,27017
95614,3961,2059,27,130,30,0,91,88,1902
93043,184,60,0,26,0,2,0,0,124
98445,32504,15936,176,834,269,151,1204,330,16568
57782,39,21,0,0,0,0,2,0,18
99223,31603,15135,122,976,325,205,1175,500,16468
87722,684,515,45,0,0,0,0,0,169
62013,693,345,3,9,5,0,11,10,348
62232,6705,3198,46,308,82,148,394,128,3507
63852,1071,458,0,32,0,0,56,0,613
20565,0,0,0,0,0,0,0,0,0
83234,1432,768,3,27,22,4,36,28,664
21052,251,127,8,0,6,0,0,0,124
69211,423,218,5,14,0,0,11,2,205
77434,4765,2215,0,181,0,79,86,57,2550
70375,85,43,0,0,10,0,0,0,42
71422,1709,861,9,55,14,24,4,22,848
66782,132,69,0,7,0,1,6,3,63
77079,33768,16300,109,784,224,29,1152,243,17468
68785,301,141,2,1,3,5,8,0,160
60402,63554,31612,697,2494,623,630,2423,852,31942
76105,21822,11121,190,640,82,231,680,205,10701
62550,2778,1310,9,68,45,0,71,28,1468
66760,0,0,0,0,0,0,0,0,0
64468,15681,7745,580,313,194,377,331,170,7936
66940,351,146,0,15,5,0,6,7,205
93201,1431,772,23,77,8,18,51,5,659
55390,2548,1368,5,86,26,19,90,38,1180
94583,35102,17397,95,1151,293,160,1411,300,17705
57053,1774,838,0,54,4,0,58,31,936
58032,735,381,35,25,13,25,13,7,354
49032,3257,1688,21,81,20,13,86,71,1569
68362,27,19,0,8,2,0,0,0,8
60107,40437,20514,319,1458,395,254,1568,664,19923
41101,18594,8930,51,680,259,101,687,284,9664
12302,27407,12687,74,761,290,153,874,310,14720
12566,11003,5179,16,468,151,15,425,212,5824
6498,6922,3348,61,91,165,81,131,133,3574
37359,758,365,0,26,22,0,5,41,393
71851,2090,1096,20,106,4,9,69,57,994
61856,7884,3763,15,133,126,80,221,66,4121
62477,781,391,0,28,22,0,26,4,390
79018,321,134,0,2,0,0,12,0,187
79025,49,31,0,0,0,0,0,0,18
71270,31045,15177,659,768,225,1015,829,346,15868
58357,377,194,0,10,0,0,12,9,183
72682,595,253,39,20,0,0,50,24,342
61372,161,86,0,12,2,0,11,1,75
80446,4486,2501,12,133,153,160,165,205,1985
82440,201,15,0,0,0,0,0,0,186
74844,406,228,3,8,1,1,5,5,178
73933,1504,734,21,46,27,11,59,33,770
76380,3639,1782,0,124,46,0,70,31,1857
83845,1875,851,0,74,66,0,69,43,1024
76836,16,12,0,0,0,0,0,0,4
84318,4526,2222,68,130,63,48,131,33,2304
60148,52963,26126,262,1881,552,362,1907,601,26837
80301,25690,13189,122,988,477,234,928,324,12501
19106,12375,6390,24,483,177,12,460,211,5985
28326,23385,11855,88,1145,127,141,1015,106,11530
65202,48560,24330,378,1848,379,505,1854,544,24230
45054,2926,1396,9,71,21,0,92,41,1530
93627,188,78,0,0,0,25,0,0,110
51571,543,283,2,21,6,0,18,3,260
93928,820,650,11,77,0,29,17,0,170
42020,1924,1025,0,98,19,0,97,13,899
20418,0,0,0,0,0,0,0,0,0
87827,110,82,0,0,0,0,0,0,28
6763,1924,970,18,49,39,11,58,19,954
8059,5612,2608,58,135,77,54,188,75,3004
31029,16459,8285,79,382,291,60,613,154,8174
21701,37185,17584,197,1097,495,202,1131,452,19601
21717,77,53,17,0,10,0,0,0,24
30016,54242,25814,618,2218,397,281,2431,618,28428
18616,590,301,0,5,2,0,16,4,289
18801,8018,3864,46,185,88,36,226,94,4154
2114,13516,6860,82,568,134,102,600,204,6656
17845,2043,917,8,25,18,14,36,49,1126
95618,26743,13077,449,758,272,523,759,291,13666
76001,32185,15778,350,913,237,143,1187,394,16407
65552,2070,1195,0,72,13,0,120,13,875
3221,2190,1107,12,78,52,6,41,62,1083
90241,44143,21976,388,1343,364,335,1416,700,22167
75476,1162,590,0,43,2,9,59,35,572
98467,16184,7949,151,438,261,100,619,174,8235
82215,101,58,0,6,4,0,0,0,43
69143,1289,628,0,20,18,0,26,5,661
95841,20586,9467,88,788,197,187,838,406,11119
64490,1924,966,1,83,16,15,62,27,958
87455,1741,890,18,55,14,8,59,22,851
76542,49857,24218,362,1596,232,468,2176,507,25639
98311,27856,14397,276,970,316,137,866,385,13459
95310,1995,1087,0,60,86,0,50,9,908
60910,671,339,0,21,2,0,9,2,332
61701,35783,17527,444,1365,413,589,1165,395,18256
79714,17818,9102,124,700,147,84,603,181,8716
80537,43637,21529,163,1271,750,160,1318,585,22108
8041,978,493,0,18,13,0,25,12,485
70777,3566,1442,55,45,89,40,114,57,2124
1740,5236,2687,34,169,54,12,154,73,2549
26541,2713,1431,20,126,92,0,122,112,1282
41763,653,311,0,29,4,0,66,0,342
66936,269,135,0,9,0,0,0,14,134
4945,1022,503,0,52,24,0,28,19,519
61313,209,104,0,0,5,0,0,0,105
15082,163,48,0,16,0,0,15,0,115
97732,129,73,5,9,0,0,5,0,56
98338,27508,13796,158,784,228,195,928,421,13712
61942,1045,482,0,65,17,13,38,23,563
95547,978,401,0,38,23,17,55,0,577
68326,261,127,2,29,8,0,21,4,134
71643,1037,452,2,17,18,3,23,15,585
68520,1521,732,0,20,55,0,17,27,789
73128,4757,2635,12,51,24,66,228,44,2122
14477,1349,676,13,39,28,0,62,26,673
93307,84809,41457,906,2525,556,573,2870,529,43352
16733,235,104,0,11,3,0,8,10,131
83449,183,82,0,14,14,0,8,4,101
84744,306,162,0,1,2,0,0,4,144
67038,769,395,4,20,8,6,20,8,374
21208,36441,16010,152,943,531,128,1281,542,20431
89310,356,220,0,2,20,0,1,0,136
17730,200,52,0,52,0,0,0,0,148
45861,207,110,0,15,0,0,1,1,97
7866,22831,11009,140,680,311,142,688,400,11822
48329,24599,11909,159,672,213,114,839,447,12690
64486,490,250,0,21,13,0,5,4,240
68724,157,85,0,3,5,0,0,0,72
68958,675,361,14,18,9,1,13,5,314
70655,3020,1359,0,100,15,22,125,62,1661
61320,724,390,6,14,6,3,16,12,334
82411,584,267,9,20,2,0,10,6,317
85611,839,349,0,18,20,0,68,69,490
78641,65654,32528,449,2546,368,375,3003,591,33126
96850,0,0,0,0,0,0,0,0,0
98019,11811,5849,10,419,135,57,544,114,5962
89107,38165,20000,279,1128,316,171,1210,336,18165
93702,44139,22796,415,1780,255,356,1348,297,21343
29201,21242,11003,1435,369,74,1125,348,103,10239
29572,9395,4588,162,170,271,36,260,226,4807
29690,23217,11419,458,520,376,158,636,219,11798
35764,497,242,0,2,4,0,15,1,255
44683,8552,4197,51,343,71,82,392,132,4355
46750,26478,12909,182,820,268,273,689,380,13569
42431,26055,12712,180,724,242,227,597,390,13343
43003,3005,1564,52,90,58,6,69,75,1441
89828,381,167,0,0,0,0,0,0,214
98548,2405,1217,0,36,65,0,0,11,1188
55918,845,419,2,16,5,11,22,11,426
42338,11,0,0,0,0,0,0,0,11
43066,1239,677,0,22,0,0,51,0,562
44056,11808,5846,0,379,167,139,419,283,5962
44202,20408,9867,102,585,282,55,610,235,10541
33018,52526,25552,398,1752,357,282,1768,499,26974
35133,3690,1829,23,71,29,0,87,18,1861
50476,819,411,0,29,5,0,45,6,408
47991,958,494,0,5,22,0,3,4,464
48731,1575,800,19,41,22,13,38,30,775
36476,18,13,0,0,4,0,0,0,5
38345,1971,1055,21,12,15,17,44,14,916
46157,4046,2219,11,104,20,29,105,55,1827
47164,4101,2043,0,198,57,39,79,38,2058
79423,38547,18826,311,1304,335,127,1445,359,19721
79745,6967,3566,82,181,83,39,209,66,3401
60517,32328,15966,155,984,286,157,1178,441,16362
61080,10440,5071,56,406,116,36,340,170,5369
62336,18,9,0,0,0,1,0,0,9
71238,3427,1565,0,134,63,25,131,85,1862
67583,873,483,15,32,14,3,29,10,390
75023,50061,24177,180,1783,416,284,1841,807,25884
75135,7725,3919,68,149,8,19,223,63,3806
75219,23419,12618,48,1155,227,32,691,231,10801
75492,394,231,21,2,9,0,6,2,163
6755,1050,477,0,30,8,0,34,0,573
7087,68484,33645,531,2782,375,420,2472,654,34839
7310,12682,6783,25,912,112,161,818,71,5899
7656,8804,4533,114,264,133,42,181,204,4271
27832,3001,1267,28,48,70,14,65,61,1734
53941,2988,1543,10,85,58,11,75,40,1445
53961,895,453,2,55,8,1,15,15,442
68307,511,287,3,10,21,0,16,3,224
57002,1078,525,7,35,12,0,38,5,553
60020,9827,4482,84,366,185,17,394,54,5345
60089,41392,20239,54,1404,500,181,1494,605,21153
60131,18025,8782,81,522,120,143,693,250,9243
60415,14254,6854,152,473,126,79,705,253,7400
61061,6382,3117,26,205,138,0,172,99,3265
62260,7405,3655,0,318,43,0,154,178,3750
62343,948,474,0,19,2,0,19,9,474
55118,28402,13495,162,955,428,233,882,375,14907
74008,28808,14228,81,1182,234,70,1128,273,14580
66959,187,99,0,0,6,0,0,4,88
54956,43736,21575,266,1312,428,262,1482,489,22161
52202,1028,562,0,22,0,14,25,9,466
54413,139,72,0,9,2,0,0,6,67
54557,893,472,0,11,24,1,9,21,421
48143,0,0,0,0,0,0,0,0,0
12486,1558,841,0,8,5,38,27,17,717
13020,110,61,0,0,0,0,0,3,49
13053,4980,2204,22,157,27,58,219,96,2776
13303,1113,551,4,17,4,14,9,12,562
5254,251,111,0,0,0,0,0,4,140
14624,35885,17562,299,957,471,76,1103,611,18323
16511,11647,5179,28,293,127,23,523,214,6468
17211,399,189,0,2,5,0,17,7,210
74754,253,158,0,12,14,0,10,5,95
74939,1164,896,4,104,19,3,3,17,268
75973,2657,1398,33,65,69,23,47,38,1259
76164,15685,8249,211,745,116,147,422,154,7436
76885,322,140,0,0,0,0,0,0,182
77010,862,471,0,12,12,0,25,10,391
82217,42,19,0,0,0,0,0,12,23
91723,18875,9213,32,952,216,93,790,150,9662
77363,2956,1347,0,76,12,0,59,98,1609
98563,7937,3946,91,247,75,71,251,96,3991
94521,43103,20755,318,1246,436,185,1313,806,22348
96766,18272,9482,88,507,277,86,571,307,8790
97338,21542,9873,137,452,165,124,614,391,11669
68040,631,353,0,21,0,2,2,0,278
29101,2889,1350,5,23,53,51,69,45,1539
7860,25425,12826,141,748,254,190,578,390,12599
13646,2030,1019,2,40,33,0,67,32,1011
13648,2298,1164,8,73,37,0,56,31,1134
62852,61,28,0,2,3,0,2,0,33
64056,16876,7791,49,354,105,95,543,256,9085
70426,5867,3530,28,386,142,149,194,112,2337
71845,2170,1056,29,40,25,0,74,24,1114
49870,3319,1669,0,36,45,26,82,69,1650
50523,685,399,0,20,2,5,12,8,286
51004,989,538,17,19,34,3,32,32,451
57520,97,48,0,12,2,0,1,0,49
48214,21086,9842,101,643,335,211,490,295,11244
4930,4056,1880,7,67,100,6,75,22,2176
4967,4065,1968,40,114,67,32,118,44,2097
6405,27825,13051,110,762,316,132,613,405,14774
15777,96,55,0,0,0,0,0,0,41
16160,808,379,5,34,10,9,10,7,429
17005,323,171,0,6,2,0,9,3,152
13786,384,230,0,3,3,0,9,4,154
8502,11203,5725,38,303,179,0,415,91,5478
8902,41135,19745,181,1734,413,132,2147,577,21390
10536,10853,5082,14,218,132,87,182,268,5771
662,40290,19548,159,1174,405,172,1300,702,20742
1226,6782,3037,33,195,115,16,203,131,3745
2333,14386,6822,22,451,88,81,468,200,7564
2460,9754,4625,106,342,101,64,314,160,5129
81020,877,418,0,17,12,18,21,9,459
81128,100,50,0,0,0,0,0,0,50
81428,3272,1670,8,71,84,0,115,105,1602
84106,36047,17811,279,1763,190,196,1315,370,18236
84647,4403,2462,104,101,85,0,86,39,1941
93206,1970,1062,4,30,2,0,40,6,908
84761,3250,1663,22,22,0,28,55,45,1587
98360,13363,6369,22,405,167,12,450,225,6994
93455,45116,21526,328,1386,524,633,1445,657,23590
94087,57219,28494,175,2476,313,41,2319,616,28725
77617,34,27,0,0,0,0,0,0,7
78252,12153,7393,99,875,134,69,417,38,4760
52232,186,94,0,18,1,0,6,2,92
52334,152,88,0,0,6,0,0,7,64
52341,1071,535,0,15,71,0,0,36,536
52354,360,189,0,0,20,0,0,0,171
65101,29998,16319,263,1276,258,202,726,378,13679
62907,1995,954,7,74,34,40,49,34,1041
21040,24424,11580,218,747,279,383,833,343,12844
47968,1123,528,11,36,10,15,37,23,595
21628,531,277,0,33,8,0,8,11,254
3445,765,366,0,10,2,3,10,15,399
5042,530,287,0,12,6,0,13,11,243
15469,1978,942,0,120,57,12,76,17,1036
10451,47798,22334,427,1396,287,406,1619,524,25464
10974,3175,1572,22,117,49,30,70,35,1603
11224,46707,20929,280,1270,716,416,1394,796,25778
22181,15299,7436,68,495,213,104,527,114,7863
28526,3018,1504,6,73,26,0,68,9,1514
29202,274,149,0,8,0,9,0,0,125
12172,271,130,0,0,0,27,0,0,141
27011,5380,2600,2,136,22,18,163,21,2780
27888,2233,1163,0,132,18,9,43,20,1070
10605,18643,8961,42,510,154,142,663,266,9682
41774,2383,1179,16,57,39,0,32,40,1204
42259,1256,732,38,32,11,2,16,14,524
51443,1628,894,0,38,34,7,43,17,734
58021,433,200,0,26,3,0,28,8,233
44677,2463,1205,15,86,45,3,71,34,1258
35802,21829,10204,130,571,146,134,608,356,11625
46772,3044,1640,15,55,6,24,84,49,1404
44262,5049,2429,68,118,146,82,142,112,2620
44607,178,105,0,10,0,0,0,0,73
45810,8230,4186,242,47,48,110,170,95,4044
50630,1934,883,3,45,10,0,48,35,1051
35768,11164,5375,37,165,224,122,273,159,5789
36401,8109,3939,16,149,123,15,294,71,4170
4955,1557,766,10,25,13,0,65,41,791
5742,626,314,0,12,5,8,14,5,312
7422,6377,3055,107,224,105,57,92,122,3322
91405,55384,27262,469,2099,289,541,2129,668,28122
95690,2122,1080,0,105,89,41,34,0,1042
96793,33074,16010,281,1068,403,213,1133,365,17064
75862,10044,4807,125,231,214,16,224,243,5237
94555,38388,19015,250,1849,307,49,1972,473,19373
96075,331,229,0,7,0,0,0,1,102
79553,3305,1418,15,36,21,20,88,54,1887
80026,29576,14785,202,1302,407,47,1079,473,14791
81133,1199,615,8,34,20,0,26,7,584
88061,17768,8494,254,427,281,94,399,201,9274
90744,57206,28854,551,1929,380,568,1932,486,28352
1862,10223,5724,81,317,91,17,186,127,4499
969,42525,19104,424,1364,344,295,1436,681,23421
1072,1536,733,5,34,27,0,66,27,803
43403,5501,2440,153,0,0,80,0,0,3061
28091,1909,977,0,86,39,21,63,3,932
47848,1670,831,52,46,9,0,31,10,839
17317,697,366,3,57,9,0,25,3,331
8038,83,45,0,0,0,0,3,3,38
10980,13943,6827,78,274,150,61,308,229,7116
12161,199,157,0,0,0,0,0,0,42
12866,39178,19113,360,1059,702,355,1120,565,20065
4548,917,469,0,22,22,0,12,15,448
83803,1114,575,0,44,75,0,0,28,539
84069,549,248,1,11,1,6,8,10,301
84767,540,291,0,31,6,13,8,12,249
85321,4370,2121,29,110,83,0,88,71,2249
86046,5266,2783,38,148,113,9,74,74,2483
59443,402,197,0,5,2,0,0,4,205
16410,1709,829,10,45,16,8,43,31,880
16509,27566,13597,86,852,322,91,618,462,13969
16829,702,366,0,27,11,8,19,19,336
17407,2226,1126,5,54,76,8,61,29,1100
18250,2958,1452,11,96,16,0,109,0,1506
26209,244,147,0,0,0,0,20,8,97
6070,15689,7774,94,474,152,46,426,211,7915
11223,81789,40113,485,2443,744,346,2335,1299,41676
29040,10616,5414,74,265,92,40,290,113,5202
29728,9722,5022,61,252,114,51,318,86,4700
22843,2476,1293,39,74,8,45,65,22,1183
36260,4001,2232,38,160,47,40,138,67,1769
36483,392,206,0,0,14,0,0,5,186
37640,3777,1900,12,127,38,30,141,71,1877
24860,293,152,0,0,12,0,12,0,141
43527,1986,972,27,64,36,11,44,31,1014
39481,1557,823,24,112,0,0,72,21,734
40229,38879,19245,333,1453,300,275,1415,449,19634
47562,4827,2405,22,144,48,33,162,18,2422
29323,12489,5980,165,349,136,63,416,160,6509
28314,58110,28123,713,1915,414,559,1641,403,29987
32569,12971,6842,185,446,70,147,321,84,6129
34661,138,17,0,0,0,0,0,0,121
99587,2065,1164,2,76,1,84,79,0,901
28801,13683,6685,25,648,143,208,528,197,6998
4861,2782,1521,0,52,70,0,141,0,1261
94014,49515,24900,314,1596,439,325,1408,769,24615
5465,5414,2774,68,114,53,48,161,56,2640
94952,36184,17765,128,1274,469,224,1073,533,18419
24898,58,27,0,0,0,0,0,0,31
65321,494,270,4,23,3,0,6,5,224
10511,2158,1127,14,92,23,4,56,18,1031
11752,9564,4731,118,313,31,117,279,92,4833
58748,137,82,0,5,1,1,6,2,55
1038,2867,1399,14,47,31,28,67,47,1468
67483,423,211,9,6,7,0,9,1,212
59521,3764,1815,11,93,24,24,75,38,1949
59644,4416,2189,9,107,33,0,126,44,2227
54531,1331,673,0,32,30,6,34,31,658
54654,66,25,0,0,0,0,0,0,41
33715,7488,3794,22,80,182,0,81,197,3694
77878,302,221,17,10,3,0,0,0,81
78549,861,356,0,25,15,22,16,8,505
35601,32666,15655,181,1233,444,302,938,438,17011
65025,762,379,18,19,16,5,26,12,383
75972,5997,2841,0,137,37,17,231,45,3156
43162,7189,3370,49,240,85,82,190,110,3819
70580,208,101,39,0,0,0,0,0,107
46755,15253,7583,67,423,249,56,455,100,7670
71651,97,76,0,0,13,0,0,9,21
81090,1025,515,0,26,7,0,5,16,510
30822,784,491,0,24,0,0,21,0,293
72113,25716,11537,198,899,165,36,983,294,14179
22849,5212,2604,6,166,81,11,173,50,2608
72534,1550,850,29,117,15,0,56,0,700
28726,3219,1753,16,237,0,27,206,32,1466
57050,324,182,0,21,0,0,0,0,142
93210,18025,10645,132,887,146,155,387,144,7380
98555,329,96,0,0,0,0,0,0,233
97019,3084,1550,12,90,66,12,103,41,1534
94402,25764,12743,36,1025,217,88,895,317,13021
7311,404,222,0,31,0,0,18,0,182
8241,1153,598,0,58,12,13,16,8,555
99922,330,167,4,9,4,5,3,5,163
97128,38160,18985,453,1113,472,348,1077,506,19175
25868,395,188,0,0,0,0,0,12,207
32466,6450,3134,137,290,93,41,188,197,3316
17979,191,73,0,0,0,0,3,48,118
37036,5855,2948,50,185,75,29,233,80,2907
12116,1666,792,0,66,75,0,43,40,874
38127,44227,20168,91,1074,260,609,1569,745,24059
58474,2643,1297,1,47,25,33,76,22,1346
60410,12791,6523,90,394,121,35,591,105,6268
72122,521,318,9,39,14,0,27,0,203
22514,2243,1112,11,35,50,20,120,33,1131
83655,4376,2219,6,116,94,7,76,59,2157
30286,22085,10521,147,661,272,0,623,408,11564
30820,1112,550,0,22,0,0,27,9,562
87312,504,178,8,12,11,5,25,5,326
21613,17109,7832,64,368,194,34,366,310,9277
78161,712,335,0,0,0,0,51,0,377
4982,570,349,2,19,4,0,24,8,221
71973,1748,807,0,63,10,3,101,13,941
1343,45,19,0,3,0,0,0,0,26
2777,16276,8503,61,472,166,33,607,179,7773
31812,585,289,2,19,23,0,8,0,296
78060,115,115,0,0,31,0,0,0,0
32112,8054,3826,146,260,137,5,232,100,4228
42124,18,9,0,0,0,0,0,0,9
17004,4943,2431,16,78,80,31,118,73,2512
63109,26562,12274,80,953,154,37,1220,697,14288
20151,23053,11260,112,690,130,127,769,140,11793
55024,35035,17029,78,1176,214,214,1420,183,18006
56714,1217,675,4,38,15,3,31,9,542
1098,1196,569,9,19,38,5,35,28,627
57276,1275,637,8,68,11,6,50,30,638
4292,1034,501,0,56,18,0,33,10,533
48623,13589,7571,80,616,172,56,303,197,6018
95666,5113,2567,5,164,115,8,128,159,2546
67423,269,124,0,10,1,0,14,2,145
67950,2031,1076,0,46,12,31,55,17,955
63037,2967,1459,8,96,21,9,90,71,1508
98559,0,0,0,0,0,0,0,0,0
74012,62429,30418,351,2184,613,248,2133,822,32011
70453,757,406,0,22,70,15,9,21,351
99322,201,95,0,1,3,0,4,0,106
78409,2678,1338,6,81,33,22,110,27,1340
74830,241,128,5,8,3,0,5,3,113
97132,29546,14425,289,1051,399,209,994,432,15121
75964,19717,9820,88,591,199,330,508,305,9897
63434,788,370,0,41,2,2,48,5,418
64856,3786,1924,18,73,48,3,115,56,1862
44641,20239,9655,81,515,356,151,548,240,10584
77201,0,0,0,0,0,0,0,0,0
71665,5856,2933,38,127,71,23,129,50,2923
50431,187,106,0,22,11,0,5,3,81
63401,22201,10747,210,699,225,123,695,328,11454
28019,0,0,0,0,0,0,0,0,0
70445,9954,4818,53,339,78,55,498,336,5136
21622,1030,430,1,18,23,11,54,32,600
73560,839,406,3,15,23,9,38,0,433
49770,16977,8283,165,435,229,67,526,321,8694
53219,34418,16600,120,1227,243,166,1262,500,17818
62885,722,349,0,5,4,0,12,17,373
44062,14523,7328,107,352,138,100,339,67,7195
81657,5850,2996,103,321,57,51,189,97,2854
78724,24779,12632,89,1059,80,199,1204,84,12147
95917,4030,2140,38,52,22,12,75,38,1890
90002,53111,25518,510,1653,244,359,2098,520,27593
95060,47367,23335,999,1218,553,865,1302,617,24032
91007,34523,16251,189,1033,344,112,1111,477,18272
99026,9298,5173,95,240,155,25,127,96,4125
28439,931,357,0,16,7,0,33,39,574
30066,55548,27122,586,2183,690,257,1677,868,28426
30735,6334,3362,228,155,138,32,168,69,2972
31304,0,0,0,0,0,0,0,0,0
31792,24017,11468,87,628,256,38,546,250,12549
35043,11461,5393,64,484,96,0,447,63,6068
36470,178,54,0,0,0,0,0,0,124
42120,2779,1465,0,104,55,0,138,20,1314
22211,1185,1080,117,9,0,14,0,5,105
24487,322,167,0,0,0,11,0,0,155
25187,627,273,0,14,0,0,0,19,354
25908,154,69,0,0,0,0,19,32,85
17976,6531,3072,41,201,115,83,173,203,3459
15637,1530,750,0,71,0,0,26,6,780
8809,6013,3061,22,121,50,26,139,100,2952
8853,5243,2519,88,218,29,69,141,72,2724
93641,198,172,0,14,2,0,0,12,26
95926,39012,19122,941,863,393,923,954,301,19890
97216,16870,8288,55,830,94,58,851,195,8582
86332,1810,958,7,17,40,3,27,49,852
89502,45772,23912,622,1647,616,353,1243,504,21860
90254,19650,10546,17,959,187,36,836,178,9104
21220,40211,19396,307,1075,349,104,1834,574,20815
38388,2073,1015,1,38,36,5,93,14,1058
61047,1839,859,8,55,24,22,41,55,980
64137,10646,5046,65,321,123,87,309,102,5600
78949,666,331,0,18,0,0,40,25,335
79770,69,38,0,0,0,0,0,0,31
67561,1277,690,3,19,12,4,21,14,587
67853,667,384,0,13,3,0,17,0,283
78004,934,440,0,0,27,0,10,0,494
84637,765,443,18,6,3,0,14,8,322
60305,11064,5383,90,274,152,65,397,134,5681
65704,3561,1600,6,64,3,0,57,52,1961
57427,775,379,0,0,41,0,48,8,396
57762,647,347,2,7,11,0,17,2,300
48705,529,296,0,13,18,6,7,21,233
50007,480,232,3,15,10,0,17,12,248
50430,411,224,10,6,5,0,0,10,187
50859,577,278,7,4,2,19,17,3,299
51024,1778,892,9,62,46,23,33,37,886
36318,1571,812,0,91,7,4,45,28,759
43533,1702,865,54,47,47,16,31,20,837
43604,8920,4586,56,214,152,38,217,115,4334
46166,2101,1067,2,87,28,1,88,2,1034
47396,6813,3242,51,253,8,96,140,93,3571
36584,741,405,0,28,0,0,20,0,336
37240,778,336,43,0,0,37,0,0,442
39325,6750,2932,26,143,15,144,201,42,3818
62556,326,151,2,8,3,2,10,8,175
62702,34051,16519,236,1093,311,196,921,406,17532
71674,636,317,15,0,3,6,12,11,319
79118,23246,12036,36,1015,121,54,541,417,11210
77977,601,306,13,20,13,21,13,26,295
58385,216,130,0,9,2,4,8,0,86
58425,1349,597,0,35,26,0,4,11,752
67657,259,127,0,5,9,0,3,8,132
17017,1565,800,11,28,10,0,40,13,765
17938,2358,1212,0,74,46,0,100,24,1146
15545,2588,1302,6,84,49,15,83,40,1286
30907,51984,24325,148,1902,582,387,1883,929,27659
35577,41,17,0,0,0,0,0,0,24
36775,839,385,0,14,6,13,0,0,454
37819,684,392,0,37,7,0,28,24,292
39326,426,69,0,0,0,0,0,32,357
40022,1070,484,21,9,17,25,9,10,586
40055,1894,803,0,50,27,0,129,35,1091
40827,1076,416,0,33,21,0,27,23,660
40874,394,224,0,0,0,0,0,0,170
45692,8731,4148,14,262,122,58,187,59,4583
46041,22664,11302,111,673,191,74,678,290,11362
54311,35700,17591,254,937,306,342,1118,506,18109
48362,16056,7868,169,415,161,95,425,207,8188
49009,45263,21245,316,1273,445,454,1347,667,24018
49764,190,98,0,21,0,0,21,0,92
2914,21605,10434,170,919,191,39,754,328,11171
13471,3313,1737,4,118,66,14,65,52,1576
8890,15,7,0,0,7,0,0,0,8
728,39698,19789,557,1114,524,352,1234,534,19909
38925,2616,1270,0,127,17,24,62,26,1346
39661,2925,1427,18,104,109,17,40,64,1498
50257,1018,495,2,26,14,0,18,1,523
51054,5633,2723,0,175,70,86,205,52,2910
53010,7663,3940,38,276,74,22,225,129,3723
54025,7361,3759,5,224,14,14,262,97,3602
54162,8988,4597,75,303,126,49,272,116,4391
63537,1925,946,19,54,19,11,57,26,979
48165,7612,3688,58,200,84,0,223,86,3924
49113,1810,947,0,87,7,9,37,26,863
49253,2803,1444,9,94,34,19,71,76,1359
70669,9587,5119,53,496,110,25,375,90,4468
71316,39,27,0,0,0,0,0,0,12
54446,3203,1603,15,89,27,23,123,20,1600
73729,535,262,0,15,12,0,10,21,273
74733,3161,1511,14,64,43,5,61,50,1650
74827,351,142,0,0,2,0,0,1,209
44132,14805,6692,67,371,108,144,543,225,8113
44714,8442,3903,40,145,66,102,145,162,4539
45387,5456,2694,36,78,150,5,74,98,2762
54739,5275,2734,27,174,55,18,165,42,2541
55319,5261,2761,18,154,54,35,167,60,2500
56378,7896,3968,91,215,88,30,175,105,3928
56654,140,64,0,0,3,0,5,0,76
52161,1416,743,9,16,23,3,15,34,673
53929,2557,1310,4,73,31,3,62,35,1247
53959,13971,6984,40,451,108,78,512,185,6987
54619,3908,1975,51,171,40,12,131,46,1933
37871,9849,4866,52,286,115,37,277,97,4983
38076,927,493,34,43,8,30,22,11,434
39437,13564,6192,35,394,258,111,351,115,7372
46902,35403,16541,218,1053,391,250,1026,497,18862
35173,27371,13080,201,809,361,85,875,482,14291
28720,140,70,0,5,7,0,1,1,70
29033,12541,6082,161,269,61,96,312,246,6459
29469,880,514,21,0,0,0,28,17,366
14757,3298,1640,5,88,61,18,142,40,1658
16405,776,405,11,17,8,11,29,14,371
16417,7863,3678,52,184,105,79,234,63,4185
4268,4969,2261,38,107,14,0,84,84,2708
4442,22,14,0,0,5,0,0,0,8
20018,19943,9090,64,908,136,144,975,333,10853
21160,2845,1419,0,69,15,15,100,0,1426
1469,7632,3744,93,296,138,33,345,106,3888
2120,14928,7729,743,277,20,418,240,112,7199
2771,15210,7169,54,415,197,58,552,275,8041
27571,6664,3209,0,285,91,0,488,100,3455
59731,100,59,0,6,3,0,4,3,41
62059,452,172,11,5,0,12,8,13,280
58241,163,81,0,14,4,0,22,1,82
32903,14090,6560,38,268,199,23,367,192,7530
35080,17889,8618,47,736,88,99,632,183,9271
40434,0,0,0,0,0,0,0,0,0
41045,1620,918,6,99,26,4,34,8,702
48145,3467,1796,9,116,30,0,136,62,1671
49453,2459,1216,35,46,57,0,44,85,1243
50244,1887,921,13,45,22,4,52,22,966
50860,251,113,0,6,0,0,13,20,138
27979,1547,785,8,95,39,0,21,0,762
12056,2743,1499,81,99,35,111,43,50,1244
12058,1656,777,7,109,45,0,91,14,879
29492,13202,6179,5,459,108,15,550,131,7023
20148,48110,23181,184,2669,183,197,3396,301,24929
24572,16698,7844,101,453,192,60,530,320,8854
88427,211,118,0,20,2,0,0,4,93
95046,6025,3107,29,98,69,69,202,41,2918
84326,1822,968,0,65,19,10,82,0,854
99620,811,442,3,13,3,4,17,6,369
51436,907,506,0,20,17,10,33,6,401
52655,4209,2010,10,100,60,52,142,47,2199
52749,1036,523,4,37,12,14,48,18,513
43616,20380,10194,194,465,309,86,692,273,10186
14819,745,317,2,7,8,29,19,3,428
22206,20150,8934,21,928,216,10,1629,226,11216
22644,2413,1208,0,21,34,0,35,40,1205
4427,2830,1410,13,97,49,0,111,36,1420
4555,1641,804,0,31,26,6,18,27,837
6409,466,199,0,0,0,0,0,0,267
8036,5915,2952,34,270,87,87,188,60,2963
8731,19956,9975,60,442,294,108,573,244,9981
10009,57925,26519,272,2240,592,882,2182,1106,31406
24216,2668,1437,14,66,18,16,76,41,1231
24580,501,289,0,0,0,0,0,7,212
6082,44455,23464,155,1647,421,269,1276,534,20991
6119,15715,7459,77,403,202,36,590,213,8256
29704,3693,1877,0,48,35,48,71,33,1816
25234,1086,514,0,0,11,7,5,21,572
26836,6986,3644,35,222,118,55,160,90,3342
26292,671,333,12,9,5,0,9,11,338
28366,5564,2837,24,107,20,77,64,44,2727
76950,3883,2123,57,87,88,3,130,24,1760
77334,313,155,0,120,0,0,0,0,158
35226,35542,17597,119,1269,585,88,1362,415,17945
83843,26775,13523,1067,921,268,672,617,369,13252
37642,15327,7202,172,315,133,45,627,214,8125
29569,17587,8368,75,408,139,175,892,376,9219
22711,23,11,0,0,0,0,0,0,12
76541,18198,9351,198,586,126,232,516,100,8847
77018,28235,14352,145,1586,185,101,1242,315,13883
82053,1006,455,0,66,16,0,68,9,551
71358,852,457,0,18,16,0,5,3,395
98859,178,95,0,0,0,0,0,0,83
72473,2515,1399,16,69,23,19,31,36,1116
72634,4338,2230,4,163,108,23,96,113,2108
92127,48721,23490,164,2100,289,55,2059,335,25231
95683,6279,2981,13,182,63,15,131,112,3298
93204,12923,8275,162,851,78,77,283,21,4648
48169,21128,10532,146,462,188,119,475,356,10596
83638,6880,3544,17,80,46,3,100,158,3336
11722,32524,16254,164,1084,207,331,1048,461,16270
85044,41449,19602,145,1466,325,141,1489,492,21847
12160,872,430,9,29,26,0,19,12,442
42754,16309,8231,175,431,152,31,550,220,8078
43065,42782,21438,107,1456,383,150,1468,411,21344
63347,2714,1484,2,70,67,0,67,14,1230
29812,11357,5472,102,240,87,40,318,213,5885
56096,3160,1593,22,67,68,9,73,38,1567
41834,341,175,0,11,0,0,0,9,166
45716,474,240,0,7,9,0,8,1,234
43204,42463,20788,136,1360,508,123,1194,431,21675
46845,22929,11355,42,575,340,86,782,253,11574
64776,3911,2046,32,103,30,41,111,75,1865
2302,32497,15622,167,1216,329,203,1210,453,16875
69301,9836,4859,30,299,74,34,404,174,4977
57348,586,295,5,3,1,4,8,34,291
97753,2377,1207,38,97,66,12,75,18,1170
58566,103,66,2,3,0,0,3,6,37
62858,2790,1494,0,78,47,18,75,54,1296
68789,155,74,0,11,2,1,9,10,81
2476,16814,7629,12,622,121,88,679,405,9185
97384,0,0,0,0,0,0,0,0,0
77705,40251,25394,546,2834,370,234,967,527,14857
97707,6381,3550,38,196,74,15,199,62,2831
91744,87240,43241,516,2649,677,583,2606,1003,43999
38341,2513,1256,15,68,24,42,86,47,1257
94588,36316,17344,77,1263,235,48,1458,416,18972
81652,4946,2507,64,202,42,0,208,54,2439
34475,12882,6611,74,411,134,117,421,134,6271
76106,40014,21086,398,983,170,332,1075,217,18928
85322,626,341,5,50,4,0,13,4,285
33071,39839,19513,148,1531,445,224,1865,485,20326
87068,4885,2445,24,114,69,10,55,76,2440
57651,129,72,7,3,7,0,0,0,57
57755,115,40,0,0,0,0,0,0,75
74106,18075,8251,78,359,102,129,617,251,9824
73654,846,462,0,13,23,0,17,28,384
47224,642,307,0,27,26,9,21,0,335
45066,24836,11910,60,891,205,173,1021,391,12926
40291,37857,18275,158,1125,453,138,1429,510,19582
36271,5952,3010,51,135,84,58,180,114,2942
37363,40041,19996,177,1291,357,176,1476,593,20045
61517,3274,1769,10,125,76,2,64,59,1505
59420,245,116,0,11,4,0,10,0,129
48843,45910,22391,227,1243,514,253,1222,628,23519
60406,25256,12482,221,784,265,111,786,251,12774
44811,12667,6268,92,345,194,81,308,214,6399
41142,76,38,0,0,0,0,0,0,38
4685,449,242,0,5,3,4,20,12,207
5773,2255,1074,3,36,45,36,53,36,1181
16731,2437,1222,17,32,29,17,91,17,1215
32145,5659,2816,49,121,48,54,137,19,2843
27884,1301,669,0,0,28,59,0,16,632
15066,12582,6101,41,428,116,39,357,215,6481
26621,771,429,48,36,9,21,24,0,342
13152,8208,4011,22,170,126,6,236,145,4197
77991,395,221,0,9,0,0,12,0,174
1741,5186,2706,0,69,106,12,73,97,2480
53516,2276,1137,21,51,25,4,46,68,1139
12052,1597,784,0,102,25,0,65,34,813
61919,942,438,0,20,11,2,19,20,504
56531,1967,933,7,90,22,26,78,17,1034
54211,274,118,0,1,3,0,16,6,156
57344,154,74,0,0,0,0,0,0,80
57460,362,169,0,17,0,0,6,4,193
60632,91039,46372,527,3557,709,704,3315,1056,44667
63736,3716,1829,30,111,69,0,77,66,1887
62241,989,527,8,48,10,1,3,29,462
73622,227,154,5,14,3,0,3,0,73
65355,10332,5098,70,120,320,39,182,232,5234
31768,22858,11181,238,935,133,117,960,219,11677
33040,34784,18128,251,1684,433,320,1287,490,16656
78559,12709,6400,64,625,194,0,357,114,6309
46985,1538,773,0,47,17,0,60,15,765
64457,240,149,0,26,4,0,10,7,91
64466,432,202,2,11,19,0,19,4,230
50166,1540,830,0,48,5,10,36,26,710
73056,346,198,0,17,0,0,15,11,148
54175,890,492,0,13,45,0,9,11,398
73556,133,67,0,3,0,0,2,0,66
87321,2112,935,13,63,24,6,53,50,1177
41141,1777,883,0,54,46,0,47,0,894
97406,13,13,0,0,0,0,0,0,0
38754,1303,625,0,25,5,7,29,4,678
81642,0,0,0,0,0,0,0,0,0
89314,299,156,0,30,0,0,9,1,143
40513,11100,5363,45,222,111,43,226,178,5737
32187,2186,1199,0,11,28,0,0,74,987
94541,66056,33388,563,2911,497,457,2649,838,32668
95037,51652,25501,478,1604,451,218,1764,811,26151
45881,1252,596,9,20,2,0,58,4,656
29439,2319,1271,0,116,0,0,192,39,1048
29555,5824,2682,27,186,69,27,262,91,3142
38220,1742,832,0,61,5,14,33,6,910
16145,2721,1318,23,64,40,18,79,39,1403
39645,4982,2553,2,98,73,28,90,77,2429
18821,1311,613,3,22,18,6,43,15,698
43766,1543,803,8,73,5,6,95,38,740
19474,583,232,0,47,21,0,11,0,351
44141,13830,6861,38,292,315,8,273,227,6969
6010,60308,29513,411,2059,656,343,1717,777,30795
46761,12126,5965,33,357,120,45,326,216,6161
22102,24746,11942,45,1034,179,120,904,193,12804
22821,5176,2610,64,133,32,43,168,69,2566
24282,890,433,38,36,1,14,65,0,457
25312,14771,7155,93,314,136,28,470,202,7616
15136,22492,11186,87,609,183,92,661,311,11306
94531,43788,21221,177,1199,454,364,1344,679,22567
96013,4810,2323,22,113,99,20,212,81,2487
91367,45282,21952,190,1679,286,129,1556,545,23330
87417,5703,2658,23,257,50,19,74,62,3045
3307,5488,2454,0,308,126,162,323,133,3034
4406,624,324,0,10,24,5,9,17,300
5077,1179,626,9,41,7,0,26,13,553
60603,1174,573,10,18,8,22,12,8,601
61418,542,249,0,11,7,0,5,17,293
62573,1912,900,13,31,51,4,55,11,1012
72104,23580,12303,97,753,249,284,662,366,11277
86020,2216,1091,22,67,18,25,52,11,1125
59749,1924,907,15,41,41,0,43,58,1017
68866,963,519,9,52,5,2,35,1,444
64743,214,94,0,9,2,4,7,3,120
65051,4813,2587,41,175,39,36,98,129,2226
67031,2607,1285,2,75,24,9,81,59,1322
73103,4924,2624,38,197,52,39,172,40,2300
53805,5148,2846,34,177,63,2,156,80,2302
37325,1709,883,13,94,27,0,16,15,826
38654,52032,24865,181,1448,515,237,1770,655,27167
44682,1030,511,7,42,19,3,35,21,519
45863,1279,629,2,28,6,0,31,28,650
48327,22356,10821,165,665,241,126,701,336,11535
62451,2041,867,19,26,39,23,60,50,1174
56336,1474,731,0,52,25,13,29,21,743
49722,308,179,0,27,13,0,0,17,129
50115,2723,1278,5,43,31,16,90,39,1445
5051,1565,674,1,32,32,6,29,18,891
1366,1269,569,10,24,14,31,37,22,700
13607,1247,656,0,27,22,0,24,19,591
20759,5011,2261,21,85,73,0,89,103,2750
12521,1431,757,0,104,27,0,25,37,674
83126,358,177,0,0,0,0,0,0,181
83813,1312,591,0,73,34,0,31,14,721
84630,454,220,21,28,8,0,41,4,234
66088,2509,1256,0,56,39,8,82,24,1253
67468,294,154,9,9,1,0,3,6,140
69132,143,62,0,13,0,0,0,2,81
86401,25709,13721,186,968,319,91,825,371,11988
87525,95,47,0,4,0,0,3,0,48
78623,921,354,0,34,0,0,9,73,567
79411,7564,4179,319,259,37,80,268,47,3385
95569,295,178,1,18,0,0,0,8,117
93558,40,31,0,0,0,0,0,0,9
41254,316,154,0,0,0,0,0,0,162
47670,12066,6119,64,514,144,204,307,169,5947
44824,3944,2041,138,77,33,17,57,49,1903
51333,531,280,0,13,14,12,11,30,251
33921,861,435,0,39,15,1,22,8,426
39630,785,282,0,44,3,7,32,15,503
14716,2746,1598,9,79,12,8,80,47,1148
15222,4900,2393,80,141,51,60,98,108,2507
16054,363,191,0,3,7,1,6,8,172
16835,204,103,0,2,1,0,2,0,101
30306,24112,12331,74,972,232,162,976,149,11781
24086,148,65,0,0,0,0,0,18,83
8360,42197,19826,158,1563,276,425,1145,602,22371
29672,12153,6222,177,215,210,143,203,181,5931
12464,653,253,0,10,27,0,0,34,400
49061,1641,897,6,25,45,6,33,40,744
35124,24438,11694,148,692,169,134,892,441,12744
41097,7194,3981,14,396,163,14,176,62,3213
42256,4388,2139,17,91,77,14,88,71,2249
43135,3914,1969,48,68,48,31,126,43,1945
43452,13674,6416,0,472,217,143,447,289,7258
17723,30,20,0,0,0,0,0,2,10
26624,2568,1238,32,48,27,0,35,164,1330
45361,328,178,0,6,4,9,2,4,150
46818,20746,10653,49,703,300,0,840,234,10093
32778,21406,10160,139,494,368,104,403,354,11246
33496,21825,9724,112,384,243,125,328,342,12101
62044,2094,960,2,64,34,0,68,16,1134
70633,8233,3662,119,292,88,21,295,116,4571
71341,3714,1861,11,112,4,2,95,46,1853
71744,2744,1393,16,89,11,0,117,49,1351
72037,35,21,0,0,0,0,0,0,14
77511,46869,23931,294,1619,601,376,1601,527,22938
78644,18274,8933,58,612,202,55,818,281,9341
65449,209,90,0,28,0,0,30,0,119
56220,2710,1383,0,52,43,13,56,31,1327
57563,265,120,0,0,0,0,8,0,145
62915,425,233,0,15,0,0,0,2,192
73438,3480,1592,12,108,72,18,121,37,1888
82243,148,62,0,15,0,0,16,0,86
82939,1519,834,19,57,22,0,25,9,685
75503,25710,12486,171,859,277,75,1034,336,13224
76043,7499,3492,57,152,97,149,201,97,4007
84004,10423,4954,53,217,109,57,193,141,5469
86039,1273,625,7,42,1,7,48,17,648
55042,9618,4723,47,247,154,14,322,132,4895
55925,1126,602,3,31,13,3,64,29,524
14550,1589,765,0,47,13,0,38,39,824
14881,324,155,0,0,0,0,0,0,169
16647,720,361,0,21,8,0,11,3,359
16938,668,322,3,21,23,0,21,12,346
33707,25143,11800,94,581,498,109,579,555,13343
30054,11904,5907,72,236,180,202,261,194,5997
27305,1812,754,14,0,42,3,64,2,1058
13071,895,501,4,25,11,4,18,9,394
10522,11027,5648,87,286,141,68,278,253,5379
11235,78128,37432,366,2348,1148,229,2642,968,40696
2351,16330,7732,99,611,129,26,473,356,8598
86043,2838,1250,24,40,25,42,109,36,1588
48426,958,514,10,28,16,18,15,31,444
93428,5981,2802,11,94,149,13,104,166,3179
94507,15646,8096,58,159,158,18,336,317,7550
46542,4083,2017,111,196,32,19,202,61,2066
97203,34365,16971,373,1779,139,452,1718,198,17394
5652,745,371,0,29,6,7,17,8,374
50848,333,168,2,4,8,11,5,12,165
87021,3582,1902,27,178,0,15,98,71,1680
87064,84,48,0,0,0,0,0,0,36
54212,1166,538,0,16,23,4,17,22,628
40741,23746,11435,120,822,369,195,829,304,12311
92883,35072,17454,227,1096,400,167,1247,328,17618
58231,348,194,5,6,4,0,4,0,154
98241,1921,968,19,20,45,0,67,33,953
72742,660,360,0,11,45,0,0,17,300
49942,240,109,0,0,0,0,0,19,131
95602,18063,8690,39,394,394,69,361,391,9373
50243,185,100,0,7,0,0,5,2,85
95983,403,195,0,32,8,0,0,0,208
43972,121,46,0,0,0,0,0,8,75
45662,30289,14347,181,899,270,268,1064,539,15942
616,10765,5102,59,375,257,116,299,219,5663
35984,1573,761,0,11,30,2,86,19,812
38371,1006,498,18,36,12,18,20,5,508
42503,23669,11556,243,773,142,194,735,341,12113
40734,4056,1985,19,138,0,0,103,65,2071
58781,805,437,4,43,8,6,11,7,368
54135,3298,1629,28,59,40,18,42,50,1669
45404,10809,5787,148,278,53,41,119,107,5022
50658,2301,1129,14,83,35,32,51,37,1172
62221,29949,13928,177,1120,230,224,1016,515,16021
51245,1296,655,16,23,13,19,16,11,641
76442,7813,4012,0,111,135,4,223,169,3801
62380,488,183,1,37,0,0,4,5,305
80204,34098,17440,233,1500,185,168,1455,351,16658
64421,1005,497,16,37,51,0,48,21,508
92868,27693,15184,248,1131,219,142,858,254,12509
98603,1204,580,0,0,39,0,38,21,624
66869,739,389,0,34,12,23,16,5,350
32043,24952,12345,187,527,304,274,681,260,12607
28625,39518,18890,188,1321,547,326,1502,470,20628
29921,197,94,0,5,0,0,5,7,103
8525,4788,2447,0,110,59,11,52,120,2341
40215,20692,9974,129,524,156,193,723,243,10718
71253,200,91,0,0,5,3,7,1,109
19933,10536,5375,39,230,140,38,358,109,5161
24460,1457,787,0,58,34,0,78,0,670
37189,3801,1630,0,202,44,0,221,63,2171
18333,573,235,32,49,0,39,0,66,338
5767,1105,562,0,12,21,7,1,21,543
18657,12056,6057,46,275,201,52,272,209,5999
15952,1747,876,0,118,0,0,85,0,871
28244,0,0,0,0,0,0,0,0,0
1826,31101,15339,147,1049,245,169,1119,529,15762
95423,3757,2055,1,138,109,2,94,39,1702
96125,184,82,0,0,0,0,0,0,102
18350,1472,660,0,72,5,0,53,0,812
98320,1128,573,0,9,15,0,16,33,555
80902,13208,7281,507,424,0,154,437,6,5927
83316,9616,4932,39,330,158,40,294,164,4684
89426,144,82,0,0,0,0,0,0,62
76462,3372,1961,0,118,18,20,54,32,1411
55949,1727,883,3,70,32,1,38,41,844
11725,29578,14555,104,651,249,206,575,457,15023
66528,697,381,0,31,1,2,49,8,316
1267,7955,3608,209,149,100,223,190,75,4347
1349,1292,660,0,47,19,0,57,0,632
4091,907,503,4,25,4,3,10,27,404
61567,540,276,2,8,7,0,24,11,264
4294,4005,1950,0,52,118,0,16,127,2055
62801,21444,11258,264,704,240,106,423,291,10186
63640,29260,16140,167,1115,456,87,687,313,13120
15213,28047,13328,1567,301,149,1780,190,167,14719
6850,18156,8956,33,641,218,115,774,200,9200
48317,28730,14000,113,911,331,93,1028,258,14730
3051,25328,12181,98,870,373,172,994,279,13147
5260,525,296,0,64,0,0,20,0,229
8096,35686,16668,194,923,417,263,1353,663,19018
23068,176,97,0,0,0,0,0,0,79
78758,47470,24404,281,2582,219,266,2018,651,23066
19602,17055,8376,212,422,92,125,649,131,8679
12198,7772,3993,37,221,100,74,193,123,3779
12839,13265,6784,49,589,148,37,488,91,6481
82639,847,468,2,37,10,2,11,0,379
93513,1692,856,13,52,11,0,36,55,836
27263,22028,10411,78,637,205,121,741,330,11617
10021,46215,21010,45,2225,400,18,2317,806,25205
52212,217,121,2,0,18,0,0,0,96
74731,1438,793,11,27,0,0,49,21,645
37754,5363,2873,89,109,48,0,125,103,2490
85208,37967,19086,250,1220,376,122,1191,513,18881
38774,2193,1055,36,71,52,0,24,4,1138
47223,1195,687,0,20,43,0,23,23,508
56057,3958,2082,34,177,80,7,160,31,1876
44662,10020,4973,133,281,182,71,239,248,5047
33890,4872,2547,37,122,37,35,54,40,2325
35125,10941,5254,34,337,117,0,284,138,5687
49618,719,397,3,20,30,9,17,21,322
68463,1251,648,0,35,35,0,30,25,603
48401,1510,801,2,14,20,16,41,35,709
68957,606,324,10,19,7,7,16,17,282
41622,155,68,0,0,0,0,37,15,87
42726,5016,2496,0,215,58,39,70,55,2520
35218,7178,3535,53,121,79,60,165,100,3643
2808,2565,1328,15,71,0,22,103,22,1237
4219,1640,834,0,45,16,4,59,28,806
92391,2479,1391,0,11,42,0,93,66,1088
90036,37988,17613,190,1547,218,295,2119,427,20375
91905,1478,789,14,25,71,70,22,5,689
77316,24199,12095,179,750,316,120,849,387,12104
73627,465,252,0,5,0,0,4,0,213
70501,31097,14833,152,835,410,376,699,372,16264
70516,503,278,0,2,0,43,4,0,225
23604,6831,5034,384,170,0,14,128,5,1797
24604,237,99,0,15,0,0,0,0,138
4915,8981,4182,74,299,186,63,283,202,4799
26586,218,71,0,0,0,0,0,0,147
28124,6192,3106,34,168,68,17,184,101,3086
23085,678,414,0,125,0,0,96,0,264
3848,6190,3184,0,75,50,10,115,132,3006
20832,26448,12971,131,845,259,202,887,230,13477
27874,3766,1716,46,95,18,18,90,92,2050
64720,3574,1661,0,99,17,7,133,12,1913
19380,51097,25126,182,1407,582,466,1182,766,25971
19567,5517,2515,56,138,42,40,137,110,3002
5759,1692,883,0,25,22,0,46,44,809
12933,52,27,0,0,0,0,0,0,25
37336,4381,2005,31,188,70,95,141,65,2376
12569,10268,4766,85,295,48,10,332,149,5502
38079,5264,3603,72,487,58,13,70,61,1661
14302,109,10,0,0,0,0,0,0,99
39039,1823,857,0,36,51,0,46,11,966
4419,2789,1389,23,71,23,32,70,40,1400
10303,25947,12810,157,858,116,294,823,270,13137
4469,2578,1431,124,7,0,59,0,0,1147
12594,4357,2226,14,138,78,0,160,87,2131
35579,3513,1655,24,94,20,5,87,26,1858
13120,2250,1066,55,50,9,5,68,6,1184
4989,4132,2134,20,125,102,0,243,66,1998
44085,3448,2016,5,156,64,35,71,56,1432
44626,3015,1496,4,91,29,9,64,83,1519
28578,6858,3745,43,162,58,116,148,114,3113
72543,12076,5965,164,213,198,99,336,132,6111
75034,102646,50420,576,3561,617,467,4767,852,52226
41631,1181,551,0,27,0,0,48,0,630
98362,23740,11671,204,537,356,129,534,465,12069
83212,110,59,0,2,4,2,7,6,51
65280,292,126,0,0,1,0,8,0,166
38732,17644,8472,77,511,181,265,472,170,9172
47872,8770,3814,46,186,48,39,329,162,4956
50049,6292,3124,25,162,29,30,170,152,3168
48463,4483,2182,40,141,85,48,154,57,2301
51063,1171,561,4,68,5,11,67,19,610
57548,1535,759,19,78,11,18,76,10,776
52362,952,453,0,17,9,0,47,32,499
50266,28917,13912,84,1213,265,243,1254,257,15005
53529,2177,1204,6,53,34,6,47,34,973
56241,3856,1951,21,67,27,0,127,50,1905
5101,4401,2025,4,128,39,7,110,76,2376
66418,466,281,2,7,5,1,2,9,185
67151,573,286,4,23,1,29,29,3,287
49279,823,377,0,7,18,3,26,26,446
33514,2350,1070,0,28,10,23,130,26,1280
26717,1017,496,1,27,9,12,37,2,521
97448,12889,6449,102,329,192,91,351,302,6440
80444,1232,692,9,48,13,0,36,7,540
33810,50302,25010,272,1661,632,185,1937,699,25292
81130,793,392,1,29,12,8,11,23,401
63010,36008,17855,321,1359,308,291,1212,658,18153
36581,136,78,0,0,23,0,0,0,58
78944,537,286,0,12,6,0,0,20,251
79924,59729,28737,620,1371,551,335,1728,835,30992
76930,96,39,0,0,0,0,0,17,57
87402,9854,5247,67,518,154,12,331,177,4607
64639,224,100,0,13,10,0,1,4,124
68128,19099,9558,76,664,295,56,920,184,9541
92399,54163,26413,506,1329,565,318,1753,1325,27750
49895,717,316,0,21,39,0,41,17,401
54626,1476,793,11,18,35,6,33,17,683
72348,2513,1252,22,50,32,17,7,78,1261
50453,527,264,2,11,0,5,12,20,263
56101,5886,2990,63,203,81,0,184,61,2896
35404,22783,11952,724,514,172,394,837,190,10831
58004,253,139,0,16,0,0,8,2,114
59927,410,210,1,0,0,7,22,3,200
33781,25059,12151,221,776,255,147,761,361,12908
24569,1035,617,0,22,0,0,33,14,418
51445,2781,1351,29,43,32,0,62,59,1430
52065,1020,499,17,9,2,2,13,15,521
62684,5861,2801,49,86,84,0,209,89,3060
67863,268,133,0,13,5,0,0,0,135
68314,547,299,0,39,2,0,4,1,248
13084,3734,1955,17,132,81,0,94,38,1779
56024,3283,1622,7,131,16,29,140,29,1661
70514,2387,1146,25,52,21,0,35,11,1241
27937,4546,2378,0,57,74,71,96,28,2168
81089,4424,2234,0,166,54,0,52,62,2190
24614,7458,3442,126,284,72,84,190,187,4016
83851,1938,1021,1,34,21,10,85,30,917
25601,5238,2493,43,176,38,28,131,81,2745
95957,888,460,0,14,13,0,9,18,428
25841,442,177,0,0,0,0,22,0,265
99513,0,0,0,0,0,0,0,0,0
93225,4816,2437,12,137,10,17,179,8,2379
18914,21156,10238,79,557,139,90,707,149,10918
28736,603,284,0,9,21,0,16,22,319
33193,51378,25117,435,1856,448,553,1617,680,26261
35111,16893,8530,171,761,230,101,875,196,8363
40065,30613,14914,212,1126,372,88,931,402,15699
45685,1120,578,13,42,1,42,49,2,542
71063,646,332,0,11,20,0,0,0,314
97355,29701,14878,78,726,313,256,743,417,14823
65068,729,406,10,21,7,0,25,8,323
65617,1272,674,0,49,14,36,15,0,598
66842,463,248,0,6,4,8,10,12,215
67567,469,243,0,10,12,0,32,17,226
90094,9368,4366,0,784,28,46,758,133,5002
56540,2150,1051,7,62,27,0,91,11,1099
54659,1341,725,9,53,19,1,18,15,616
57219,472,267,0,5,19,0,5,2,205
57632,634,318,0,3,7,0,17,17,316
63862,1629,732,11,55,19,0,98,12,897
45432,14818,7369,37,475,115,126,547,220,7449
92683,91376,45146,612,2341,844,645,2774,1028,46230
95721,15,15,0,0,0,0,0,0,0
50862,206,138,3,7,0,0,0,0,68
53182,9719,4440,73,323,92,42,372,71,5279
677,14311,6875,72,469,199,166,615,196,7436
50010,33965,17647,962,1234,292,472,946,270,16318
54126,3738,1973,25,159,37,29,122,65,1765
82322,197,99,0,0,0,4,27,1,98
83431,786,408,11,0,14,5,41,7,378
62532,110,32,0,0,0,0,13,17,78
43061,4278,2254,10,240,84,23,93,64,2024
67436,746,381,4,22,4,0,30,0,365
38052,4075,2044,36,49,39,15,119,85,2031
47393,1730,814,47,103,20,13,118,28,916
88022,1348,644,0,39,28,0,24,17,704
19810,25707,12303,56,764,250,68,760,328,13404
54754,1785,982,5,53,21,12,36,34,803
5075,1032,476,10,40,18,4,11,30,556
15422,189,82,0,0,0,0,21,8,107
57738,117,72,0,6,0,0,0,2,45
8876,22059,10956,70,774,200,224,734,358,11103
73460,4609,2211,27,117,54,36,200,72,2398
17272,400,231,0,18,0,0,0,0,169
71825,727,374,0,27,23,0,11,15,353
49727,7559,3672,59,240,91,60,150,133,3887
37879,10790,5328,134,389,120,17,233,105,5462
62916,993,518,2,12,3,0,12,24,475
39560,17334,8586,68,512,166,152,529,263,8748
56291,411,210,3,5,2,3,11,10,201
46366,5690,2726,67,84,94,3,197,47,2964
59917,4811,2326,22,166,54,0,150,146,2485
54530,823,446,6,23,24,6,13,8,377
53013,3292,1623,13,86,77,57,137,40,1669
37365,1039,516,0,12,16,0,10,5,523
38390,1144,505,8,39,13,6,38,8,639
72469,965,456,0,1,8,9,25,2,509
74750,318,148,0,13,4,2,9,12,170
44814,2876,1452,19,25,2,53,45,50,1424
46130,2440,1436,0,8,119,0,59,15,1004
46553,3212,1659,0,165,32,10,120,8,1553
11933,7302,3524,59,332,81,55,90,32,3778
48872,7033,3501,21,246,91,28,254,89,3532
6380,2888,1512,0,89,64,0,95,14,1376
15050,2641,1327,10,67,19,10,79,47,1314
58577,1895,1042,17,141,21,8,33,31,853
6870,7506,3718,32,182,45,0,234,63,3788
60540,45112,21977,321,1304,349,384,1421,552,23135
25083,794,385,0,20,40,0,20,0,409
83858,14925,7346,52,559,130,37,405,78,7579
75838,577,270,0,35,0,0,32,5,307
22305,17783,8770,45,1084,112,167,1130,136,9013
22641,479,237,0,0,0,22,0,0,242
8314,3020,2724,9,433,20,0,8,9,296
91730,71422,34752,698,2807,669,504,2453,753,36670
11428,18929,9208,72,555,182,75,582,315,9721
79536,4879,2354,19,187,35,1,154,126,2525
58262,89,46,0,3,1,0,4,8,43
95746,23492,11718,111,305,258,72,831,444,11774
33620,5402,2136,121,0,0,146,0,0,3266
97348,1442,671,15,32,10,3,20,31,771
41143,14234,7244,102,508,172,150,434,174,6990
47551,923,392,0,31,10,7,34,14,531
49631,6049,3101,45,141,119,16,104,110,2948
12762,709,363,0,18,0,0,52,0,346
70047,12326,5840,20,368,237,72,444,269,6486
38635,16364,8065,107,552,147,98,527,134,8299
56168,871,443,5,20,13,9,13,22,428
57107,10102,5190,90,284,93,110,340,154,4912
31523,13650,6963,45,615,146,36,466,176,6687
23898,2104,909,8,45,25,14,28,28,1195
6762,7656,3615,83,82,108,45,227,113,4041
15434,258,137,0,0,0,0,5,1,121
92614,26676,13374,197,1000,233,226,1181,375,13302
8069,12558,6091,110,544,76,19,403,154,6467
94024,23961,11305,28,500,294,47,599,325,12656
81144,7128,3600,0,147,117,48,189,105,3528
11514,4597,2374,36,183,48,51,90,113,2223
98235,98,16,0,0,0,0,0,0,82
6473,24278,11675,149,657,324,128,592,426,12603
94122,62131,30424,144,2568,929,208,2705,737,31707
28352,25760,12704,214,868,308,232,861,302,13056
34266,32246,18640,199,1273,418,128,839,353,13606
36025,6756,4712,108,527,20,12,139,28,2044
65747,3785,1924,0,30,160,0,51,71,1861
36832,24509,13190,1218,514,90,814,577,76,11319
78880,1812,974,16,55,49,43,60,15,838
13661,1368,658,0,46,8,8,36,26,710
95528,1493,716,0,85,9,5,69,22,777
3901,7620,3725,18,246,38,20,165,160,3895
97494,36,15,0,0,0,0,0,0,21
8691,16033,7554,14,428,67,29,505,140,8479
92655,8415,3969,162,154,68,26,281,118,4446
10504,8254,4183,0,134,133,0,169,179,4071
77303,20163,10371,305,662,138,87,535,96,9792
29161,11261,5246,107,360,116,53,333,268,6015
12553,26465,13525,101,794,293,243,713,239,12940
48737,1216,639,10,27,29,0,41,34,577
48827,15953,7641,62,395,263,119,414,222,8312
53122,6172,2834,24,141,89,25,100,126,3338
60165,4923,2576,55,243,12,61,164,53,2347
56440,1482,764,11,36,17,2,32,25,718
61570,1787,940,0,55,22,10,59,46,847
45690,15599,7526,124,516,167,244,505,206,8073
35769,9968,4633,24,350,132,56,387,232,5335
78353,274,148,0,12,46,0,0,5,126
49913,6739,3257,44,119,136,14,145,81,3482
98244,2783,1357,52,110,23,41,47,37,1426
99362,41456,21085,372,1297,443,371,1035,476,20371
43786,35,21,4,0,0,0,0,0,14
46218,27851,13555,350,980,171,84,1021,410,14296
38257,4570,2183,32,128,17,14,218,52,2387
49841,7242,3487,13,262,58,34,310,146,3755
39459,3672,1822,1,46,39,108,49,28,1850
34470,19856,9957,89,580,201,86,519,227,9899
46922,29,18,0,0,0,0,0,0,11
47462,4367,2363,15,89,38,0,84,73,2004
98908,36848,17866,93,853,663,187,1332,499,18982
35203,2996,1754,11,195,8,0,74,56,1242
82084,7,7,0,7,0,0,0,0,0
33122,109,59,0,0,0,0,12,0,50
18091,5389,2688,0,146,26,0,157,22,2701
89318,1271,719,0,82,17,0,15,0,552
70815,29672,14247,153,585,270,265,1014,300,15425
71859,546,237,0,16,9,0,13,26,309
73453,503,235,0,6,30,0,9,3,268
12117,3094,1455,15,48,27,0,149,87,1639
53947,152,73,0,10,2,1,0,6,79
2861,25044,12447,85,866,271,53,781,400,12597
44875,13437,6520,40,338,158,106,324,220,6917
15865,1224,609,3,42,8,5,16,15,615
50801,9417,4570,84,324,154,82,360,149,4847
53944,2070,1156,3,70,49,7,65,28,914
35654,8006,3996,13,161,122,27,87,100,4010
59322,39,22,0,2,4,0,2,2,17
48065,11178,5729,29,504,112,11,303,250,5449
49340,2827,1410,9,78,48,20,64,54,1417
41222,2395,1153,0,41,34,0,75,54,1242
28515,2584,1598,25,138,44,18,51,46,986
28721,10152,4733,38,201,93,57,410,170,5419
21770,5453,2831,42,115,66,13,160,121,2622
13691,2878,1400,7,87,37,6,92,51,1478
14427,2044,992,0,109,20,10,97,54,1052
14545,180,71,0,0,0,0,0,3,109
15472,182,32,0,0,0,0,0,0,150
16059,8100,4088,22,194,108,23,225,77,4012
32828,65665,30928,507,2565,371,1039,2490,712,34737
25002,0,0,0,0,0,0,0,0,0
25839,578,253,0,0,0,0,41,0,325
10027,64548,29804,667,1899,357,1066,2648,472,34744
10464,4434,2162,15,162,95,5,65,108,2272
52213,4060,1907,0,135,48,49,87,32,2153
53051,36806,17440,235,1333,439,186,1299,613,19366
53178,2738,1333,24,83,62,6,92,28,1405
54947,2476,1269,20,52,53,11,43,28,1207
55970,994,486,0,39,12,6,29,14,508
56037,1594,776,4,72,22,11,40,23,818
58785,1169,561,0,32,24,2,20,34,608
59013,157,59,0,9,0,0,12,0,98
60053,23256,11532,87,726,268,167,759,290,11724
60430,20227,9684,87,757,158,16,688,370,10543
69121,340,169,0,5,2,1,5,4,171
75605,30011,14145,111,752,238,133,1079,315,15866
75701,35549,15766,420,778,179,275,1040,391,19783
76845,254,126,0,9,0,0,0,3,128
62848,716,335,0,31,18,0,11,19,381
64126,6148,2905,77,218,0,91,308,37,3243
56149,1128,565,2,39,15,7,26,31,563
85210,40919,20620,391,1586,144,412,1201,331,20299
87326,1890,904,14,37,12,13,62,54,986
87942,1012,452,0,40,0,0,9,33,560
96041,2797,1284,0,81,66,41,59,50,1513
96857,2815,2590,424,11,0,67,0,0,225
80918,49232,24682,604,1519,342,455,1459,667,24550
90079,0,0,0,0,0,0,0,0,0
90670,16578,7926,108,488,219,151,514,122,8652
90742,699,367,0,26,28,15,14,28,332
91436,15070,6974,8,468,87,50,456,161,8096
91606,44476,22219,329,1934,242,309,1623,449,22257
93518,975,474,0,11,29,0,20,9,501
33486,24146,11547,157,647,419,271,785,369,12599
44903,23604,11809,104,677,261,125,729,455,11795
17321,2348,1225,26,83,20,7,87,47,1123
32648,570,259,0,35,0,0,33,0,311
33125,61492,30121,550,2150,626,357,2221,579,31371
21087,5407,2683,51,201,127,44,157,77,2724
21703,36265,17577,162,1367,295,333,1538,263,18688
22204,55386,28300,202,2626,369,114,2787,539,27086
29845,983,462,13,22,11,16,54,13,521
29928,16366,7751,47,267,304,25,272,363,8615
30078,35824,16954,308,1097,451,193,1355,519,18870
35501,9644,4804,94,393,96,36,337,152,4840
3045,13678,6723,96,408,222,83,403,220,6955
5081,536,263,7,7,4,7,11,6,273
6029,15988,8326,164,648,214,62,426,152,7662
1070,604,320,7,10,14,0,8,8,284
47371,12336,6062,102,340,145,78,192,186,6274
47579,2577,1275,15,38,30,13,67,36,1302
47964,111,54,0,1,1,0,6,0,57
48890,2129,1086,10,71,26,9,71,35,1043
43529,328,178,7,16,0,13,20,0,150
44026,10989,5420,18,218,152,39,266,245,5569
45239,29809,14072,213,771,285,239,1119,549,15737
45882,2875,1356,3,65,36,13,46,68,1519
37932,18069,8765,107,518,135,45,657,187,9304
38068,10741,5355,90,406,164,34,378,150,5386
38313,3110,1518,0,52,43,0,65,42,1592
49632,1095,586,8,19,20,3,11,18,509
50668,1174,622,3,32,1,4,14,7,552
50849,2423,1184,19,28,13,20,63,46,1239
35121,15426,7298,125,555,117,52,421,278,8128
92091,1343,652,0,0,50,0,0,0,691
92211,25339,11819,64,442,390,91,380,585,13520
92551,33578,15607,244,1013,200,409,1182,331,17971
98126,24329,11623,104,1143,181,94,1123,324,12706
83712,9519,4693,80,448,150,67,281,167,4826
84663,33466,16691,151,1069,147,199,1159,302,16775
84724,1208,617,0,14,41,9,39,9,591
38847,3388,1838,3,150,43,37,38,47,1550
56230,820,414,4,29,15,3,29,10,406
57043,1339,660,0,45,56,0,28,27,679
58483,287,148,2,11,5,0,8,3,139
53506,1106,558,6,30,14,4,28,20,548
54514,1768,886,3,41,60,0,31,51,882
55033,30054,15235,124,1215,233,124,827,514,14819
55056,13895,6630,115,396,117,38,385,126,7265
49426,36724,18756,291,1247,266,212,1181,424,17968
51439,1013,521,6,27,10,0,52,10,492
41224,5840,3534,33,329,71,22,166,46,2306
42361,430,191,0,10,16,0,0,7,239
43004,26139,12433,28,1081,144,63,1182,381,13706
59935,3529,1653,0,66,118,0,29,46,1876
63050,15940,8043,102,581,185,106,432,246,7897
47971,1961,977,34,25,21,9,83,0,984
31831,3556,1682,62,75,75,36,127,51,1874
21640,1440,768,13,52,30,4,49,3,672
23976,53,22,0,0,0,0,6,0,31
14571,1313,714,0,48,18,0,38,36,599
14854,13,0,0,0,0,0,0,0,13
24517,5007,2301,0,109,57,19,117,128,2706
24656,2812,1494,0,94,60,5,61,31,1318
25936,48,45,0,0,0,0,0,1,3
17507,30,14,0,0,0,0,0,0,16
28742,2660,1334,21,14,58,0,51,35,1326
95389,1392,882,19,136,39,5,21,0,510
96071,49,25,0,0,0,0,0,0,24
98392,3071,1461,23,107,58,17,149,61,1610
15540,236,119,0,8,3,0,0,11,117
19375,23,7,0,0,0,0,0,0,16
5850,306,132,0,0,0,0,0,0,174
7850,5704,2864,62,129,55,53,107,58,2840
8555,802,411,5,33,29,0,43,17,391
10598,29492,14370,128,686,292,166,1061,529,15122
11956,212,105,0,8,0,0,6,6,107
13078,10607,5296,24,389,123,26,349,265,5311
1803,27059,12910,117,826,188,123,708,215,14149
70006,16344,7883,30,539,122,110,575,203,8461
70637,573,306,0,0,0,0,0,0,267
50009,19559,9526,69,574,199,112,686,310,10033
50264,460,249,0,8,4,0,6,6,211
82210,408,200,0,0,17,0,6,3,208
83113,2360,1328,5,52,62,12,44,14,1032
87111,58203,27700,309,1901,877,272,1614,762,30503
95351,50079,24743,606,1566,345,491,1678,308,25336
96132,93,44,0,1,0,0,11,0,49
96161,18333,9461,109,691,230,93,766,226,8872
74401,15972,7590,150,391,153,53,536,241,8382
68601,28517,14471,129,708,238,185,943,597,14046
68923,90,38,0,0,5,3,1,4,52
38740,384,208,0,24,3,0,8,19,176
38772,61,12,0,0,0,0,15,0,49
64733,1279,606,16,22,16,5,24,11,673
68034,699,403,0,20,25,5,26,12,296
74935,200,110,2,7,5,0,11,4,90
75426,4625,2285,55,201,31,25,89,41,2340
76655,8652,4336,96,198,159,26,207,133,4316
77045,37279,17581,361,1120,303,222,1009,391,19698
77830,2901,1444,8,107,41,37,41,55,1457
77994,451,216,0,7,0,5,21,1,235
59540,283,158,0,5,10,0,0,4,125
61451,331,185,0,8,4,0,16,0,146
61735,454,218,0,23,12,0,34,12,236
57110,17125,8422,65,534,159,84,556,201,8703
58484,32,16,0,0,0,0,0,0,16
58782,476,268,0,9,8,0,12,14,208
58789,301,150,0,15,3,0,8,4,151
59059,171,89,0,5,36,0,2,2,82
79040,2007,1115,73,77,0,10,68,5,892
73853,657,357,0,27,8,12,23,7,300
23130,336,241,0,0,20,0,20,0,95
24230,8815,4590,57,340,112,37,294,135,4225
13682,885,457,0,24,7,3,28,12,428
14210,14723,7426,116,389,87,52,323,208,7297
16212,344,184,4,15,1,6,5,10,160
17246,175,93,0,0,0,0,0,0,82
32442,3132,1555,23,63,23,0,59,30,1577
21082,611,304,0,27,18,0,0,9,307
23066,133,89,0,0,21,0,0,0,44
7924,7591,4041,0,135,98,0,359,67,3550
10553,10429,4506,99,266,105,52,455,157,5923
10805,19215,9039,154,626,234,143,645,213,10176
11565,8696,4148,74,281,168,19,215,227,4548
36612,4926,2334,94,78,69,92,115,75,2592
37135,12380,6126,55,501,132,103,551,150,6254
38368,2032,786,0,42,0,19,76,63,1246
10517,420,213,0,17,10,0,0,6,207
17522,33978,16798,195,957,339,202,892,633,17180
2744,11036,5273,81,358,54,34,370,141,5763
4342,1891,931,5,22,20,9,47,52,960
72082,2010,916,13,78,9,9,85,46,1094
74074,32812,16645,1236,761,247,1048,887,385,16167
74477,0,0,0,0,0,0,0,0,0
41616,581,291,0,11,0,16,5,7,290
62681,5552,2975,0,220,97,0,140,53,2577
55104,45535,22150,542,1506,358,754,1481,439,23385
55733,4837,2405,26,128,28,0,160,66,2432
44807,2120,1118,12,57,36,0,71,58,1002
47334,3267,1660,0,120,58,21,103,39,1607
21074,14872,7266,135,344,103,35,410,100,7606
50321,9134,4216,33,255,144,16,277,141,4918
80103,2749,1401,7,74,35,0,53,60,1348
85620,639,228,0,3,4,0,7,32,411
78362,10184,5351,67,343,73,37,365,63,4833
79313,1566,853,4,30,8,17,50,11,713
60933,312,160,4,8,8,4,5,2,152
61443,13663,6545,84,463,168,84,337,206,7118
61772,238,120,0,20,0,0,0,0,118
92071,57511,27524,563,2163,530,295,2100,979,29987
15209,12158,6445,66,287,116,0,300,206,5713
15376,1625,805,14,19,35,34,45,24,820
16423,4277,1995,15,147,32,63,147,131,2282
19904,35718,16948,293,807,327,349,915,401,18770
22623,817,402,0,40,10,0,60,0,415
2894,674,259,0,0,0,0,0,0,415
5456,1190,661,41,49,13,0,46,26,529
7657,11248,5691,81,297,129,99,476,232,5557
12878,621,322,0,20,10,0,9,24,299
8056,4755,2457,15,136,0,0,320,88,2298
8759,32803,13458,94,262,624,28,418,547,19345
17801,15979,8096,86,385,198,69,411,240,7883
37650,11691,5652,139,302,217,70,370,177,6039
39663,2989,1481,16,60,23,25,137,68,1508
39664,2385,1198,0,131,42,0,50,34,1187
32827,9421,4524,68,415,55,31,391,114,4897
45710,5222,2549,46,152,119,45,204,140,2673
46732,3660,1790,14,179,3,61,139,48,1870
47304,31899,15811,793,892,485,669,687,388,16088
35150,17448,8057,119,385,134,163,480,349,9391
36925,3520,1680,83,93,41,37,55,78,1840
26412,648,340,0,48,20,0,15,10,308
48218,7536,3715,81,191,69,54,206,87,3821
48240,17395,8298,126,729,205,13,555,329,9097
48850,4507,2288,13,151,37,23,140,53,2219
95817,13461,5972,72,658,117,77,450,159,7489
95833,41209,20298,159,1424,257,228,1463,526,20911
81041,860,419,13,17,15,4,17,6,441
83805,8075,3975,6,216,214,27,219,147,4100
76268,273,139,0,11,0,0,20,0,134
78418,30629,15519,209,1201,501,47,1094,559,15110
78609,2044,1028,0,27,32,70,41,33,1016
66843,171,77,0,0,15,0,0,0,94
69142,83,38,0,5,0,0,0,4,45
57323,220,105,0,7,5,0,4,1,115
28277,71605,33421,277,2377,553,111,3138,971,38184
47954,2380,1146,37,59,65,4,41,32,1234
48873,1405,710,0,98,3,6,51,26,695
38749,29,19,0,0,0,0,6,0,10
16639,1528,807,10,16,20,12,17,27,721
16874,1388,679,6,44,30,8,54,27,709
18046,53,0,0,0,0,0,0,0,53
8073,203,89,0,0,12,0,0,0,114
12043,8171,4011,84,158,63,165,125,79,4160
13320,2102,988,5,56,11,15,60,33,1114
23974,5418,3081,88,335,97,16,144,37,2337
14808,612,364,0,20,20,0,10,15,248
1521,2539,1382,30,36,5,20,44,21,1157
24628,367,215,0,0,0,0,5,0,152
25320,6976,3473,4,225,70,100,167,128,3503
76134,26484,12002,146,449,215,166,969,258,14482
83671,5,5,0,0,0,0,0,0,0
85653,17978,9152,104,787,189,128,620,221,8826
77331,7699,3927,0,394,82,24,249,237,3772
65647,2112,1038,7,44,27,0,50,57,1074
65766,78,35,0,0,0,0,0,0,43
18643,12592,6281,120,445,97,119,521,189,6311
19135,35302,16978,163,1596,221,219,1494,343,18324
19355,25928,12587,51,745,293,80,902,357,13341
26293,550,277,0,61,8,0,25,0,273
6791,5469,2785,8,109,94,19,129,63,2684
11931,44,11,0,11,0,0,0,0,33
12307,6115,2698,18,71,12,337,138,17,3417
27861,59,28,0,2,5,0,0,0,31
23059,35124,16495,77,1135,242,208,1273,534,18629
23502,21640,10679,381,691,136,111,604,289,10961
14034,2800,1864,47,158,14,6,42,27,936
14132,5792,2888,5,89,23,56,155,82,2904
14441,332,187,0,10,2,0,7,1,145
3582,2459,1232,16,59,36,0,48,45,1227
33848,1059,488,0,37,0,0,0,16,571
37764,9741,5138,0,323,141,73,221,153,4603
24457,240,169,0,32,0,0,0,0,71
25143,8233,3822,111,152,135,20,313,167,4411
44120,34276,15578,237,1045,511,93,1115,660,18698
38838,860,465,0,0,26,0,36,0,395
30571,3545,1910,34,55,39,41,111,110,1635
27048,8059,3980,3,144,41,31,255,124,4079
97522,620,337,4,21,0,0,26,22,283
83253,75,47,0,0,0,0,17,0,28
83330,6617,3479,176,199,13,0,84,0,3138
87027,309,179,0,0,15,0,19,0,130
79371,1416,688,0,21,5,8,44,3,728
64783,987,533,19,28,14,0,18,0,454
65668,1766,848,11,54,25,0,59,16,918
57533,1939,958,5,76,20,3,28,56,981
79003,178,91,0,8,7,3,0,2,87
79406,6880,3595,62,0,0,127,0,0,3285
75773,13640,6520,55,327,87,28,495,134,7120
70119,38255,20069,219,2003,325,159,1381,399,18186
62948,13183,6281,32,371,176,116,473,89,6902
64119,27848,13446,157,1024,233,118,1041,474,14402
73555,160,119,0,3,0,0,0,0,41
56138,868,446,0,19,6,0,36,6,422
84112,1989,1128,125,9,6,118,10,13,861
88056,197,125,10,0,0,0,0,0,72
88421,39,39,0,0,0,0,0,0,0
94515,7436,3776,108,319,78,11,106,201,3660
99032,714,343,13,13,10,4,18,13,371
97392,6671,3428,43,415,73,6,241,86,3243
69167,370,199,0,6,9,0,8,0,171
45338,5009,2499,5,112,52,0,107,49,2510
58653,695,384,0,24,9,0,5,18,311
18240,3797,1895,19,136,137,0,81,94,1902
19113,93,44,0,0,0,0,29,0,49
19501,1098,566,0,29,4,0,32,4,532
8002,22651,10689,95,693,154,47,906,371,11962
67601,24202,12030,553,620,349,375,566,360,12172
71282,10559,5217,108,360,94,35,341,155,5342
62523,1439,906,5,97,1,17,7,9,533
63073,905,473,0,57,0,0,0,14,432
77020,25749,13449,200,867,102,338,825,322,12300
77359,475,333,0,0,12,0,0,0,142
78411,25999,12490,163,668,212,207,801,458,13509
73051,10399,6442,137,535,138,36,227,100,3957
83823,1401,738,6,29,37,0,56,16,663
81004,26033,12477,210,848,377,204,777,391,13556
81525,1468,800,0,120,10,0,87,0,668
93218,873,440,7,22,14,4,27,15,433
93532,2871,1465,19,58,68,7,40,95,1406
99788,115,70,0,4,0,2,4,6,45
87347,156,84,0,0,0,0,0,0,72
652,3697,1778,23,174,41,37,159,21,1919
14487,5910,2729,28,111,72,0,177,73,3181
23220,34280,16291,705,1030,182,1523,591,140,17989
20307,108,76,0,0,0,5,0,0,32
20621,1046,567,0,10,22,0,18,26,479
17953,487,257,8,16,9,3,7,9,230
18426,4226,2014,4,131,24,0,73,99,2212
19342,18859,9405,179,473,257,8,382,259,9454
8872,20324,9876,60,708,326,71,803,297,10448
707,10964,5364,22,182,147,26,237,93,5600
1367,595,291,4,14,7,4,12,18,304
13739,796,392,0,14,7,0,19,3,404
95303,871,509,0,17,6,6,10,6,362
89501,4054,2472,17,203,88,36,80,87,1582
90230,32808,15576,167,1054,344,130,1208,338,17232
97911,78,46,6,0,1,0,0,3,32
92270,18075,9132,0,302,334,18,226,229,8943
92327,740,447,0,0,81,0,46,32,293
72845,1018,485,0,57,28,0,34,46,533
73722,499,276,0,15,3,0,3,7,223
74458,94,54,3,8,6,0,6,0,40
62703,30910,13883,168,760,292,332,1021,450,17027
63766,876,457,0,6,25,0,19,56,419
65631,5517,2408,17,143,31,20,119,43,3109
82082,1696,926,0,55,32,0,37,15,770
62298,16608,8106,92,525,196,143,567,250,8502
80903,15519,7861,194,601,182,315,412,182,7658
69353,24,13,0,0,0,0,0,0,11
50170,2803,1416,4,59,53,5,78,25,1387
49277,3389,1657,27,115,56,54,79,46,1732
27292,39649,19598,284,1007,588,48,974,510,20051
27871,4307,1987,17,150,138,9,90,142,2320
22733,1100,553,0,12,18,0,14,0,547
23229,35479,17574,246,998,450,38,1068,472,17905
4568,443,232,0,1,13,0,4,10,211
14882,4072,1928,55,145,78,41,111,21,2144
77510,14823,7374,93,324,262,85,507,213,7449
79345,975,439,6,24,17,0,38,4,536
60192,15650,7798,77,412,186,24,493,328,7852
71280,4745,2121,93,117,54,3,212,86,2624
65803,41023,20665,483,1321,368,109,1225,365,20358
68055,314,173,0,12,1,0,7,6,141
84121,40752,19554,263,1398,533,293,1423,579,21198
85936,4447,2334,49,222,3,52,92,13,2113
75390,0,0,0,0,0,0,0,0,0
72904,22438,10815,137,886,161,100,640,314,11623
73570,1083,622,24,10,19,9,26,27,461
13832,663,345,4,38,11,0,39,13,318
15210,26616,12985,97,735,275,219,1040,513,13631
16420,711,391,3,13,8,0,31,11,320
32764,3188,1698,23,56,24,17,56,51,1490
33584,27153,13167,105,755,323,151,758,455,13986
23303,890,381,0,0,12,0,0,86,509
26285,471,263,0,14,0,0,0,0,208
59053,402,197,0,10,2,0,3,0,205
49428,27596,13595,118,796,306,86,914,516,14001
49718,686,322,0,6,8,4,29,12,364
50041,89,54,0,0,0,0,0,0,35
52411,8145,4137,16,153,30,0,204,196,4008
53922,900,461,2,27,18,6,13,18,439
63460,461,227,0,0,0,0,6,3,234
45056,27957,13208,1327,361,132,1903,465,216,14749
45385,38635,18810,296,1112,506,239,1029,625,19825
71860,2208,1034,22,31,7,7,58,14,1174
61053,2612,1244,5,61,67,9,59,54,1368
61873,6519,3198,67,296,48,39,288,115,3321
29203,39518,18614,571,1220,410,366,1200,565,20904
30079,2824,1281,20,90,21,0,126,0,1543
44121,33211,14824,196,906,461,241,1154,434,18387
44131,20532,9804,44,606,355,69,470,404,10728
31833,7188,3490,26,167,28,56,194,104,3698
24458,356,185,0,10,0,0,0,9,171
25639,344,204,0,37,9,0,24,10,140
74829,1474,1174,2,115,34,0,14,36,300
84107,33978,15916,195,1326,199,282,1104,397,18062
85711,39521,19153,509,839,456,357,1305,595,20368
95065,8355,3909,39,196,108,51,296,107,4446
95689,1698,911,0,58,69,17,8,43,787
16411,1674,856,0,57,0,9,47,40,818
16837,146,80,0,0,0,0,0,0,66
10165,0,0,0,0,0,0,0,0,0
12841,107,39,0,0,2,0,0,3,68
25703,7375,3519,313,89,53,402,106,72,3856
22303,14504,7391,136,702,116,76,641,122,7113
14489,6923,3432,31,193,82,148,91,55,3491
74528,194,108,3,1,0,0,2,0,86
74804,20867,9838,158,543,144,147,571,265,11029
75172,4294,2349,0,198,18,37,114,17,1945
81632,10011,5142,43,407,170,41,364,64,4869
82051,40,19,0,0,5,0,0,0,21
82224,12,6,0,0,0,0,0,0,6
85609,199,97,0,0,17,0,0,0,102
96056,1572,825,0,35,26,0,29,14,747
86440,7329,3802,63,140,84,154,141,130,3527
87574,256,148,0,10,0,0,0,7,108
88008,8337,4180,116,164,74,111,289,124,4157
89521,31329,15047,85,1118,323,80,1248,530,16282
29519,228,139,0,0,7,0,0,14,89
30517,14657,7083,46,552,138,32,483,123,7574
35614,7638,3708,60,230,91,21,224,66,3930
45044,54680,26608,251,1625,372,419,1936,649,28072
45310,270,146,1,12,4,0,12,4,124
46069,7415,3994,101,154,130,43,203,96,3421
46310,14063,6922,38,412,238,44,323,179,7141
46915,584,269,3,18,2,3,38,8,315
40965,12415,5913,63,324,91,78,373,122,6502
5859,1730,863,19,44,19,8,58,35,867
1845,30589,14964,245,811,268,71,938,370,15625
23002,9937,5101,100,266,134,46,159,216,4836
26236,154,97,0,0,0,0,0,0,57
17030,917,487,9,16,6,0,19,28,430
17088,1037,527,0,60,0,0,47,24,510
17304,2906,1491,17,57,40,35,81,50,1415
15930,136,82,0,40,0,0,41,0,54
6856,5,5,0,0,0,0,0,0,0
8732,1357,605,4,18,30,6,36,20,752
11374,42653,19585,154,1256,641,130,1755,805,23068
95385,440,281,0,21,7,9,7,0,159
95709,5315,2777,7,141,61,0,81,49,2538
97027,12568,6056,116,299,137,86,507,202,6512
19975,9341,4458,63,152,198,0,109,191,4883
60560,24886,12460,46,1584,359,71,1051,253,12426
61565,1448,738,4,61,24,9,19,24,710
64446,968,478,13,13,12,0,23,26,490
64459,386,183,0,0,0,0,18,4,203
79051,0,0,0,0,0,0,0,0,0
80422,4618,2489,9,157,153,7,81,146,2129
83524,952,482,4,31,11,3,19,11,470
74033,11999,5958,79,437,74,70,444,69,6041
84776,619,323,0,16,15,0,18,0,296
59442,1857,899,16,66,38,4,53,13,958
60060,37208,18979,188,1261,439,135,1219,480,18229
40489,4399,2183,0,215,8,18,116,30,2216
32344,12360,6703,65,591,170,46,283,163,5657
44404,1446,588,0,1,15,10,40,10,858
51433,548,248,0,11,0,2,8,3,300
52571,1676,754,19,49,29,0,61,48,922
53525,4114,2027,39,152,43,26,117,73,2087
81211,8076,4617,22,382,96,41,104,252,3459
74872,3263,1714,17,96,34,10,94,37,1549
75684,7607,3932,37,335,47,22,254,138,3675
58413,981,450,0,10,4,0,16,12,531
59739,222,126,0,2,5,0,0,0,96
17563,4080,2105,28,70,35,44,146,18,1975
18830,555,298,3,20,9,0,13,10,257
19348,23537,11503,170,848,243,91,645,390,12034
15224,11257,5266,46,373,73,59,396,193,5991
25920,261,133,0,0,0,0,0,0,128
26268,43,10,0,0,0,0,0,0,33
26320,620,320,0,19,35,25,29,0,300
27209,4591,2208,81,130,7,0,125,30,2383
27239,9066,4490,21,209,120,39,203,243,4576
27551,1627,750,0,2,52,0,30,39,877
27704,39281,18272,263,1427,231,18,1808,458,21009
27978,203,94,0,0,14,0,0,4,109
31087,8685,5237,52,365,147,0,177,132,3448
33004,16812,8235,11,565,195,112,688,145,8577
33477,13710,6338,0,132,230,45,153,298,7372
34431,7958,4063,6,88,108,21,166,100,3895
37757,9519,4633,17,331,91,87,303,68,4886
39656,695,431,18,41,7,0,43,22,264
43760,2138,1066,0,111,0,0,42,0,1072
55974,2031,979,8,83,28,8,37,40,1052
48306,27663,13600,101,623,338,65,742,399,14063
48604,12435,5448,282,209,47,365,289,57,6987
49634,81,48,9,8,4,0,0,0,33
13808,1534,723,0,44,25,14,11,21,811
14261,5736,2985,302,0,0,319,16,0,2751
14870,9565,4741,49,318,92,56,306,140,4824
15644,18704,9100,63,640,246,56,609,358,9604
15901,3417,1653,0,27,7,23,37,55,1764
20015,16395,7956,48,390,194,6,668,252,8439
21532,15062,7360,311,303,106,313,315,109,7702
22968,10810,5188,19,414,131,19,272,278,5622
3745,1546,815,18,21,13,3,30,45,731
8353,374,154,2,9,0,2,15,8,220
8550,19246,9460,34,388,149,24,538,283,9786
28670,3590,1749,24,147,66,52,190,14,1841
12449,3433,1630,0,60,18,21,123,44,1803
12857,629,335,3,34,11,0,21,5,294
28349,2840,1417,0,71,94,26,72,75,1423
17758,869,421,5,12,13,3,23,6,448
74633,341,187,0,23,7,1,10,3,154
74764,3814,1952,0,100,67,12,91,48,1862
85381,25446,12145,261,728,302,313,765,306,13301
86323,16394,8319,5,249,374,68,429,355,8075
66609,7194,3542,40,170,97,21,144,194,3652
14588,679,586,7,104,0,0,5,0,93
16101,32486,15406,116,1018,415,153,823,655,17080
16155,124,20,0,0,0,0,0,0,104
17041,248,116,0,10,11,0,10,0,132
2858,728,244,0,0,0,18,61,0,484
3839,3938,1977,13,71,64,0,76,28,1961
4110,1372,736,0,27,21,0,27,0,636
4349,1049,508,0,18,8,23,27,21,541
4666,1251,609,10,40,25,4,31,32,642
74884,5731,2752,16,148,57,17,110,86,2979
74942,155,83,0,4,2,0,5,0,72
76643,14347,6790,61,609,153,39,457,100,7557
77494,114989,55688,295,5111,494,484,6247,787,59301
80459,2501,1271,0,54,31,17,63,73,1230
80919,28146,13530,62,883,407,168,871,515,14616
81152,1170,643,18,0,18,15,43,40,527
83241,2278,1177,3,99,30,2,116,28,1101
85054,6896,3542,0,242,176,88,268,10,3354
99590,176,90,3,2,1,3,0,3,86
99672,3435,1754,93,51,54,26,77,103,1681
78160,4786,2423,7,126,59,12,95,123,2363
48467,2212,1144,25,42,40,11,53,54,1068
49310,3415,1717,20,95,72,19,86,45,1698
24716,417,197,0,21,0,0,0,0,220
12764,1583,814,0,44,26,11,20,17,769
1026,954,451,0,11,7,0,17,7,503
27840,426,191,6,6,8,0,11,1,235
65014,2030,1006,38,68,50,18,43,29,1024
61773,413,240,11,13,8,3,6,4,173
62084,1464,745,2,43,10,8,53,12,719
62445,1290,677,0,87,15,0,46,7,613
98815,7719,3664,67,197,143,0,194,138,4055
99201,13547,7164,133,391,106,47,490,184,6383
97101,4024,2074,19,123,42,6,101,89,1950
67425,757,408,8,22,4,2,8,4,349
67880,7682,4027,35,152,55,13,189,136,3655
68654,543,266,0,8,9,0,18,10,277
68734,84,40,0,4,6,0,9,1,44
68765,1323,687,14,31,33,10,26,5,636
69128,127,69,0,0,0,0,0,0,58
71222,3318,1579,54,101,58,0,135,43,1739
76522,36204,17228,139,1315,251,311,1413,369,18976
78387,9481,4504,171,344,56,31,220,179,4977
79703,23111,11964,243,625,290,115,710,189,11147
83666,26,18,0,3,2,0,0,0,8
66202,16183,7790,53,661,203,107,748,176,8393
86434,1657,772,14,54,13,3,40,34,885
87013,5350,2698,38,125,43,31,172,71,2652
87023,623,297,0,0,37,0,0,0,326
87419,365,194,0,1,0,0,33,0,171
48219,48184,22142,456,1166,431,169,1542,872,26042
48315,27154,12628,95,809,248,155,604,451,14526
40155,1066,556,0,43,28,0,37,28,510
59482,589,294,0,7,12,12,21,4,295
62822,3091,1446,25,76,33,0,95,33,1645
56201,23192,11474,183,810,203,115,729,297,11718
52142,1763,985,57,13,11,44,22,16,778
55109,34135,16559,133,1070,406,199,1078,474,17576
48662,1643,904,6,63,27,0,47,14,739
51035,1592,843,7,124,23,6,39,31,749
43782,673,360,7,28,0,0,14,17,313
3109,10550,5304,20,353,115,18,347,125,5246
5656,3587,1813,126,126,33,157,89,42,1774
6103,1861,1030,0,65,0,13,11,17,831
7076,24121,11375,19,865,223,62,952,447,12746
14516,2454,1195,43,96,48,0,82,29,1259
14815,811,458,3,16,37,2,19,15,353
16823,30228,17001,118,1372,292,149,798,503,13227
24541,27607,12911,166,701,369,194,771,458,14696
23009,6541,3135,14,178,36,0,189,133,3406
27019,4139,2353,11,108,80,0,88,42,1786
19472,12,6,0,0,0,0,0,0,6
28546,46338,23283,849,1574,315,409,1498,514,23055
29518,1042,604,0,9,32,20,15,0,438
11762,22606,11182,134,572,172,104,650,328,11424
12917,1332,703,29,38,10,8,22,20,629
52079,870,516,4,38,47,0,38,13,354
52544,7369,3575,65,188,84,0,245,117,3794
52807,15638,7906,175,558,144,132,448,134,7732
54853,4179,2059,10,141,71,20,94,79,2120
54967,352,200,0,7,8,4,2,18,152
65041,5429,2772,25,148,49,0,157,152,2657
67443,1655,844,4,42,6,0,49,20,811
56671,3294,1677,41,23,39,0,110,0,1617
62469,610,259,0,59,8,0,63,0,351
72653,27981,13228,53,607,364,126,452,504,14753
72958,7089,3591,67,196,95,70,118,125,3498
30344,32706,15206,170,1142,283,397,1306,303,17500
31810,245,145,0,10,3,0,1,2,100
50653,605,351,3,25,8,0,25,8,254
53923,2110,1014,7,57,10,5,50,19,1096
54021,6617,3666,41,217,104,9,241,59,2951
54209,1277,636,5,15,31,4,31,21,641
54487,9587,4765,41,179,118,61,213,192,4822
55705,3301,1691,11,99,50,22,80,46,1610
56361,2292,1224,35,103,26,11,51,26,1068
42776,2481,1239,3,75,47,24,36,28,1242
46035,1082,501,6,29,15,6,31,2,581
48128,10748,5289,79,301,87,43,285,159,5459
37809,2412,1205,0,23,21,6,62,53,1207
16314,5411,2716,18,174,70,13,166,58,2695
16686,13268,6610,174,529,204,16,322,163,6658
29451,4430,2156,3,81,55,11,82,87,2274
10282,5593,2707,10,346,15,0,486,25,2886
13314,373,203,9,5,0,2,2,3,170
22643,273,155,0,13,8,0,7,0,118
23109,2178,1034,0,50,13,0,89,23,1144
25134,303,178,0,0,19,0,27,0,125
21666,12363,5943,53,255,184,20,368,174,6420
97305,43590,21801,498,1707,403,383,1386,339,21789
90606,32803,16509,172,968,338,228,1061,324,16294
94110,74161,40201,259,4462,612,219,3306,860,33960
98297,36,25,0,5,0,0,0,0,11
98350,451,249,6,22,6,0,11,0,202
98538,339,162,9,4,0,0,13,3,177
87315,188,108,0,0,0,0,0,0,80
89012,35075,16942,77,1141,231,94,1252,569,18133
2332,15703,7569,94,261,160,74,303,237,8134
784,40685,20129,430,1251,489,190,1052,717,20556
60613,50113,25205,268,2714,269,482,2680,367,24908
62808,1438,803,0,66,12,3,43,23,635
62841,131,73,0,0,0,0,6,0,58
64124,10626,5482,151,262,77,60,367,87,5144
78622,195,84,0,0,9,4,10,11,111
79012,1341,776,0,22,0,0,128,0,565
80110,22523,11861,199,1115,186,291,1034,263,10662
81656,175,120,0,12,0,0,17,0,55
83281,114,59,0,10,0,0,10,0,55
85284,18945,9292,127,674,312,84,558,279,9653
59833,5656,2789,0,128,76,0,153,139,2867
68648,575,272,0,49,5,2,42,9,303
51576,2079,1019,7,58,43,13,34,10,1060
53074,12953,6318,25,537,150,66,376,178,6635
53575,16493,8652,53,498,180,29,571,270,7841
55073,3600,1804,0,163,55,0,67,53,1796
56025,442,227,2,16,11,1,14,8,215
37845,673,282,26,0,0,21,0,0,391
22482,3041,1368,0,83,55,9,42,42,1673
19440,19100,9756,90,679,229,65,762,302,9344
8203,8966,4235,34,184,111,40,143,217,4731
8403,967,459,7,4,23,0,13,23,508
28637,1734,807,23,56,23,27,34,10,927
29594,79,32,0,0,0,0,0,0,47
12207,1688,936,0,34,19,0,10,21,752
36454,39,26,0,0,0,0,0,0,13
15746,124,54,7,0,8,0,0,0,70
11715,4832,2467,0,121,8,14,157,100,2365
13066,12550,6127,18,407,141,11,423,211,6423
13346,6045,2639,122,144,49,400,29,60,3406
25035,1112,635,0,33,0,0,0,46,477
25971,963,523,0,25,21,0,0,12,440
18074,5688,2876,0,253,62,0,182,60,2812
18642,4170,2055,44,192,79,18,136,50,2115
19374,1146,700,0,24,0,9,105,0,446
75101,615,299,0,22,4,5,16,0,316
75779,135,78,0,0,0,0,20,0,57
76085,11119,5493,30,306,175,22,319,149,5626
85531,417,201,0,0,0,0,0,7,216
64750,547,279,0,12,0,0,13,0,268
66614,32180,14771,115,996,372,143,878,454,17409
78704,48486,25320,143,2318,271,217,2460,377,23166
3903,6484,3300,33,81,68,0,136,135,3184
7732,4834,2567,0,40,63,1,100,274,2267
10985,189,54,0,0,0,0,9,0,135
11023,9215,4619,32,187,69,45,265,125,4596
741,4880,2290,49,129,63,15,122,48,2590
1843,25454,12389,273,777,275,94,935,210,13065
59535,77,41,0,0,0,3,3,0,36
37722,5380,2589,49,117,104,67,108,148,2791
29146,1694,780,16,14,35,26,82,17,914
29374,3756,1886,93,92,13,68,176,14,1870
29850,200,0,0,0,0,0,0,0,200
15116,14267,6849,64,409,192,54,377,327,7418
21113,33736,15766,44,1048,157,67,1395,201,17970
23079,297,134,0,0,10,0,4,6,163
43117,212,92,0,0,0,0,0,0,120
43240,4295,2108,74,194,13,0,160,53,2187
45307,330,156,1,4,1,5,4,2,174
97737,655,378,9,0,0,0,31,8,277
99402,1578,738,0,18,24,12,12,41,840
99660,425,259,0,36,1,5,11,5,166
57730,5767,2912,49,80,139,50,146,131,2855
63472,665,343,8,18,5,5,14,19,322
48733,1693,768,3,34,30,10,55,41,925
48762,1090,504,3,5,16,0,17,12,586
46565,8698,4230,71,271,60,100,239,127,4468
49788,6017,4329,69,502,64,20,126,20,1688
50316,16774,8363,118,605,74,155,520,124,8411
40280,685,380,27,0,0,0,8,0,305
90274,25279,12090,105,362,257,61,400,581,13189
96762,6686,3420,163,217,29,153,143,10,3266
98903,14312,7241,59,353,137,70,451,263,7071
98930,16315,8358,278,587,123,234,388,80,7957
95311,1649,809,0,0,43,52,24,42,840
95323,1222,610,16,31,10,8,28,21,612
3875,1067,549,0,29,34,0,20,11,518
5404,7232,3729,100,348,60,95,279,92,3503
7029,18889,9480,105,868,81,96,801,115,9409
7042,26029,12285,89,806,217,174,851,454,13744
7307,43055,21612,213,2050,297,330,1828,405,21443
7430,26325,12125,264,719,147,454,948,281,14200
29920,11693,5362,90,187,306,0,345,142,6331
49126,1055,493,3,12,6,11,21,13,562
40828,3682,1907,13,101,57,26,31,43,1775
23083,2484,1328,0,46,0,0,96,0,1156
23437,4175,2025,17,56,92,11,131,199,2150
30165,41961,20790,284,1105,303,173,1244,280,21171
30331,64492,27956,505,1527,591,338,2387,853,36536
35235,20926,9613,31,682,230,73,749,344,11313
38259,632,349,0,16,6,2,11,8,283
18249,3760,1802,8,136,48,0,123,31,1958
20620,1365,560,0,0,55,0,88,10,805
21740,61803,31502,381,2292,504,328,1806,840,30301
43235,42673,20551,56,1823,352,142,1593,525,22122
27810,4074,1937,40,121,114,5,182,64,2137
38572,11022,5220,39,174,156,93,181,138,5802
40212,17486,8204,116,412,169,149,606,296,9282
46017,5827,2936,53,141,41,17,103,54,2891
50482,841,426,2,19,11,0,16,10,415
48502,1147,860,53,54,0,11,32,0,287
51526,1782,843,5,76,23,3,52,48,939
58267,1348,741,8,52,16,0,28,21,607
52583,302,144,0,3,6,2,8,0,158
54155,7001,3142,18,330,3,7,349,143,3859
2814,7673,4017,46,167,70,9,288,91,3656
58622,1922,1093,17,96,9,0,71,18,829
7740,30889,15462,297,1344,375,360,989,341,15427
55335,1733,873,9,76,19,15,48,10,860
18420,57,20,0,0,0,0,0,5,37
81087,123,52,0,2,0,0,10,2,71
15140,3230,1566,12,134,64,0,87,22,1664
84640,95,50,0,1,3,0,0,0,45
34997,44018,21574,247,1142,544,191,1163,726,22444
64635,561,262,0,12,5,0,4,2,299
37350,1992,932,5,33,54,0,71,43,1060
75229,31790,16431,72,1373,232,180,1337,416,15359
76828,214,104,0,10,0,0,0,0,110
95131,31170,16157,301,1122,280,167,1229,403,15013
77007,37492,19597,2,2391,294,21,1755,409,17895
67060,14210,6954,142,444,180,35,461,134,7256
67227,304,156,0,0,0,0,12,0,148
92378,263,127,0,12,0,0,13,0,136
79062,190,98,7,9,2,0,9,2,92
65233,11943,6361,35,404,71,93,297,175,5582
71256,1121,630,0,3,2,13,16,8,491
62294,14117,6657,41,386,78,57,473,363,7460
97479,9550,4825,19,272,107,79,305,135,4725
50458,2159,1085,0,79,32,15,60,29,1074
95679,71,44,0,0,0,0,0,11,27
57531,115,68,0,8,6,0,6,4,47
49004,16374,7863,56,428,152,93,389,229,8511
64465,4731,2399,23,81,28,58,153,20,2332
44646,46749,23349,385,1427,680,336,1409,678,23400
72517,292,130,0,0,12,0,33,14,162
50272,143,76,3,2,6,0,0,2,67
34135,46064,23101,315,1337,755,214,867,643,22963
57432,391,160,0,1,9,6,1,2,231
39466,26057,12939,117,543,292,297,607,270,13118
14729,897,508,8,43,12,0,19,29,389
59531,305,178,0,6,0,0,7,3,127
33001,323,160,0,4,1,0,0,0,163
59928,187,101,0,0,9,9,0,0,86
25844,1383,646,0,16,0,0,23,0,737
52042,1606,753,0,29,0,0,28,4,853
8852,18052,9041,25,1004,206,56,957,173,9011
62518,176,83,0,0,0,0,0,0,93
67638,285,149,0,3,5,3,8,0,136
54843,11577,5860,82,248,196,107,337,207,5717
55414,34725,17865,1977,539,128,1980,512,200,16860
55798,633,321,3,10,8,3,13,15,312
17859,2814,1306,5,39,64,12,51,36,1508
71357,1991,959,31,63,18,0,28,39,1032
89032,44034,21163,394,1201,404,357,1422,783,22871
1772,9486,4772,21,155,109,107,197,97,4714
93622,10395,5164,107,473,36,130,396,139,5231
26537,5021,2336,88,207,75,75,268,78,2685
90621,35398,18213,323,1352,259,241,1296,616,17185
45231,40071,18539,160,1025,429,341,1435,615,21532
93012,36225,16770,326,628,399,273,769,643,19455
30830,13828,6526,79,316,101,124,397,242,7302
33194,8485,4894,11,624,119,0,216,56,3591
39057,2328,1122,34,14,0,32,81,109,1206
58439,110,39,0,3,0,0,3,0,71
45348,1026,508,22,42,19,11,47,24,518
68327,301,143,0,6,7,0,24,7,158
46711,8308,3943,60,225,108,33,218,83,4365
76957,0,0,0,0,0,0,0,0,0
91316,29964,13764,170,951,262,48,991,407,16200
92086,1544,750,8,30,37,0,26,52,794
67438,239,109,0,11,1,0,10,0,130
67661,3310,1587,14,79,47,19,104,79,1723
98382,28326,13609,244,435,638,75,609,498,14717
56136,1064,494,3,20,9,3,17,6,570
42041,4340,2092,55,159,30,35,87,107,2248
80543,7001,3576,75,294,103,28,259,84,3425
34601,21847,10402,123,545,383,101,275,518,11445
99569,48,25,0,0,0,0,2,1,23
50457,340,150,0,16,3,2,3,8,190
52342,3335,1535,0,65,43,36,83,49,1800
7093,63913,31634,376,2914,263,510,2065,663,32279
51541,364,162,0,5,11,0,14,0,202
54480,1414,699,7,32,12,16,41,3,715
54601,50761,23847,951,1232,467,1741,1177,590,26914
60512,1184,566,0,0,68,65,0,0,618
55384,1829,877,6,70,18,0,26,46,952
62860,546,300,0,9,13,3,53,5,246
43310,2841,1474,5,84,41,15,51,81,1367
70341,4023,2118,36,113,112,0,116,76,1905
38560,1180,584,9,26,13,7,69,24,596
74301,11499,6075,42,325,113,88,278,123,5424
21043,46932,22731,215,1507,287,204,1927,527,24201
52756,2027,1051,3,71,32,0,60,40,976
4074,19713,9454,74,596,253,95,560,285,10259
55429,27597,12992,132,1001,201,145,1190,193,14605
8758,7674,3845,41,149,175,0,94,189,3829
72329,193,101,0,0,0,0,17,0,92
17224,1827,908,0,120,14,0,32,79,919
73501,20617,11432,123,862,185,155,467,231,9185
51366,294,150,3,6,7,0,13,0,144
44491,3517,1842,26,128,20,11,98,38,1675
30518,52688,25901,358,1818,444,375,1886,537,26787
32622,1004,508,3,30,27,2,43,4,496
39166,640,299,0,9,7,1,12,18,341
64426,354,182,0,6,14,0,11,13,172
57772,2571,1251,15,40,0,17,59,38,1320
36263,434,195,0,13,0,2,45,48,239
49241,2486,1159,2,114,20,6,78,27,1327
26563,550,277,0,42,8,0,0,31,273
49307,20769,10332,641,375,186,525,398,238,10437
43211,23453,11338,113,351,156,184,893,278,12115
71112,35061,17233,255,1189,304,168,1112,354,17828
28441,3818,1864,26,68,34,38,157,22,1954
28777,10314,6139,48,517,154,58,164,135,4175
29072,60081,30501,134,2141,539,116,2286,792,29580
74022,1864,913,4,20,23,5,22,23,951
29471,1455,640,0,64,16,0,5,10,815
45177,22385,11281,182,543,306,135,559,293,11104
25628,217,89,0,0,0,0,9,0,128
50067,247,128,0,7,5,2,24,6,119
37329,5811,2985,88,146,58,14,137,50,2826
53590,40064,19301,344,1763,371,151,1604,397,20763
72330,478,262,12,13,7,14,0,7,216
31094,1217,662,9,7,0,0,18,5,555
73027,1210,509,3,25,10,7,40,11,701
33511,57642,27625,269,1907,631,409,1845,702,30017
45003,552,255,3,15,7,7,12,8,297
47124,4607,2403,55,109,43,26,180,45,2204
49117,3607,1688,13,63,48,8,75,123,1919
48867,27211,13361,241,913,303,185,848,407,13850
6241,6206,3168,44,229,65,22,236,94,3038
48888,5978,3079,20,276,55,29,158,117,2899
6515,19184,9027,288,460,98,192,706,200,10157
7074,2739,1320,0,94,26,8,51,24,1419
17039,64,32,0,0,0,0,0,0,32
5832,879,502,4,47,5,0,27,10,377
59054,250,139,2,1,19,0,3,4,111
24850,499,241,0,17,26,0,18,14,258
61604,30582,14642,141,1361,298,179,979,519,15940
20903,26206,13234,159,1416,157,165,1135,274,12972
85016,35167,18049,165,1555,446,149,1280,419,17118
21837,3266,1612,47,120,47,25,80,40,1654
76049,29279,14153,78,650,516,47,771,464,15126
77014,36455,18105,456,1132,141,174,1266,370,18350
11005,1749,604,0,0,49,0,0,6,1145
92780,61660,30414,628,2355,400,252,2334,758,31246
11777,8951,4575,17,313,95,28,275,188,4376
78142,154,66,0,23,0,0,4,0,88
28134,11049,5046,63,385,23,28,567,50,6003
99360,1584,821,30,97,22,47,49,11,763
59730,2026,1136,0,77,21,0,96,19,890
32697,334,163,0,12,0,0,25,3,171
96713,1201,604,19,0,28,0,0,0,597
97394,5028,2376,0,45,156,0,79,135,2652
42631,195,112,21,0,0,18,0,0,83
49073,5049,2585,36,130,41,3,106,67,2464
38222,3216,1567,28,131,50,70,92,64,1649
38629,2368,1226,17,49,5,0,74,37,1142
49953,2519,1210,0,66,46,11,62,74,1309
51649,294,140,0,5,0,0,3,7,154
28434,1023,492,4,18,4,3,12,89,531
27306,6211,3173,98,124,90,30,168,116,3038
21520,2212,971,1,63,12,13,73,21,1241
31811,6272,3348,37,117,64,10,220,132,2924
29909,18829,8382,0,101,609,9,228,216,10447
15009,15321,7264,52,486,171,68,440,282,8057
25139,381,197,0,0,0,0,35,30,184
92315,5234,2513,33,101,79,42,87,103,2721
8027,4839,2228,0,113,9,11,111,76,2611
93552,40266,20896,392,1456,209,398,1494,519,19370
8501,6220,3145,35,197,82,15,188,77,3075
89017,102,59,0,0,31,0,0,0,43
95212,28049,13626,205,927,202,204,879,335,14423
83866,50,33,0,0,0,0,0,0,17
97038,15587,7846,75,460,235,33,358,210,7741
98595,2863,1464,52,60,74,19,60,79,1399
1430,6253,3025,27,300,59,30,150,138,3228
55021,30035,16151,220,1270,349,223,927,504,13884
55340,8023,4083,13,360,74,58,336,63,3940
67547,1902,955,1,48,31,0,39,20,947
23606,28594,13740,459,801,195,409,846,267,14854
61811,678,322,0,16,12,2,15,11,356
28753,9937,4548,36,482,78,20,329,130,5389
63801,22970,10806,93,589,211,146,808,337,12164
13652,1696,813,7,43,26,0,37,13,883
95324,8016,3940,24,117,61,71,303,143,4076
21531,1895,1040,0,88,28,5,47,21,855
95758,63894,30090,358,1844,522,521,2155,912,33804
16914,2050,1039,14,34,26,11,37,20,1011
97918,4141,1943,3,109,66,19,98,60,2198
10036,27428,14922,203,1669,455,76,983,469,12506
22726,744,330,0,34,10,9,47,14,414
40979,20,20,0,0,0,0,0,0,0
29741,2239,1084,0,15,17,0,23,37,1155
57751,1000,492,20,19,21,0,33,28,508
41714,433,209,0,0,0,0,48,0,224
68367,326,174,11,4,0,0,4,8,152
38454,1201,584,0,8,0,15,76,10,617
61242,1208,635,4,22,29,3,33,24,573
57532,2946,1518,0,172,24,23,51,41,1428
63038,7077,3556,28,79,109,17,107,129,3521
49881,320,172,4,7,5,0,6,4,148
43961,363,161,0,13,6,2,8,7,202
89503,29097,15029,718,780,238,628,719,326,14068
57732,2120,1113,11,61,29,0,17,40,1007
38929,1424,707,0,151,14,0,36,26,717
51033,374,201,0,12,6,0,7,8,173
45241,24366,12456,73,756,439,92,643,533,11910
46176,27603,13435,85,828,293,120,727,311,14168
4284,974,426,4,25,17,0,45,15,548
7442,11049,5637,13,431,49,114,336,153,5412
1432,7762,3790,20,446,126,16,266,54,3972
92083,39043,20709,361,1757,358,326,1333,421,18334
82072,16945,8857,686,500,119,449,388,137,8088
83312,154,84,0,0,0,0,0,14,70
33150,29839,14698,366,1094,263,181,972,226,15141
78738,15589,7733,8,581,178,7,610,127,7856
18222,9339,4798,49,310,140,113,318,205,4541
86502,1290,566,5,13,11,14,22,8,724
18241,676,294,0,39,10,4,27,9,382
88256,1693,878,0,33,26,0,13,32,815
70163,0,0,0,0,0,0,0,0,0
90292,22490,11665,77,1415,262,60,1281,304,10825
70665,11474,5985,83,428,126,78,282,168,5489
13859,189,91,0,0,0,0,0,0,98
14522,9231,4664,75,249,174,26,240,176,4567
72201,972,616,0,99,16,0,17,13,356
10174,0,0,0,0,0,0,0,0,0
51048,608,304,2,10,12,8,17,10,304
2151,53976,27229,224,2151,476,293,1713,932,26747
44113,20358,11699,95,909,140,35,665,168,8659
4017,415,207,0,22,16,0,17,9,208
7522,20104,8672,52,462,55,177,713,286,11432
47448,7016,3412,4,156,163,34,233,61,3604
11363,6952,3341,20,120,38,51,291,81,3611
12143,4800,2451,18,118,80,19,83,122,2349
13041,11453,5462,15,407,124,35,522,92,5991
20838,252,137,0,9,1,9,0,3,115
20880,455,227,0,13,17,0,10,14,228
21071,595,238,0,19,21,24,45,0,357
24176,1387,643,0,82,0,0,43,59,744
25624,188,103,0,0,0,0,0,0,85
25704,16528,7751,43,533,175,60,469,290,8777
14085,7306,3613,27,313,58,0,195,91,3693
15056,1162,587,0,40,9,2,25,4,575
4216,371,191,4,3,9,0,3,0,180
5052,156,84,0,0,0,0,0,0,72
1368,1170,582,0,28,18,5,28,23,588
2743,10483,5207,72,176,62,119,300,231,5276
77642,39142,18932,368,1347,320,334,1222,441,20210
82932,272,154,0,44,0,0,10,0,118
83120,778,366,0,54,0,0,49,0,412
83201,37740,18694,621,1316,339,405,1301,392,19046
84033,1253,617,0,60,5,0,29,12,636
85708,4025,1913,61,222,0,28,176,0,2112
78832,3675,2290,17,220,78,0,52,58,1385
79904,34461,16757,201,1102,316,300,903,381,17704
95401,38986,18684,156,1376,415,287,1788,439,20302
96729,1191,622,15,27,13,5,27,14,569
89415,3111,1532,0,58,37,0,42,85,1579
95045,4181,1975,0,71,92,36,70,65,2206
91403,25218,12185,50,1093,317,109,1024,329,13033
91963,999,528,0,19,63,0,14,22,471
29373,487,298,0,24,0,0,0,0,189
34202,23739,11584,81,306,430,15,611,476,12155
36460,9644,4336,113,233,31,98,402,186,5308
37219,1134,765,0,70,68,0,18,0,369
43977,2289,1183,14,30,24,8,67,42,1106
4456,2963,1483,23,82,46,53,51,47,1480
4664,1343,720,15,39,3,4,23,11,623
22831,1119,516,9,14,7,12,26,21,603
22936,4895,2396,42,68,125,4,102,63,2499
26241,13667,6584,128,384,218,45,431,248,7083
16936,1940,1059,0,41,24,19,33,29,881
16941,93,49,0,0,0,0,0,2,44
19008,20794,10108,102,538,251,51,576,340,10686
13485,1009,507,14,24,33,16,18,24,502
15436,2835,1307,10,32,21,11,129,23,1528
15563,3163,1600,2,74,27,9,96,47,1563
16218,953,508,20,20,13,0,30,32,445
93563,408,235,4,10,0,0,0,7,173
96117,319,146,0,17,17,0,27,0,173
96763,2826,1455,0,122,18,13,61,0,1371
96789,53734,27525,517,1625,726,315,1726,593,26209
97301,55448,29140,745,2104,448,583,1464,650,26308
87553,1469,754,10,30,9,10,27,23,715
36502,18192,10011,72,875,186,130,464,206,8181
99918,148,76,0,4,2,0,6,0,72
62471,10363,5855,143,412,105,94,259,82,4508
62567,1035,524,11,24,12,0,46,16,511
64050,22733,11099,36,912,177,57,615,384,11634
79082,239,106,0,0,0,4,10,0,133
67332,101,46,0,2,0,0,0,5,55
69041,66,25,0,0,8,0,0,0,41
71279,36,0,0,0,0,0,0,0,36
72940,2881,1355,44,53,67,0,51,24,1526
74110,14812,7260,99,539,102,130,514,209,7552
78006,32931,15919,173,1073,291,90,1053,386,17012
84325,2358,1172,9,60,50,6,64,0,1186
55775,1651,868,0,63,24,8,52,29,783
56155,393,197,4,17,5,0,12,5,196
56225,740,352,1,16,5,0,31,3,388
58001,29,19,0,0,1,0,0,1,10
38804,17672,8530,105,643,129,158,853,116,9142
32356,91,45,0,0,0,0,0,0,46
45740,383,162,3,8,21,0,5,7,221
53718,13507,6129,35,619,79,42,619,184,7378
62474,970,484,2,16,10,0,11,13,486
63132,13427,6338,35,345,56,64,524,106,7089
64020,3783,1783,17,42,25,31,139,25,2000
64479,955,452,0,18,14,2,26,2,503
71414,107,57,0,0,0,0,3,0,50
72031,7198,3567,85,207,171,86,233,90,3631
72571,307,177,0,0,16,0,13,18,130
73539,185,94,0,7,0,1,9,1,91
79413,22181,10165,654,861,149,251,962,305,12016
82007,21434,10846,90,682,110,97,860,174,10588
75468,797,423,25,14,34,0,0,0,374
76426,12251,6398,64,321,122,16,379,183,5853
76821,4578,2362,5,167,107,12,80,80,2216
78058,1121,705,0,69,12,0,15,4,416
78116,281,146,0,6,5,0,5,10,135
64755,2921,1576,6,102,32,0,98,58,1345
65641,1062,542,0,5,24,0,0,63,520
58783,354,192,0,1,3,0,4,5,162
59820,1925,945,11,58,16,16,59,56,980
68028,13588,6644,43,664,102,21,596,143,6944
15052,3305,1534,29,94,34,55,113,23,1771
26159,3365,1697,23,106,38,0,57,35,1668
26217,233,108,0,0,0,0,0,24,125
26415,3707,2093,24,150,30,10,143,55,1614
30204,12940,5987,68,404,94,116,241,292,6953
31067,252,128,0,13,0,7,3,23,124
31623,113,44,0,0,0,0,0,0,69
32578,32833,16473,252,1218,420,155,1054,564,16360
53593,23247,11335,84,870,247,93,764,247,11912
55019,1983,908,0,57,23,3,61,24,1075
48460,2289,1136,3,46,34,8,59,22,1153
48744,4183,2157,19,82,48,16,135,74,2026
49667,544,261,3,0,4,3,11,3,283
52731,745,387,4,14,17,1,14,10,358
52801,1109,732,6,18,3,0,46,8,377
30305,23693,11680,46,1083,210,83,818,285,12013
15320,5484,2416,7,129,30,0,246,162,3068
2917,13803,6731,227,230,118,175,281,225,7072
26137,581,249,0,0,0,2,22,28,332
29122,40,15,0,4,0,0,4,1,25
29923,377,182,0,0,0,9,2,54,195
27591,21098,10171,134,572,165,122,659,381,10927
17772,2577,1293,35,39,27,11,39,65,1284
19009,803,375,12,26,21,16,13,11,428
19017,260,135,5,11,0,0,4,0,125
19082,41016,20027,343,1578,406,313,1608,428,20989
76460,348,158,14,0,10,0,24,0,190
76656,2499,1250,30,54,39,15,64,27,1249
77483,226,104,0,13,0,0,11,0,122
65032,1671,866,8,45,17,0,43,42,805
14777,695,363,0,19,3,0,26,14,332
15028,151,82,4,0,2,0,1,3,69
15055,1190,551,8,14,46,0,41,16,639
17309,2085,1021,0,0,7,53,23,32,1064
3447,2395,1253,6,48,79,0,29,37,1142
5663,6597,3741,306,126,135,87,32,127,2856
23235,32355,14718,113,1200,440,146,1341,469,17637
74850,327,159,0,10,6,5,4,3,168
75039,19297,9806,45,1256,90,47,1245,145,9491
76873,36,10,0,0,0,0,0,0,26
77340,30866,15185,468,867,334,1354,680,172,15681
77375,52785,25294,128,1922,200,269,2215,589,27491
84334,342,117,0,0,0,0,11,0,225
88012,29044,14663,142,932,177,51,1002,307,14381
90272,22551,10753,32,465,320,62,573,364,11798
98367,29137,14505,130,1187,330,202,826,455,14632
93305,38725,19240,241,1063,306,377,1228,489,19485
94930,8678,3902,0,223,74,42,211,153,4776
94972,23,12,0,0,0,0,0,0,11
92124,32170,15634,182,1302,213,144,1275,269,16536
49029,1528,693,2,28,30,12,32,33,835
25118,788,458,0,39,14,0,40,0,330
26288,3411,1655,54,106,81,22,98,77,1756
13329,4330,2161,10,129,43,16,126,102,2169
1701,32570,15810,64,942,445,118,1093,753,16760
29560,13292,6075,66,273,121,30,410,226,7217
41839,1541,836,8,50,15,8,32,7,705
65463,1043,637,73,22,27,0,81,0,406
67637,2753,1385,5,90,33,16,113,63,1368
59873,3535,1895,0,147,37,20,179,34,1640
61257,1198,629,12,23,21,11,34,8,569
61449,337,186,0,3,22,0,2,9,151
37731,541,299,0,15,30,0,0,0,242
98249,4040,2033,78,34,121,0,22,131,2007
98624,1636,880,9,17,26,0,32,35,756
95903,1630,973,110,48,0,4,48,0,657
97236,40866,20058,308,1712,406,239,1419,510,20808
67345,111,45,0,0,0,0,0,2,66
78521,92108,44522,1021,2489,760,959,2870,878,47586
79097,890,429,0,33,10,28,36,18,461
94010,42730,20359,120,1107,476,45,1539,691,22371
75152,5097,2453,6,141,37,9,92,64,2644
84312,4513,2310,90,135,52,25,88,25,2203
88255,22,11,0,0,0,0,0,0,11
89506,42053,22039,584,1644,349,331,1237,465,20014
89834,147,93,5,16,0,0,0,0,54
47041,6526,3344,23,112,54,59,97,37,3182
47368,2935,1444,8,74,91,21,77,46,1491
40313,3316,1657,117,50,60,55,68,24,1659
41826,664,386,0,10,0,15,24,29,278
62984,1643,782,16,27,34,2,53,7,861
56265,7322,3625,41,264,69,49,228,90,3697
51520,204,123,0,1,7,0,6,4,81
52540,1281,643,6,44,23,23,18,17,638
54173,4206,2022,0,232,83,22,186,113,2184
4646,65,30,0,2,0,0,2,11,35
5001,9303,4321,68,287,149,11,288,366,4982
5825,75,41,0,4,0,0,3,0,34
7676,9229,4595,81,231,124,19,352,96,4634
15451,1151,419,0,0,0,0,47,23,732
24219,11630,6432,46,440,131,51,475,127,5198
25109,547,263,0,54,0,0,0,0,284
8318,12219,6205,31,389,93,32,318,214,6014
10279,43,18,0,0,0,0,0,0,25
10914,395,181,0,15,0,0,0,15,214
27841,24,10,0,0,3,0,0,0,14
28278,27286,12870,104,779,240,29,1228,253,14416
18109,17637,8755,162,598,172,94,585,316,8882
28729,3271,1745,0,172,34,0,125,39,1526
29565,7836,3529,192,208,31,95,306,42,4307
12422,307,183,0,18,0,0,22,18,124
78385,523,259,0,0,20,0,16,1,264
78390,5416,2682,23,138,48,71,69,52,2734
78406,2074,1179,14,185,30,18,98,0,895
78612,13852,7345,77,462,22,91,334,254,6507
51461,1134,610,5,38,7,10,30,10,524
53816,844,454,8,20,11,0,21,16,390
55413,13945,7035,51,608,176,26,615,150,6910
58538,2608,1319,13,96,0,18,98,31,1289
59432,106,49,0,0,1,0,0,0,57
66743,4301,2093,67,91,28,23,140,48,2208
68366,1024,491,0,23,20,0,42,37,533
71220,22023,10309,42,511,253,91,712,303,11714
57448,496,267,0,12,0,0,2,3,229
72205,23242,11168,108,705,167,23,925,280,12074
49682,4093,2013,20,101,67,37,89,91,2080
50590,853,412,0,27,8,6,40,20,441
53110,18349,8635,134,559,254,41,683,166,9714
54836,1027,518,0,37,9,0,36,13,509
56482,6825,3324,22,224,47,18,196,83,3501
42717,6648,3268,26,135,132,57,164,62,3380
45503,32363,15434,252,779,474,234,979,396,16929
38486,702,299,0,10,0,0,20,0,403
38553,2577,1334,49,28,36,0,15,27,1243
38876,1458,769,18,103,6,0,53,8,689
39194,21750,12649,135,1440,219,67,485,167,9101
30701,40820,19826,312,1459,265,217,1576,579,20994
31081,72,33,0,0,0,0,0,0,39
32351,18643,8122,93,523,193,126,859,261,10521
33483,11904,5858,41,340,200,13,236,329,6046
34639,27522,12989,98,814,224,165,1014,265,14533
36352,5305,2733,38,114,49,18,116,144,2572
36475,2127,1142,11,1,36,10,40,30,985
38327,374,180,0,13,0,0,17,3,194
19031,4653,2040,0,140,52,0,219,51,2613
19056,15540,7292,122,359,128,103,403,279,8248
28071,2649,1510,0,65,76,13,42,31,1139
11217,41407,19458,60,2186,348,164,2142,512,21949
12071,398,187,3,24,3,3,11,0,211
24363,1350,728,0,13,20,0,24,31,622
24477,10901,5350,84,189,110,64,399,166,5551
21536,4145,2057,0,122,27,17,93,75,2088
25865,1406,721,20,39,23,0,21,50,685
14525,2607,1283,22,43,15,26,77,43,1324
97443,2194,1073,76,72,44,21,27,88,1121
94117,44239,22556,47,2364,314,52,1836,204,21683
88118,336,184,0,22,0,1,11,2,152
1834,6749,3526,83,207,161,98,97,161,3223
4966,1719,818,6,24,11,0,50,24,901
61483,2090,1039,2,65,37,40,39,68,1051
61747,1479,719,2,57,26,2,54,30,760
79041,2983,1540,12,148,28,24,102,69,1443
79503,94,50,0,0,0,0,0,2,44
81005,32062,15101,169,745,520,101,930,397,16961
70032,4501,2199,32,170,93,0,147,59,2302
70422,13824,7033,160,580,356,60,424,92,6791
72140,456,217,0,22,6,0,12,0,239
81240,3607,1757,14,83,112,3,157,99,1850
59755,215,101,5,0,14,0,8,8,114
67133,6395,3103,28,240,52,46,277,157,3292
68812,501,254,6,10,10,4,13,2,247
68927,1283,669,0,40,0,12,30,13,614
65690,189,86,0,0,0,0,2,13,103
75409,15379,7161,192,811,82,38,864,128,8218
77562,10380,5114,125,362,197,0,335,270,5266
53963,13880,7712,14,659,51,17,378,81,6168
54858,1721,869,0,63,18,13,36,28,852
37801,26381,12340,208,834,203,203,973,358,14041
39746,3284,1546,74,90,45,16,118,67,1738
47012,9959,4957,69,395,113,86,256,147,5002
59523,2193,1125,19,64,33,0,80,83,1068
60171,10148,4828,9,395,59,71,372,173,5320
57369,2515,1227,18,53,40,0,29,36,1288
50062,690,333,0,6,15,0,12,19,357
34268,128,54,0,0,0,0,29,0,74
3857,9064,4538,0,415,130,70,290,139,4526
7103,32471,14900,286,951,181,222,1287,426,17571
14059,10144,4827,56,293,85,45,210,180,5317
14209,7410,3411,91,88,68,161,194,137,3999
15686,832,430,0,5,3,3,7,33,402
15756,275,146,0,8,4,0,11,0,129
17061,7104,3482,22,191,106,37,173,151,3622
28537,146,71,5,7,0,0,7,0,75
10573,38861,19452,272,1522,239,134,1389,440,19409
20774,46812,21540,216,1157,569,277,1696,709,25272
19312,11974,5720,46,178,211,26,245,120,6254
27208,1847,958,0,56,21,32,77,50,889
27839,3503,2135,13,210,81,22,98,10,1368
27875,424,180,0,0,26,0,41,0,244
81030,183,104,9,0,9,0,27,7,79
83857,1049,564,0,36,42,0,11,27,485
84403,37828,18729,269,1230,359,455,1318,350,19099
62501,2863,1576,33,138,23,54,69,58,1287
62890,2789,1449,8,161,50,10,129,26,1340
62905,505,239,0,11,19,0,3,17,266
64139,2079,1022,58,69,18,0,99,44,1057
72764,56445,28719,313,1888,455,401,2002,349,27726
72956,35617,16923,222,1097,273,299,1091,326,18694
74117,24,12,0,0,0,0,0,0,12
74848,7911,4506,128,437,61,39,146,86,3405
76466,244,95,0,0,0,0,0,0,149
36606,18879,8815,128,505,205,79,768,190,10064
77428,0,0,0,0,0,0,0,0,0
24571,2045,1019,18,52,17,9,50,8,1026
67146,1900,906,21,55,22,16,39,39,994
44455,1665,836,3,8,50,0,16,1,829
98072,24213,11870,215,986,216,101,823,285,12343
98584,37156,19204,140,1408,650,154,1195,650,17952
99565,75,42,3,7,0,0,5,1,33
95562,3422,1662,0,126,16,23,69,50,1760
97111,3543,1657,87,130,30,73,92,96,1886
61337,393,211,0,9,4,1,10,6,182
41539,1515,775,51,57,26,0,99,0,740
43523,20,10,0,0,0,0,0,0,10
16655,1438,709,6,14,22,15,15,25,729
45013,53933,25977,401,1650,601,448,1696,712,27956
24612,229,111,0,31,16,0,16,0,118
24866,311,147,0,12,0,8,42,0,164
19801,16299,8549,124,748,147,108,419,113,7750
29010,12469,6773,118,399,216,59,338,130,5696
11003,45263,22279,237,1732,563,565,1480,581,22984
17936,859,460,3,36,9,0,29,16,399
17945,168,78,2,0,0,0,3,0,90
49002,21226,10530,247,533,264,240,580,298,10696
66221,17455,8799,97,444,176,50,635,210,8656
87723,426,199,0,0,16,1,2,1,227
27127,39902,17890,275,1038,340,227,1119,521,22012
71416,880,298,14,13,13,7,41,10,582
46268,25247,11695,73,810,195,118,1109,269,13552
93030,59755,30324,479,2356,298,436,2046,536,29431
32459,15400,7353,36,655,145,0,500,245,8047
15857,12670,6314,22,309,135,0,345,207,6356
70087,7665,3763,80,158,38,71,329,50,3902
59217,125,70,0,0,4,0,0,14,55
71602,15900,7598,57,374,239,35,346,129,8302
59824,1509,731,16,25,11,8,53,19,778
47713,10427,4689,102,267,58,22,355,144,5738
88350,301,173,0,24,0,0,0,0,128
49335,358,224,0,72,0,0,0,0,134
75060,48664,23469,340,1440,476,341,1442,556,25195
75117,3776,1828,14,69,16,8,125,49,1948
75211,79010,40137,818,2588,504,763,2198,997,38873
75561,5099,2410,10,167,85,34,126,91,2689
75760,2392,1109,44,101,38,13,125,31,1283
80465,16062,8064,70,511,263,36,580,288,7998
81023,1192,624,0,7,15,0,54,63,568
81527,1853,980,0,52,61,0,33,22,873
89025,1171,524,6,9,33,1,36,38,647
92256,3282,1681,0,161,31,0,91,26,1601
99147,128,59,0,0,5,0,0,3,69
65680,1116,569,0,0,16,0,43,62,547
29170,21555,10358,129,1025,234,121,526,350,11197
30805,2735,1213,7,120,29,42,88,7,1522
7945,8999,4192,5,117,89,0,136,237,4807
39363,1271,676,4,33,47,36,17,6,595
62540,1567,786,27,40,16,4,48,25,781
20121,30097,14655,150,1228,228,210,1359,255,15442
22827,10026,4766,32,287,169,10,247,190,5260
3837,1305,681,0,37,37,0,37,11,624
7305,64535,30040,413,2015,482,447,2158,863,34495
15951,481,305,0,0,0,0,0,14,176
81120,2070,1096,16,57,47,12,17,36,974
83115,1463,874,0,260,115,0,0,58,589
83525,323,200,0,0,6,0,0,0,123
91330,3273,1328,173,21,0,247,29,0,1945
93202,3777,2037,69,182,83,12,50,21,1740
84766,344,159,0,0,0,10,0,0,185
88114,15,12,0,0,0,0,0,0,3
97827,2381,1156,0,78,58,7,41,40,1225
97125,296,145,0,0,0,0,14,0,151
97302,38397,18255,92,1152,567,337,1382,545,20142
52245,25157,12978,624,736,289,499,672,146,12179
54805,1332,689,4,35,19,3,32,12,643
65281,2802,1368,12,116,32,22,93,39,1434
67112,194,108,0,3,1,2,2,11,86
59440,115,81,0,5,1,0,2,2,34
59710,255,133,3,7,15,2,2,1,122
48453,5239,2532,49,130,80,5,184,61,2707
48632,5246,2739,25,155,81,47,93,102,2507
48727,1153,625,6,21,10,2,19,17,528
6830,25247,11994,9,606,246,86,989,352,13253
1860,6839,3234,29,81,37,0,269,44,3605
4635,12,7,0,0,0,0,0,3,5
10911,0,0,0,0,0,0,0,0,0
11355,80853,38656,270,3065,834,414,2865,1061,42197
23038,1762,798,40,29,0,0,86,41,964
23357,770,405,0,28,0,0,74,0,365
791,48569,22969,367,1745,612,374,1656,863,25600
29634,5129,2250,97,0,0,87,0,12,2879
29940,4046,1836,12,117,0,0,157,86,2210
11577,12808,6128,51,368,147,19,494,132,6680
26757,6569,2911,39,84,102,22,184,97,3658
27572,6887,3283,0,200,85,55,150,187,3604
28422,8404,4296,18,152,153,4,271,124,4108
46012,19394,9076,232,561,218,282,444,240,10318
47118,3150,1538,2,74,36,9,111,17,1612
40391,35500,17406,268,1059,516,70,1012,561,18094
51453,712,322,0,18,10,1,16,3,390
54107,3599,1840,18,72,43,16,82,60,1759
54171,3688,1865,49,143,0,3,141,124,1823
54303,27718,13491,106,872,209,146,779,342,14227
36474,3099,1586,77,152,21,1,35,63,1513
56593,0,0,0,0,0,0,0,0,0
57262,5693,2859,48,172,51,20,183,48,2834
35172,3177,1706,3,55,20,0,57,63,1471
50173,875,454,1,6,1,3,17,28,421
47944,3412,1668,17,120,13,0,56,59,1744
49228,5253,2681,17,212,58,60,148,73,2572
49264,2182,1081,0,62,23,12,44,30,1101
46767,8347,4146,55,270,86,93,317,72,4201
56313,92,43,0,0,1,0,7,0,49
57580,3998,1943,0,132,48,12,140,87,2055
41837,1436,779,0,47,31,0,57,0,657
49872,193,98,0,6,4,0,7,8,95
50256,416,201,0,10,10,0,30,8,215
51248,1930,993,0,45,42,0,41,12,937
35014,4780,2467,45,170,10,28,224,33,2313
4769,9162,4444,113,223,210,88,206,158,4718
7739,5864,2744,0,57,31,0,103,93,3120
93555,33742,16960,103,1173,184,32,1203,358,16782
96003,44475,21946,213,1283,661,351,1217,610,22529
97402,51489,25879,280,1923,467,488,1678,663,25610
99006,13055,6327,24,239,168,66,363,223,6728
83332,2705,1405,26,58,43,9,61,29,1300
78101,6175,3019,64,281,68,37,76,97,3156
94575,1170,380,85,0,4,139,0,0,790
78209,42045,20178,206,1411,379,429,1255,618,21867
78560,5084,2460,99,108,14,0,132,26,2624
71044,679,340,0,26,4,0,34,11,339
13365,8469,4146,16,216,166,78,170,219,4323
13807,1278,589,2,26,25,18,8,7,689
14510,4772,2398,0,175,71,0,84,37,2374
14607,16750,8372,178,672,49,363,524,199,8378
8234,42081,19634,252,979,429,125,1461,512,22447
12429,294,106,0,0,4,0,0,0,188
12457,893,401,0,39,32,0,0,77,492
2780,50264,24026,309,1470,406,221,1761,657,26238
7737,3939,1808,13,118,19,11,127,72,2131
1339,1428,662,6,24,40,0,38,33,766
27879,339,152,0,20,6,11,11,7,187
49051,2683,1276,77,27,36,0,85,123,1407
49111,3613,1924,3,96,39,9,148,49,1689
49262,1197,622,3,25,11,11,35,17,575
15675,1032,569,13,49,5,13,50,5,463
16001,39011,18770,168,1144,422,179,1089,451,20241
16025,5237,2639,31,162,99,42,139,39,2598
16657,1293,647,11,30,27,10,23,19,646
17728,5019,2480,8,128,93,5,88,94,2539
5359,488,255,0,20,7,0,1,9,233
12986,6071,3092,87,130,140,0,187,98,2979
22718,802,486,0,24,9,0,19,0,316
4478,309,121,0,0,23,0,0,12,188
13628,209,91,0,2,1,0,5,2,118
15379,106,59,0,2,0,0,1,3,47
21084,7583,3723,52,169,81,68,229,120,3860
25984,1482,816,0,50,21,0,52,36,666
85257,33369,17864,122,1365,342,221,1258,162,15505
85618,1954,1054,13,48,29,0,44,27,900
77583,36903,20830,55,2038,329,233,1543,403,16073
59853,702,399,0,22,22,0,35,5,303
18325,2157,1120,0,0,53,55,38,8,1037
25413,8431,4237,39,291,77,0,294,95,4194
25857,43,29,0,0,0,0,0,0,14
5736,542,241,0,0,0,0,4,0,301
8533,6604,3369,48,242,76,37,283,101,3235
10576,4891,2349,0,81,40,30,85,71,2542
11581,21275,10203,140,553,258,98,679,374,11072
28660,1878,917,0,18,11,15,43,20,961
29016,21259,10202,124,573,187,322,734,213,11057
23866,2100,995,2,95,17,42,59,21,1105
34201,3930,1907,28,80,89,0,68,46,2023
37033,7552,3602,18,144,133,59,111,145,3950
25033,2156,1153,0,79,0,9,43,11,1003
26160,669,322,0,4,11,0,0,10,347
43046,3812,1914,9,114,48,7,112,80,1898
39465,21187,10425,217,614,229,19,607,213,10762
46226,46110,20715,195,1408,419,309,1681,396,25395
29851,7328,3600,88,53,48,73,333,27,3728
26739,918,512,0,21,0,0,9,8,406
32811,41246,19480,296,1508,260,533,1814,257,21766
97462,3765,1826,67,30,112,4,94,112,1939
80132,20843,10622,80,720,211,114,572,321,10221
84041,51333,26224,358,2325,269,409,2093,455,25109
76388,255,136,9,0,2,4,0,4,119
76705,31230,15755,323,1002,335,223,846,467,15475
77485,4475,2311,75,139,59,36,183,89,2164
95228,4501,2316,0,74,83,11,48,118,2185
91107,32364,15883,129,1312,294,80,1215,429,16481
62480,470,237,0,2,5,2,6,18,233
62531,1764,926,5,48,21,0,46,7,838
56521,745,360,0,24,17,3,11,15,385
58627,143,79,0,0,4,0,10,3,64
66724,1058,519,3,23,10,8,23,28,539
61729,1201,614,6,33,4,12,42,21,587
20737,21787,10872,152,1047,141,124,838,201,10915
79088,5642,3054,12,241,105,0,216,41,2588
79601,27379,16636,453,1714,182,806,475,195,10743
66407,792,362,14,1,1,35,3,0,430
66419,370,181,0,9,1,0,1,1,189
66968,1540,762,0,35,12,0,10,22,778
67850,322,176,0,9,4,2,18,2,146
68735,780,362,1,16,8,0,7,25,418
75562,177,125,0,36,23,6,0,39,52
71998,384,384,95,0,0,0,0,0,0
63370,13,5,0,0,0,0,0,0,8
63935,9770,4838,79,235,53,7,324,132,4932
80652,330,184,0,4,0,0,3,0,146
82842,639,306,0,85,14,0,59,0,333
57437,1380,653,6,36,23,0,17,19,727
90266,35573,17503,43,1020,416,60,1341,444,18070
92201,65347,31487,319,2184,681,436,2365,633,33860
98252,9603,4930,119,326,79,0,312,163,4673
97219,42813,20653,273,1741,638,310,1888,753,22160
97331,2768,1229,57,0,0,16,6,0,1539
50108,466,226,0,7,8,0,2,0,240
67431,2081,1109,7,85,32,5,53,27,972
66833,507,264,0,39,10,2,22,5,243
60163,5161,2585,40,94,35,53,123,88,2576
99765,257,122,0,2,0,5,4,5,135
16051,2913,1464,12,50,59,5,121,49,1449
16250,571,296,8,8,8,16,0,0,275
18622,173,103,0,0,0,0,6,0,70
18847,5549,2873,50,120,83,41,137,102,2676
8078,8317,3921,17,243,75,76,336,141,4396
67490,942,468,3,7,40,0,36,29,474
68629,1232,591,0,23,4,0,34,22,641
68871,288,135,0,6,4,0,0,3,153
72017,540,271,0,11,10,2,11,6,269
62481,430,200,0,18,0,0,2,0,230
58281,138,64,0,6,0,0,0,6,74
60601,14675,7191,14,608,64,33,225,240,7484
72445,75,39,0,1,0,0,5,1,36
72449,298,157,0,14,4,0,11,3,141
72830,15539,7665,117,587,158,148,497,126,7874
73759,1565,796,15,39,28,5,16,32,769
80648,1243,620,0,28,20,0,42,15,623
80913,3753,3323,593,25,0,65,0,0,430
81401,22633,10950,183,590,312,83,598,466,11683
71251,9050,4628,65,410,112,105,305,110,4422
71711,81,39,0,0,0,0,10,9,42
71772,8,4,0,0,0,0,0,1,4
79548,178,90,0,13,1,0,16,0,88
65535,1698,738,0,35,1,13,65,11,960
66537,1067,544,0,31,3,0,24,15,523
72125,836,408,10,37,5,8,8,13,428
76063,71555,34600,408,2228,484,337,2905,711,36955
89013,363,145,0,5,8,0,17,3,218
92101,39313,22255,57,2470,533,119,1310,482,17058
95973,35445,17913,381,1257,280,186,1436,430,17532
3431,25463,11933,563,632,270,456,578,402,13530
5040,634,327,4,25,0,0,35,19,307
5677,2328,1200,0,35,32,45,56,55,1128
1863,9131,4408,75,246,119,84,245,132,4723
2035,17535,8486,104,598,235,63,416,269,9049
53020,3726,1843,19,84,62,29,76,92,1883
54143,15006,7557,137,507,225,77,459,199,7449
36901,327,201,0,0,40,0,0,23,126
21651,2735,1364,36,37,24,26,109,88,1371
23407,768,236,0,0,46,33,14,0,532
53534,12031,6126,41,342,124,62,189,135,5905
54101,2684,1316,10,69,35,8,65,33,1368
49255,2618,1346,9,106,19,10,95,18,1272
56371,105,55,2,3,3,0,2,1,50
72176,9808,4662,77,247,28,67,320,113,5146
49431,17415,8442,121,434,252,56,374,335,8973
70803,729,274,0,0,0,49,0,0,455
31012,3099,2234,48,252,36,2,41,74,865
31622,1972,878,0,72,19,5,89,10,1094
32359,1162,586,0,0,31,0,0,70,576
33567,12318,6094,175,304,47,47,524,54,6224
38542,17,8,0,0,0,0,0,0,9
43938,5320,2655,14,168,133,24,186,117,2665
36040,3584,1759,0,97,27,19,128,62,1825
26438,166,36,0,0,0,0,0,0,130
27876,1346,582,7,72,17,0,43,50,764
27935,1801,842,12,10,41,0,66,42,959
28032,3296,1601,30,178,0,7,97,54,1695
41006,4374,2206,17,200,34,43,71,41,2168
26133,1562,714,0,79,11,16,71,10,848
24966,1556,710,0,44,30,0,0,35,846
53716,18360,9177,122,675,203,70,840,365,9183
59214,98,72,0,3,0,0,2,3,26
74859,6032,2893,18,148,45,37,193,61,3139
13431,1773,897,0,36,19,6,49,47,876
77414,23989,11897,75,727,308,156,753,352,12092
77951,1880,896,0,63,0,0,45,0,984
49740,7004,3451,15,112,131,4,137,111,3553
78238,25052,11711,149,1057,237,194,1026,157,13341
50122,1358,691,0,49,3,7,40,5,667
79227,1431,723,0,74,17,5,50,12,708
27807,6415,3459,42,199,43,5,167,79,2956
59866,854,462,0,14,26,0,54,10,392
4275,374,175,3,1,8,0,10,11,199
63556,3982,1888,6,123,49,27,140,46,2094
5149,2090,1029,0,39,17,14,51,41,1061
7028,7685,3896,36,135,31,4,238,76,3789
88113,77,45,8,0,0,0,0,0,32
74748,659,356,0,15,18,22,22,0,303
75411,1278,695,0,0,30,0,8,24,583
72173,9104,4729,30,261,52,158,281,134,4375
72462,353,195,0,10,2,0,4,10,158
73002,906,439,10,23,23,4,25,19,467
73565,998,457,1,30,18,1,15,20,541
74055,45378,22287,257,1455,357,216,1366,580,23091
83283,210,159,33,0,6,0,0,0,51
13674,145,60,0,0,0,0,23,0,85
14824,471,261,0,17,5,0,5,8,210
17268,29426,14238,137,969,364,74,694,370,15188
32409,10191,4994,0,295,79,27,426,98,5197
33445,32261,15739,177,740,477,226,655,410,16522
24245,818,408,0,22,0,5,26,28,410
24343,9791,5030,72,281,159,59,212,156,4761
8904,13992,6666,89,415,99,86,672,103,7326
29593,1669,765,28,31,24,19,77,30,904
12420,318,210,11,47,0,0,8,0,108
12873,856,480,2,17,7,5,0,30,376
54519,1290,662,0,28,26,0,16,17,628
54934,514,284,0,10,3,20,0,0,230
55764,536,246,0,13,4,7,4,3,290
37412,21128,10629,116,873,363,123,535,272,10499
37829,1754,898,4,27,18,2,67,10,856
38054,271,205,27,19,0,3,21,0,66
13492,11268,5309,42,292,142,60,280,166,5959
19549,264,155,0,0,4,0,5,4,109
75218,21576,10227,30,796,333,60,627,323,11349
76365,4419,2303,16,160,76,22,76,48,2116
76654,159,67,0,1,0,0,2,1,92
77506,38568,19999,390,1410,143,195,1254,314,18569
64648,2298,1138,17,25,28,23,65,15,1160
68355,4894,2397,13,142,28,41,194,71,2497
69037,142,93,0,7,8,0,5,0,49
79032,76,45,0,0,0,0,0,2,31
70650,186,92,0,0,0,0,0,0,94
74036,7378,3541,26,185,59,60,223,70,3837
74083,1029,488,1,20,9,17,19,13,541
92590,4388,2206,42,20,13,15,112,51,2182
2813,7780,4073,33,124,112,63,138,147,3707
5361,1169,556,18,31,6,4,30,17,613
7088,3133,1238,6,97,19,71,98,43,1895
10112,0,0,0,0,0,0,0,0,0
1602,23854,11408,275,661,281,365,762,381,12446
2357,1126,614,80,6,0,83,0,0,512
65251,21734,11603,321,1156,346,139,694,223,10131
59425,3506,1690,1,105,45,8,93,84,1816
51646,716,423,0,20,22,2,16,5,293
23889,605,316,0,45,35,0,0,10,289
41091,20170,10419,41,681,248,46,553,270,9751
44854,1708,854,5,28,29,17,51,7,854
45613,2734,1322,0,70,38,2,44,117,1412
99651,13,8,0,0,0,0,0,0,5
54538,3024,1563,18,46,45,18,59,41,1461
56054,950,467,11,13,22,5,11,23,483
56759,254,132,0,13,5,0,4,3,122
64030,25150,12088,210,715,166,100,757,224,13062
48658,4968,2480,33,89,70,17,142,58,2488
49795,2006,1081,5,52,35,13,38,24,925
41030,5949,2859,11,137,79,23,338,75,3090
39159,3412,1583,33,43,70,38,213,65,1829
40218,34424,16856,140,984,278,248,1195,282,17568
40511,33116,17238,100,1601,214,124,1330,286,15878
54639,2578,1331,2,82,42,3,85,23,1247
87114,68676,33459,465,2307,636,390,2593,705,35217
97638,466,238,23,6,0,0,0,0,228
98112,25426,12709,102,1069,267,23,1044,285,12717
98421,1496,1364,27,238,0,0,36,0,132
94002,27202,13580,111,1331,305,99,1143,360,13622
2881,7836,3688,159,0,22,117,4,25,4148
6820,21759,10434,205,561,187,96,696,276,11325
7717,1761,779,6,15,21,0,42,38,982
2130,40377,18889,175,1745,282,198,1898,468,21488
25541,9934,4988,39,381,176,17,496,126,4946
36115,964,547,29,50,0,0,63,0,417
37807,10738,5389,52,344,170,40,402,287,5349
37849,27062,13481,138,857,317,145,1051,274,13581
38333,185,120,0,0,10,0,0,9,65
20137,1534,727,0,21,24,0,20,21,807
23868,7231,4182,147,330,78,61,225,254,3049
41263,442,208,0,20,9,0,9,0,234
32410,987,500,0,18,4,0,16,11,487
32462,3641,1807,38,118,30,32,81,30,1834
33178,51459,24256,389,2124,255,251,2344,424,27203
40505,25426,12526,85,820,288,135,883,385,12900
51365,338,113,0,5,7,1,4,1,225
53545,23500,11647,50,686,173,117,610,385,11853
53953,221,116,0,3,0,0,16,3,105
58772,151,76,0,0,3,0,2,8,75
59311,147,77,0,3,4,0,3,10,70
45121,9245,4568,46,253,118,48,352,99,4677
46072,8683,4214,94,293,49,7,274,121,4469
47457,170,71,0,10,0,0,9,0,99
66872,1030,528,6,14,30,15,21,8,502
67437,1052,547,0,38,31,6,28,14,505
67734,358,184,1,11,8,0,23,5,174
68664,358,188,5,0,4,0,4,9,170
62624,463,225,0,6,9,0,13,7,238
55357,3229,1551,0,66,30,13,62,30,1678
55363,4808,2511,9,283,44,5,202,55,2297
55364,15269,7832,150,384,104,56,415,127,7437
55929,1295,633,5,64,13,3,55,16,662
72901,20985,11053,253,670,321,206,558,282,9932
73749,414,207,24,17,7,0,0,15,207
75481,366,182,5,9,22,0,14,14,184
32664,538,306,0,0,20,0,7,7,232
33760,17260,8951,145,641,205,133,582,187,8309
1082,10586,5219,64,470,204,0,330,205,5367
34488,10499,5527,33,245,294,34,162,216,4972
36314,445,178,0,52,1,2,0,0,267
37354,17438,8891,70,614,244,118,493,267,8547
38363,5728,2883,52,233,130,70,117,50,2845
97541,1552,905,0,60,55,0,12,35,647
98526,235,111,2,3,7,6,2,7,124
98819,209,108,0,2,4,0,1,4,101
56255,377,195,10,13,7,3,13,3,182
56310,5425,2791,66,158,55,18,187,67,2634
57234,1352,702,11,34,6,0,17,18,650
59063,1951,1057,19,27,36,22,47,28,894
79068,3431,1596,27,58,34,0,93,17,1835
93262,63,32,0,0,0,0,0,0,31
87008,2550,1254,0,44,53,0,72,17,1296
92307,39273,19170,297,1152,368,243,1022,542,20103
66546,1219,634,0,36,21,8,17,79,585
67037,28364,13920,106,1113,257,141,977,332,14444
50217,636,345,4,41,5,0,14,18,291
56641,322,178,2,5,9,0,5,3,144
57005,11560,5726,19,487,67,70,525,144,5834
63541,346,193,0,2,2,0,16,9,153
64438,109,49,0,0,0,0,3,2,60
72857,1304,662,4,40,17,0,52,67,642
70051,1749,801,0,30,36,0,25,7,948
99159,1500,772,3,25,38,0,34,14,728
92123,31216,16041,409,1085,266,111,1182,266,15175
57027,112,80,0,1,4,4,0,2,32
58047,4107,2146,10,181,43,0,103,85,1961
58259,352,183,1,0,1,0,11,7,169
74543,388,224,0,11,0,0,0,0,164
49969,1271,603,2,12,25,2,24,11,668
52626,1236,642,3,43,4,18,31,12,594
53964,3621,1792,25,125,43,8,114,53,1829
63031,47419,21990,279,1272,382,146,1674,776,25429
70774,10507,5527,45,228,188,43,395,42,4980
71922,64,33,0,0,0,0,0,4,31
60505,77190,39022,723,3189,601,577,2972,686,38168
61731,194,87,0,0,16,0,0,0,107
61777,728,343,0,10,3,0,32,7,385
81435,5278,2804,36,178,91,40,135,94,2474
78662,2298,1006,0,27,63,70,24,91,1292
79339,6658,3417,49,200,104,25,235,79,3241
79759,16,8,0,0,0,0,0,0,8
96025,1957,947,3,26,20,9,26,37,1010
96706,72799,35949,372,3204,704,234,3042,520,36850
92882,71581,35682,498,2361,541,857,2566,877,35899
76264,1508,760,60,52,6,2,5,20,748
77504,23875,11528,182,623,98,125,802,236,12347
99669,16249,8018,70,366,206,81,476,163,8231
35646,4734,2376,29,98,29,40,165,36,2358
92341,203,109,0,0,0,0,0,0,94
39041,3570,1629,0,91,52,0,127,85,1941
46777,6455,3110,95,204,56,44,239,103,3345
94950,134,72,0,0,0,0,0,0,62
95703,938,455,20,0,31,0,0,0,483
97429,838,447,6,27,21,0,22,34,391
90601,33058,16097,202,1054,432,162,1099,325,16961
93549,264,151,0,0,18,0,0,14,113
87005,405,233,0,0,0,0,0,49,172
87801,9744,4958,94,396,86,102,191,88,4786
88230,4880,2440,39,214,22,19,145,67,2440
98850,1881,995,37,113,4,6,55,17,886
624,22707,11110,167,790,265,274,718,273,11597
55375,4968,2296,58,160,52,71,196,59,2672
55434,30559,14954,120,977,385,55,1050,540,15605
56331,2221,1164,6,77,21,1,58,14,1057
41607,471,239,0,0,0,0,0,0,232
41647,1707,870,0,32,44,0,20,61,837
43903,2108,1036,2,89,29,20,101,28,1072
32808,57443,27399,567,1676,514,529,2062,281,30044
32966,17868,7857,187,216,253,57,489,305,10011
33634,22733,11068,46,683,177,177,898,208,11665
82052,12,6,0,0,0,0,0,6,6
82510,433,208,0,8,2,0,10,4,225
64487,671,352,0,25,22,4,22,19,319
65623,21,3,0,0,0,0,0,0,18
66408,486,232,0,29,0,0,1,1,254
75859,1815,802,13,21,34,0,6,4,1013
92804,88749,43455,660,2999,706,733,3122,1124,45294
93306,73401,36616,296,2541,516,743,2053,840,36785
98588,1390,785,0,34,53,0,17,128,605
87113,15521,7604,212,424,116,309,636,91,7917
89101,41600,23655,282,1534,455,278,1241,382,17945
89821,468,187,0,14,0,0,9,6,281
90280,95103,46470,646,3265,816,794,3558,1256,48633
95823,79272,38277,586,2616,600,746,2391,869,40995
6263,251,87,0,7,0,0,7,10,164
31082,9636,4361,110,264,81,62,106,115,5275
31763,24186,12328,41,907,244,28,958,319,11858
32640,10790,5293,135,220,84,0,328,203,5497
24340,6096,2848,59,231,59,56,207,117,3248
24483,579,332,0,0,0,0,17,14,247
14816,604,312,0,16,0,0,3,0,292
3087,14508,7334,130,372,149,18,360,138,7174
95932,7742,4026,33,240,115,70,328,101,3716
87035,7624,3926,29,384,116,80,244,82,3698
96727,5270,2544,26,173,90,49,79,77,2726
97473,309,130,0,18,15,0,17,3,179
92222,0,0,0,0,0,0,0,0,0
66514,1037,551,0,89,5,5,47,11,486
64656,270,134,0,5,3,0,6,0,136
65085,1259,578,0,56,10,0,68,3,681
85286,42979,21631,168,2081,244,204,1840,312,21348
85325,1243,647,0,14,40,0,13,4,596
60542,18125,8825,80,629,230,52,572,349,9300
61842,2727,1345,5,97,43,0,95,14,1382
78266,6633,3275,0,319,105,41,294,90,3358
79353,52,28,0,0,0,0,0,0,24
63079,24,24,0,0,0,0,0,0,0
68522,13359,7244,124,512,120,199,546,61,6115
38650,3989,2063,93,86,38,0,42,57,1926
38862,2237,1058,0,28,10,0,76,37,1179
56058,5729,2868,26,249,60,6,220,73,2861
37715,733,331,0,7,7,16,43,17,402
14471,2651,1321,41,92,25,87,31,29,1330
14817,2556,1323,39,48,28,49,46,20,1233
30506,44468,21788,309,1439,479,249,1469,573,22680
31058,1361,685,10,22,26,1,39,0,676
31620,10836,5277,67,303,65,176,424,155,5559
32568,2735,1414,0,27,49,0,96,113,1321
33169,41525,19311,224,1129,355,281,1736,730,22214
23874,831,366,0,40,23,3,21,22,465
24076,1330,744,33,13,20,0,43,16,586
28665,2377,1158,0,56,37,0,63,11,1219
30087,40003,18567,150,1428,350,257,1347,903,21436
28073,5366,2845,21,54,79,55,160,82,2521
12203,31251,14845,773,851,266,677,749,282,16406
5495,10148,4834,87,240,104,0,394,250,5314
7034,8964,4570,0,407,115,50,279,53,4394
7601,44381,21460,202,1728,580,323,1618,626,22921
7880,263,171,0,0,0,0,0,0,92
1220,8209,4162,83,294,157,14,240,142,4047
34446,16647,8019,46,156,377,188,276,270,8628
35045,14778,7116,37,328,229,200,426,252,7662
36080,2084,1117,5,76,23,0,35,6,967
93040,2007,929,4,62,20,31,64,59,1078
95304,14539,8530,232,534,116,118,293,294,6009
98642,19285,9598,39,603,276,58,601,225,9687
84628,523,279,0,18,0,0,12,8,244
81231,680,424,19,0,0,0,0,0,256
96034,236,100,0,4,3,1,0,7,136
1522,3176,1560,46,105,50,12,122,55,1616
37881,2135,1060,10,72,23,0,76,19,1075
39747,1580,785,13,8,13,10,22,24,795
57792,176,86,0,0,0,0,13,0,90
58451,171,92,6,3,1,0,7,0,79
59240,31,10,0,0,0,0,0,0,21
54835,929,498,3,40,12,0,17,13,431
55333,825,438,4,10,8,3,12,17,387
55437,18183,8892,86,490,129,46,409,240,9291
43927,124,49,14,0,9,0,0,0,75
45820,488,239,0,15,10,0,17,8,249
43558,12662,6480,14,250,225,73,295,241,6182
60490,22202,11270,130,706,188,149,786,178,10932
31821,263,116,0,0,18,0,0,0,147
21555,1541,799,13,47,29,15,0,8,742
22548,440,203,0,0,0,0,34,0,237
15074,7952,3872,18,286,119,38,325,116,4080
12957,1899,1024,0,68,10,4,83,17,875
13063,1988,1023,22,51,27,5,27,13,965
34215,560,255,5,15,20,27,0,18,305
19406,24187,12071,155,1091,224,144,713,268,12116
28587,353,199,0,0,23,0,3,5,154
97017,3405,1664,25,87,77,11,123,70,1741
99029,1058,538,7,37,23,0,28,7,520
18430,6,3,0,0,0,0,0,0,3
33351,35581,16052,234,1175,265,123,1310,498,19529
33503,204,110,0,0,0,6,0,0,94
35148,2444,1115,7,82,15,9,69,3,1329
27587,66583,31829,212,1942,582,216,2546,759,34754
7424,26948,12795,254,815,213,255,826,443,14153
8350,629,232,0,14,0,0,0,0,397
1527,13630,6787,309,377,87,79,522,135,6843
72311,117,49,0,8,0,0,0,6,68
72367,52,40,0,0,0,0,0,0,12
72908,13698,6252,68,416,78,80,559,216,7446
50174,1446,762,2,17,18,10,48,24,684
78376,655,410,0,39,7,0,13,9,245
78962,5239,2753,74,181,96,0,176,81,2486
95357,11322,5788,35,510,145,48,416,143,5534
95380,42672,20719,319,1403,302,372,1529,353,21953
97064,3241,1736,0,135,40,0,72,41,1505
84314,1238,651,9,39,20,0,44,22,587
39443,21962,10917,22,990,118,89,668,393,11045
40121,8965,5006,199,616,0,131,347,15,3959
66619,2936,1410,28,88,99,44,156,9,1526
77043,25447,12640,163,996,187,229,1063,356,12807
80802,322,130,0,3,3,0,16,4,192
60645,47732,23740,159,1777,446,167,1708,693,23992
62627,1029,519,0,16,12,13,34,14,510
63126,14781,7146,42,564,134,8,473,255,7635
72677,389,186,0,5,0,4,0,3,203
73111,11368,5027,72,260,187,19,471,173,6341
23138,534,322,17,0,0,0,0,25,212
24873,638,343,0,29,32,0,45,15,295
25244,590,324,0,0,17,0,0,15,266
13681,885,421,7,33,18,0,12,16,464
14445,7875,3983,36,142,72,108,195,121,3892
22432,213,131,0,18,0,0,17,0,82
7901,23335,11316,56,825,168,95,886,220,12019
8757,33999,15045,235,615,483,69,503,490,18954
10952,41834,20369,334,983,295,144,882,259,21465
18641,6623,3159,7,120,86,35,87,96,3464
19710,0,0,0,0,0,0,0,0,0
28697,13638,6399,54,340,189,71,383,143,7239
51549,532,260,1,33,20,1,19,19,272
53044,2369,1135,8,36,39,5,89,28,1234
55322,3505,1727,7,103,32,18,115,68,1778
39169,2586,1162,8,70,17,8,74,34,1424
10463,71360,33641,436,2004,1025,531,2563,1019,37719
13112,1843,952,39,25,9,0,44,44,891
16260,289,135,0,14,5,0,15,15,154
17519,7147,3576,66,230,116,15,226,93,3571
76010,57668,29557,891,1796,283,693,1638,384,28111
77536,33015,16458,323,1231,320,240,1154,431,16557
77538,1030,562,0,60,2,0,14,14,468
67901,21826,11130,206,751,145,91,619,323,10696
75203,17301,9156,210,619,153,50,448,173,8145
62664,3061,1532,10,123,55,8,50,20,1529
62838,1816,855,82,54,20,0,25,15,961
65557,114,69,0,0,0,0,0,0,45
29074,112,70,0,0,14,0,0,12,42
54411,5219,2733,41,178,63,23,154,68,2486
18976,20639,9726,66,508,171,160,424,321,10913
21005,2723,1597,69,91,0,5,96,18,1126
50571,406,197,1,13,2,0,5,4,209
85746,44823,21467,299,1306,314,418,1600,501,23356
78231,8536,4087,57,240,208,18,147,168,4449
78339,330,197,0,21,0,0,0,0,133
87571,12132,5916,169,320,234,62,428,219,6216
91505,30680,14874,275,1143,152,250,1313,444,15806
92584,51298,25464,176,1615,375,235,1954,611,25834
14867,5548,2752,73,104,108,39,174,230,2796
14869,1302,692,14,80,21,0,17,15,610
15753,463,242,0,14,7,0,16,6,221
16427,149,75,1,1,0,6,2,0,74
16865,1785,882,0,77,19,0,44,4,903
23803,38654,18729,230,1334,471,261,1011,698,19925
3819,4498,2272,34,159,65,45,115,60,2226
12466,2402,1249,0,104,14,0,76,17,1153
13418,324,182,0,3,0,0,39,3,142
18360,27084,13847,162,425,464,268,717,532,13237
30175,5544,2651,33,169,85,50,107,89,2893
25550,8482,4164,16,334,28,45,313,85,4318
43005,201,86,0,0,0,0,0,0,115
43044,4866,2616,12,158,24,0,153,95,2250
95421,1681,836,4,49,34,6,53,42,845
96751,69,35,0,0,0,0,0,0,34
98333,3692,1780,0,84,45,24,116,61,1912
80801,120,64,0,0,0,1,0,9,56
82725,630,339,0,0,0,0,23,13,291
74836,211,129,0,32,0,12,15,0,82
74955,15122,7620,60,447,169,51,407,179,7502
76861,1927,1009,33,59,28,6,35,22,918
66039,591,293,0,22,16,2,44,13,298
67452,127,55,0,7,2,0,0,6,72
68771,1483,725,7,40,9,0,25,24,758
68815,598,296,0,9,7,0,16,1,302
68978,2153,1007,0,48,23,12,45,23,1146
56438,2922,1511,39,81,26,4,97,42,1411
58482,990,532,15,17,8,0,20,13,458
59071,179,72,0,1,14,0,17,0,107
59929,257,161,0,7,0,0,8,8,96
60469,5780,2811,90,117,12,67,206,54,2969
51008,134,58,0,4,3,0,3,0,76
62935,1799,984,7,66,43,6,67,45,815
64688,574,286,4,6,17,0,24,2,288
47032,3208,1832,20,98,11,0,89,82,1376
70591,5863,2956,0,181,78,21,185,72,2907
55708,696,389,0,7,8,0,17,6,307
60511,1932,1107,5,54,38,5,41,39,825
61535,1697,966,0,47,0,0,45,0,731
29669,12058,5852,97,259,152,120,312,169,6206
41843,564,224,0,11,16,0,0,8,340
37922,36224,18042,82,1330,326,108,1400,566,18182
39470,11799,5632,57,459,181,58,305,93,6167
25262,829,384,0,31,5,0,11,0,445
25825,2312,1191,0,53,10,0,75,52,1121
32343,3301,1532,0,134,19,52,190,33,1769
73050,958,366,23,13,0,65,3,0,592
74563,1963,1007,24,88,36,11,66,18,956
80930,1995,1058,0,133,0,16,99,26,937
81601,15666,7690,76,459,221,87,710,263,7976
83285,120,47,0,0,0,0,8,6,73
85608,4978,4978,72,815,10,0,0,0,0
95076,86703,44315,793,2668,735,522,2465,1166,42388
95543,664,319,4,0,9,0,12,26,345
16140,20,7,0,0,0,0,0,0,13
5653,466,251,0,0,2,4,11,26,215
7885,10052,5035,62,333,143,57,233,131,5017
10941,13176,6782,123,439,62,119,306,139,6394
36420,10369,5101,93,299,81,21,273,221,5268
36559,99,52,0,0,0,0,0,0,47
36913,19,9,0,0,0,0,0,0,10
37641,9407,4425,46,236,193,57,248,172,4982
46150,934,520,0,85,36,0,11,10,414
46173,10093,4789,42,306,136,93,416,118,5304
62373,294,142,0,20,0,0,22,5,152
71866,599,257,4,22,20,0,42,0,342
70737,43652,21629,223,1723,426,174,1353,662,22023
99695,0,0,0,0,0,0,0,0,0
7731,38483,19383,213,1017,395,146,1068,330,19100
11434,65791,29219,426,1662,507,356,2413,929,36572
12526,3639,1864,8,156,22,15,116,63,1775
17070,15722,7727,83,597,225,65,478,274,7995
17101,1865,1081,14,64,18,35,0,0,784
907,16202,7880,76,429,202,124,241,205,8322
1542,2314,1148,0,91,18,0,119,44,1166
39426,18193,9185,159,583,368,51,390,434,9008
39743,1345,544,0,25,9,6,28,14,801
28226,39631,19075,91,1223,547,179,1484,480,20556
49628,167,66,0,3,0,10,5,0,101
49896,1713,856,25,58,25,32,60,23,857
50845,861,426,0,35,22,0,5,1,435
68336,537,238,0,15,4,0,28,11,299
62561,5350,2511,76,146,53,35,253,82,2839
56258,15503,7613,97,505,199,174,449,221,7890
57324,345,166,0,11,6,3,11,14,179
58631,1166,591,9,37,9,12,33,23,575
60102,32739,16010,153,1051,204,183,986,685,16729
60419,22644,10287,97,625,174,181,877,522,12357
60458,15288,7105,101,498,141,21,665,205,8183
61272,1198,617,0,46,10,3,35,10,581
62048,1829,919,2,69,0,0,40,30,910
48210,29930,15351,106,1107,179,261,842,202,14579
49103,10612,5416,124,386,159,68,377,97,5196
49250,6252,3172,36,208,58,38,187,82,3080
71034,342,187,0,5,0,0,27,0,155
71331,1045,575,0,72,40,0,24,11,470
71758,383,189,0,0,0,0,20,0,194
55744,20343,10279,100,661,290,184,703,275,10064
72769,1172,666,0,11,14,0,23,27,506
55066,18192,8941,64,516,267,105,478,342,9251
55386,7646,3840,22,239,59,25,236,175,3806
56435,2499,1252,3,66,47,17,41,37,1247
55780,214,100,4,7,0,0,6,0,114
55971,2937,1533,19,77,65,6,78,42,1404
36509,2076,996,49,22,5,10,41,52,1080
40939,170,102,0,0,0,0,0,0,68
33069,27612,14670,176,1048,219,185,976,384,12942
46933,6164,3149,60,215,81,0,287,154,3015
47348,9226,4491,57,233,106,39,293,125,4735
41649,2205,926,9,124,20,24,43,23,1279
48201,15954,7288,212,355,250,329,419,208,8666
48852,162,87,0,0,0,0,4,1,75
14092,11083,5162,48,285,150,17,270,246,5921
16033,6178,3148,37,178,87,33,141,124,3030
17221,581,251,9,15,8,0,16,12,330
17366,5332,2575,0,225,68,12,310,66,2757
4693,393,182,0,22,27,0,18,18,211
23709,689,512,76,52,0,40,0,0,177
25540,129,35,0,0,0,0,11,0,94
20135,3177,1609,0,50,61,0,77,64,1568
20623,2934,1579,12,156,36,0,105,80,1355
22314,33926,15943,47,1596,427,62,1661,514,17983
33147,47834,22855,298,1260,362,285,1144,499,24979
33875,10928,5242,0,343,65,0,339,145,5686
34140,437,146,0,0,0,0,0,0,291
46345,177,111,0,3,1,0,3,3,66
46524,2353,1226,4,58,33,3,25,12,1127
47137,1607,807,1,41,14,0,40,17,800
48009,21066,10025,15,618,265,23,673,368,11041
48205,33953,15863,270,1273,265,179,1082,355,18090
49508,40830,19492,210,961,383,153,1595,826,21338
13210,28234,13273,859,493,156,1419,474,198,14961
32169,10502,4856,0,136,226,38,155,252,5646
23347,678,330,0,35,2,0,33,38,348
23433,1129,586,6,34,33,6,20,59,543
12412,562,234,0,0,45,0,0,0,328
29018,2971,1446,0,105,33,28,94,100,1525
91915,31740,15382,124,1476,86,156,1603,213,16358
93706,40936,20516,330,1284,434,288,1145,362,20420
88120,221,112,0,14,5,0,9,1,109
90242,42553,20394,332,1886,305,460,1500,410,22159
95382,38343,18476,390,1362,273,176,1355,390,19867
85309,681,598,36,0,0,44,0,0,83
97520,25030,11416,179,412,429,206,591,603,13614
98675,6888,3856,30,243,72,14,120,114,3032
8270,8296,4472,71,218,145,59,288,174,3824
11507,7286,3669,31,163,100,47,216,161,3617
3766,9392,4599,16,366,60,27,324,95,4793
4979,884,442,21,35,17,7,29,30,442
683,30424,14668,299,595,430,255,807,366,15756
1255,972,527,4,15,21,0,28,36,445
37366,852,414,0,14,22,0,24,24,438
23845,457,229,18,0,0,0,0,0,228
21155,2584,1163,0,74,31,0,62,75,1421
29067,11093,6389,150,556,105,30,229,141,4704
29554,8582,3990,0,179,158,0,366,131,4592
78217,33960,16898,313,1115,353,280,1042,399,17062
80469,366,165,0,0,8,0,17,6,201
72435,368,175,1,1,2,0,11,6,193
99363,370,194,0,0,0,0,0,9,176
93726,43209,20873,391,1545,415,776,1214,320,22336
94104,546,372,0,49,1,0,9,31,174
84779,600,304,4,14,18,5,32,6,296
76864,822,513,0,7,9,0,11,4,309
77619,15760,7837,102,445,39,116,548,251,7923
42757,2863,1440,0,74,18,7,83,29,1423
63116,44290,22302,264,1612,431,157,1525,603,21988
54660,16062,8331,37,598,204,111,438,232,7731
56013,4277,2158,9,62,34,15,147,70,2119
56591,190,89,0,2,0,11,5,0,101
57438,1554,732,30,60,18,5,31,28,822
68038,1310,651,30,20,7,0,36,21,659
60014,48443,24343,381,1226,424,345,1563,577,24100
60135,6906,3556,46,149,20,21,184,86,3350
61732,2057,1034,16,67,38,5,60,46,1023
62019,393,189,0,24,8,1,10,20,204
62230,6279,2997,38,195,33,6,150,85,3282
56379,17017,8466,91,519,212,55,558,201,8551
62618,7398,3773,31,260,105,8,243,43,3625
1105,11957,6001,58,264,147,147,482,81,5956
2420,14496,7079,109,298,193,8,398,189,7417
38843,11908,5763,143,200,62,41,264,90,6145
44136,25776,12707,129,685,270,196,770,520,13069
46978,2012,1042,0,47,35,10,29,15,970
47150,47857,22846,293,1557,482,286,1462,709,25011
35209,27768,13006,264,1058,268,394,883,165,14762
35896,700,172,27,0,0,52,0,0,528
36069,1939,887,17,36,44,17,47,41,1052
37343,41655,19816,206,1506,428,126,1209,557,21839
33785,5515,2721,0,45,133,0,63,285,2794
63902,0,0,0,0,0,0,0,0,0
64011,3237,1652,0,117,36,2,28,106,1585
64117,14673,7173,31,761,78,111,538,121,7500
19139,44870,20080,313,869,300,520,1483,706,24790
56180,1206,645,12,25,15,16,25,9,561
56248,804,420,5,8,16,0,7,20,384
56520,3828,1868,40,92,30,33,109,59,1960
73487,156,94,2,2,5,0,3,3,62
50219,13568,6787,270,428,158,242,390,122,6781
53204,38321,19709,215,1485,190,313,1516,162,18612
45663,6162,3124,60,281,104,13,248,155,3038
46537,458,248,0,4,13,0,0,10,210
46936,5947,2809,25,60,94,16,112,106,3138
47119,11336,5579,53,388,147,92,246,209,5757
50171,2581,1335,12,80,41,0,39,29,1246
52050,479,222,9,17,3,0,12,27,257
52326,565,331,6,14,7,13,8,2,234
52330,656,317,0,11,9,0,31,30,339
52348,68,34,0,3,0,0,0,0,34
35117,5235,2529,67,262,98,29,179,19,2706
58244,118,59,0,0,7,0,7,1,59
58272,255,128,0,6,9,0,11,7,127
58765,553,309,11,25,2,0,32,0,244
59922,2136,953,67,20,22,1,12,64,1183
38702,30,14,0,0,0,0,0,0,16
40509,40186,19693,167,1696,327,111,2019,531,20493
40927,364,180,0,19,8,0,36,8,184
40953,618,405,0,32,0,21,8,11,213
49305,2064,1069,11,64,40,0,43,38,995
43469,2948,1429,7,87,28,0,86,24,1519
29918,5711,3194,33,401,119,0,57,62,2517
29932,221,79,0,7,4,0,6,2,142
31063,4928,2296,54,146,23,56,207,96,2632
12979,2223,1121,8,82,36,7,83,27,1102
13452,4553,2265,8,136,69,4,176,71,2288
16623,590,273,0,24,2,0,25,9,317
24445,2735,1428,14,44,1,6,113,60,1307
24448,257,133,6,8,3,1,4,2,124
24503,19481,9205,153,381,213,196,638,469,10276
1921,8270,4036,20,100,177,107,205,193,4234
2111,7926,3727,81,186,88,77,284,105,4199
4015,3824,2025,22,46,86,12,102,55,1799
4231,279,133,4,6,3,4,4,2,146
4468,9156,4652,164,211,158,116,267,108,4504
8846,13659,6832,102,393,91,0,375,87,6827
10532,4968,2485,18,166,55,12,111,64,2483
5737,922,482,11,30,21,4,29,22,440
7663,13918,7001,92,359,158,30,315,170,6917
1050,2422,1270,15,42,40,0,58,35,1152
52561,944,473,8,27,12,0,38,4,471
58621,1357,634,0,20,42,20,12,32,723
61844,715,309,0,5,11,3,18,24,406
65745,3046,1540,17,118,21,0,40,34,1506
65755,486,193,0,4,39,0,4,5,293
66020,1620,846,0,35,51,0,20,20,774
68442,294,149,0,11,19,0,5,5,145
76523,0,0,0,0,0,0,0,0,0
78829,1274,622,0,12,22,0,7,0,652
78942,8629,4414,13,231,130,0,347,88,4215
79255,631,348,12,26,3,3,7,17,283
62844,2186,1088,0,75,24,11,52,13,1098
63115,18213,7882,175,465,143,167,486,281,10331
72396,13130,6294,72,425,53,41,382,181,6836
84742,213,108,0,1,23,0,6,29,105
98394,1342,711,18,59,65,0,9,10,631
98607,31795,15817,201,1086,393,175,1242,402,15978
80810,1231,598,1,15,2,13,51,5,633
93260,228,115,0,12,15,0,0,8,113
54943,1947,940,4,36,48,0,52,47,1007
29166,849,444,2,0,12,0,8,4,405
55057,25091,11998,454,571,301,839,651,290,13093
37665,5640,2935,32,100,94,0,244,93,2705
45002,13865,6599,35,451,168,75,493,165,7266
30177,1427,826,0,20,16,9,47,0,601
45305,11161,5432,42,492,174,89,400,144,5729
5769,1115,600,0,18,20,19,29,18,515
1085,41942,20243,470,1232,472,532,1361,661,21699
1340,1808,869,4,31,39,0,49,55,939
26035,2030,911,0,42,40,0,18,117,1119
36279,2339,1219,56,12,36,0,20,49,1120
37020,5820,3011,8,209,41,90,227,48,2809
21787,10186,5345,118,268,94,36,249,102,4841
22560,6454,2915,8,155,56,14,178,123,3539
22812,9026,4212,129,183,40,244,156,142,4814
21075,32496,15893,152,1392,129,76,1402,312,16603
28668,314,135,1,10,0,0,0,22,179
28786,20821,9947,74,436,415,115,507,232,10874
29650,34886,17246,66,930,322,131,1118,541,17640
24256,3556,1838,35,158,18,61,98,65,1718
78615,1229,675,14,11,12,0,25,30,554
79358,1088,552,6,65,11,4,28,20,536
82433,957,523,15,22,22,3,27,16,434
72567,321,202,0,15,0,0,8,0,119
74068,14,6,0,0,0,0,0,0,8
87040,469,231,0,10,6,0,12,0,238
89113,30626,15147,93,1302,276,145,1306,421,15479
90056,7795,3122,53,91,43,72,148,197,4673
98438,487,430,79,0,0,17,0,0,57
91356,30804,15103,209,1222,366,105,1086,493,15701
92663,21572,11235,133,609,226,242,611,208,10337
92832,25134,12649,288,856,150,233,1008,240,12485
74761,72,36,0,3,0,0,1,0,36
83650,564,300,8,36,16,6,21,19,264
43036,270,142,0,14,10,0,1,7,128
61041,959,454,0,27,28,3,24,34,505
56032,269,154,0,8,0,0,6,2,115
57785,9054,4547,72,236,139,47,143,106,4507
46126,5217,2499,26,249,52,4,170,92,2718
46142,29871,14164,212,984,296,244,896,363,15707
46504,3669,1795,9,81,11,0,147,45,1874
47535,823,463,0,0,9,0,29,0,360
48455,8142,4151,99,136,104,73,185,171,3991
49724,1187,569,16,3,6,40,28,15,618
1886,24194,11862,173,570,226,153,580,273,12332
56311,757,374,0,40,10,6,18,2,383
72721,378,165,0,0,5,11,12,0,213
73005,9585,4904,56,342,30,60,220,123,4681
97711,45,19,0,0,3,0,0,0,26
98424,11373,5842,87,408,41,63,452,100,5531
98430,0,0,0,0,0,0,0,0,0
92372,6282,3115,0,133,66,108,96,84,3167
87511,2896,1177,0,49,5,2,52,0,1719
90275,42421,20180,118,845,488,162,1131,656,22241
39088,92,41,0,4,0,0,0,0,51
45053,3690,1958,18,91,33,13,68,14,1732
45251,22502,10476,133,806,219,45,592,417,12026
33901,20950,9908,134,572,212,62,629,277,11042
52207,436,233,0,20,12,0,4,0,203
37025,5820,3312,60,99,151,33,151,43,2508
18451,783,427,27,25,0,0,0,28,356
71644,5313,4943,81,863,62,0,9,17,370
48202,16049,8171,191,302,230,222,359,261,7878
56253,1181,624,0,16,15,8,14,4,557
41764,736,320,0,27,0,0,10,0,416
49668,3315,1724,25,94,36,14,53,55,1591
52550,429,199,0,8,13,0,0,1,230
30467,12070,5899,209,333,181,89,384,190,6171
21644,77,39,0,0,0,0,0,0,38
13224,8296,3953,88,206,66,29,216,137,4343
15102,29580,14259,150,731,400,215,890,604,15321
33064,61397,31532,517,2321,586,264,1734,930,29865
33565,17311,8685,158,623,206,78,458,432,8626
23704,17920,8803,39,589,178,60,646,268,9117
1754,10600,5299,39,309,80,20,316,117,5301
751,21009,10095,216,584,139,104,624,224,10914
13782,665,294,0,12,16,0,15,17,371
32321,6277,3983,81,214,99,26,271,138,2294
33763,20195,9533,134,462,303,97,399,317,10662
22315,29110,14348,70,1289,300,78,1388,364,14762
23129,632,288,0,6,11,0,16,0,344
24085,2088,1108,0,63,9,27,28,38,980
35063,3671,1947,0,63,25,8,93,122,1724
12144,20272,9916,118,609,201,70,812,241,10356
3809,3660,1840,0,221,0,0,127,64,1820
11558,8217,4505,59,303,132,16,277,276,3712
48381,13384,6224,53,249,149,104,350,314,7160
43025,5100,2603,33,162,121,74,107,59,2497
44117,9611,4089,89,289,89,79,377,172,5522
46303,14644,7370,128,432,130,150,457,299,7274
37411,17006,8157,93,647,227,63,519,289,8849
38673,714,366,0,30,14,3,2,0,348
90022,65890,32317,416,2280,525,429,2282,589,33573
54720,7607,4000,96,275,38,20,211,62,3607
61037,55,26,0,0,7,0,0,0,29
62426,873,435,0,4,20,0,13,12,438
62462,982,488,0,47,13,0,44,1,494
66610,10777,5402,23,354,120,32,511,131,5375
68132,14569,7337,246,619,130,144,469,118,7232
74522,266,121,0,11,9,0,12,25,145
77028,16721,7999,77,440,114,185,584,212,8722
78572,80213,39361,463,2280,488,417,3231,1024,40852
79766,6815,3837,51,303,36,0,198,67,2978
72421,589,294,0,16,0,0,8,0,295
84401,38644,20235,250,1526,316,274,1294,368,18409
86429,7743,3616,9,137,168,5,162,123,4127
99637,527,271,2,9,2,4,6,4,256
96002,33901,15804,178,873,375,457,1048,424,18097
96023,1114,600,2,31,13,0,9,20,514
80426,83,58,0,38,0,0,0,0,25
80736,679,380,0,39,6,0,4,5,299
81301,30409,15112,207,1345,481,187,1175,491,15297
83451,1051,474,9,48,0,16,44,18,577
29332,2511,1253,33,61,20,20,33,19,1258
38425,3776,2848,58,465,17,6,68,88,928
39086,1273,571,80,43,11,0,72,0,702
40359,6572,3179,4,200,111,26,263,55,3393
45350,106,55,0,0,0,0,2,0,51
45681,1670,815,55,31,2,54,64,19,855
33019,14933,7608,30,362,240,20,372,236,7325
95224,166,65,0,0,0,0,0,0,101
98226,44406,21925,292,1655,506,532,1462,544,22481
98536,53,20,0,0,0,0,0,0,33
99341,844,414,0,14,6,9,17,30,430
99722,153,75,4,3,0,2,8,0,78
84020,47402,24330,322,2191,270,216,1604,284,23072
84123,38839,19787,368,1382,296,251,1248,404,19052
53128,9001,4725,38,299,69,51,300,133,4276
55951,1595,835,2,37,32,0,32,35,760
45619,7585,3752,31,382,96,15,250,179,3833
46162,472,265,0,12,0,0,22,0,207
49819,11,4,0,0,0,0,0,0,7
50438,4109,2018,15,142,30,0,142,48,2091
52229,782,381,0,26,2,0,19,2,401
60033,13681,6752,81,401,153,63,546,191,6929
62028,1279,637,35,18,3,57,10,13,642
63767,701,352,30,14,8,12,25,6,349
64083,22839,11025,48,606,208,49,686,302,11814
48765,728,386,4,9,9,3,5,9,342
30541,1580,784,20,32,14,0,23,31,796
31097,1656,815,10,48,52,2,18,32,841
31312,20297,10150,71,538,133,35,671,210,10147
32258,31990,15853,0,1499,424,208,1225,585,16137
49759,1513,741,7,11,24,3,19,41,772
28607,35523,17680,1569,691,282,1599,678,438,17843
50449,759,377,0,28,2,4,44,7,382
29666,6610,3038,6,132,135,41,203,82,3572
50071,1076,562,8,32,9,0,21,6,514
51532,726,338,19,16,1,3,16,1,388
52255,1560,798,19,40,11,11,29,13,762
53553,570,247,0,17,4,17,12,6,323
40997,352,205,0,13,0,0,8,0,147
43016,36260,18170,71,1380,286,67,1691,358,18090
43842,330,134,0,0,0,0,0,0,196
39322,1569,652,0,0,60,0,67,18,917
32137,43813,21056,191,1060,974,152,1161,824,22757
32826,36464,19048,696,482,215,992,659,171,17416
35013,40,40,0,0,0,0,0,0,0
35096,7610,3630,0,236,61,33,174,86,3980
45808,363,185,3,3,10,0,10,4,178
38311,849,372,0,19,6,0,42,11,477
16111,1301,670,18,30,28,20,43,17,631
16803,25901,13753,967,940,219,563,788,292,12148
17036,22618,10860,210,639,290,22,708,263,11758
18826,1515,789,10,47,32,15,50,17,726
28345,12107,5919,112,285,153,53,317,237,6188
28463,9741,5338,93,340,87,9,184,84,4403
29056,2187,1022,54,46,23,0,15,23,1165
29904,712,634,98,11,0,0,0,0,78
11575,16546,8027,167,514,71,168,611,101,8519
11789,8380,4153,23,172,109,45,363,231,4227
24871,241,160,0,0,0,0,0,7,81
92557,52089,25177,475,1689,590,442,1582,464,26912
92707,61026,31027,435,2451,285,675,2004,492,29999
97905,143,78,0,0,3,0,0,9,65
99144,25,10,0,0,0,0,0,0,15
99575,90,49,2,0,0,0,2,0,41
3450,921,473,0,29,18,2,19,33,448
3827,3171,1586,3,38,23,31,41,49,1585
60946,445,204,0,35,6,13,20,2,241
63012,10676,5430,82,303,101,19,113,178,5246
63013,1783,943,16,26,41,0,57,72,840
79902,20543,10046,258,614,240,286,575,290,10497
70714,19808,9697,195,738,126,139,495,255,10111
71921,3660,1868,0,91,11,9,130,55,1792
72949,9427,4585,0,286,152,16,213,142,4842
83406,18103,8933,71,711,226,106,797,206,9170
84639,1000,495,4,41,18,14,56,13,505
59925,1377,782,15,36,18,25,39,16,595
68967,887,491,5,29,32,0,20,7,396
65439,242,107,0,0,0,0,0,0,135
73008,20240,10236,279,474,197,171,581,171,10004
77036,76831,40384,640,3596,273,607,2604,564,36447
94956,1224,507,0,36,15,0,0,47,717
51579,2332,1206,13,61,25,0,39,9,1126
52639,2067,1051,40,86,20,8,68,16,1016
54841,313,148,0,15,0,2,11,0,165
55068,29474,14701,75,1146,189,93,1095,245,14773
36530,6939,3539,89,229,111,43,130,79,3400
36556,601,357,0,48,0,0,0,0,244
37878,323,192,0,0,0,0,6,9,131
40219,39537,19401,514,1073,385,464,1279,527,20136
47060,5869,3027,13,152,114,20,110,77,2842
59703,50,31,0,0,3,0,0,0,19
58779,491,291,0,18,3,0,10,9,200
51338,939,492,0,38,27,2,39,8,447
35441,1089,561,0,44,9,0,62,20,528
36313,240,147,0,0,0,0,27,11,93
43711,116,77,0,0,0,0,0,0,39
47987,4045,1992,22,116,77,11,103,40,2053
46235,32327,14383,165,1277,96,339,1287,313,17944
34953,69685,34259,680,1356,520,253,2668,778,35426
17024,2056,1089,12,75,21,0,60,21,967
17222,11602,5787,71,222,59,37,231,173,5815
32531,5735,2810,30,230,30,0,198,30,2925
32542,3081,1877,134,44,0,45,86,0,1204
33767,7714,3676,51,114,231,9,74,128,4038
24869,487,209,0,0,18,15,0,20,278
25432,121,44,0,0,0,0,0,12,77
28747,2243,1066,0,36,21,0,46,45,1177
18041,5299,2595,23,166,51,38,99,34,2704
18624,344,167,0,0,12,0,15,6,177
27509,6285,3703,203,187,39,32,175,120,2582
35128,10651,4980,143,407,138,25,304,163,5671
25302,14209,7147,74,459,177,19,615,247,7062
25904,406,230,0,4,0,11,0,13,176
917,18212,8658,95,345,236,90,518,285,9554
19535,10,5,0,0,0,0,0,0,5
44084,3749,1966,47,131,32,5,97,56,1783
46393,322,219,0,0,0,0,0,0,103
31807,3215,1544,33,146,0,0,203,45,1671
32701,21997,10298,94,724,222,52,661,318,11699
33624,38618,18437,314,1392,476,210,1213,440,20181
1020,30097,14803,222,757,481,236,895,543,15294
1966,7212,3051,0,108,124,30,95,135,4161
2053,13244,6181,54,343,79,69,416,222,7063
2562,3052,1547,0,72,48,78,81,67,1505
20910,42868,20746,83,2092,316,83,1772,610,22122
22203,24213,12134,76,1047,203,92,947,223,12079
24105,297,128,0,0,12,0,0,16,169
11735,33454,16443,337,821,376,253,879,449,17011
12068,3083,1507,57,67,35,48,121,25,1576
25174,562,383,0,11,48,0,10,0,179
25506,4976,2601,26,121,44,36,93,114,2375
37190,8430,3989,87,184,94,59,207,212,4441
18073,10293,5131,37,388,142,78,363,108,5162
30113,6649,3236,41,179,66,58,140,91,3413
95959,17910,9429,53,379,284,69,363,424,8481
15489,480,232,0,26,6,0,24,13,248
16740,1077,562,6,30,2,0,48,18,515
17552,19845,9667,133,735,250,83,695,179,10178
18424,5160,2601,33,87,107,18,119,70,2559
32358,1889,759,2,93,13,5,95,38,1130
34690,12028,5881,8,433,123,30,342,112,6147
24631,2522,1590,9,166,25,11,9,11,932
27850,7244,3608,0,161,174,0,323,97,3636
32087,5979,3757,14,445,92,54,183,19,2222
6081,1414,620,0,63,0,0,59,18,794
11791,26121,13074,132,842,214,93,832,419,13047
12604,603,290,67,0,0,87,0,0,313
49752,818,488,3,55,0,0,14,8,330
93004,30502,14689,130,1041,404,232,1113,529,15813
94074,197,103,0,0,0,0,0,0,94
86445,221,119,0,0,0,0,0,31,102
95211,1629,712,48,0,0,69,0,0,917
96050,418,233,0,22,9,0,7,12,185
75077,37080,18781,200,1200,316,136,1423,375,18299
75602,22159,11095,315,732,119,179,675,234,11064
69210,2188,1040,0,52,41,0,67,21,1148
84716,245,136,0,2,2,0,5,7,109
38668,14215,7189,111,395,165,82,406,154,7026
45732,4438,2238,13,126,105,14,129,31,2200
46311,21627,10565,179,562,319,165,595,406,11062
65438,2455,1096,0,100,0,47,37,54,1359
66863,29,10,0,0,4,0,0,0,19
67744,216,110,0,14,0,0,3,5,106
68346,516,277,1,6,4,0,9,28,239
68423,1130,554,0,20,24,11,22,18,576
76028,69413,33217,286,2687,768,314,2808,979,36196
80521,37076,18967,1284,850,198,1645,771,233,18109
81521,15781,7771,21,618,189,40,425,202,8010
83211,6141,3001,11,259,26,0,137,12,3140
84010,46327,23045,376,1292,322,226,1673,361,23282
85942,87,44,0,0,0,0,0,25,43
59601,31464,15113,263,1092,380,287,1058,521,16351
60417,15225,7529,35,377,211,44,405,311,7696
61361,1117,521,8,48,14,0,46,13,596
58006,423,196,2,4,2,0,9,10,227
78215,2974,1972,22,173,14,0,87,11,1002
72327,1908,921,0,95,34,0,41,15,987
73851,150,81,0,0,3,0,3,0,69
71753,16902,7642,244,204,146,225,750,289,9260
24412,25,11,0,0,0,0,0,0,14
24714,252,115,5,8,0,0,15,0,137
30753,7330,3598,40,276,45,20,293,69,3732
19979,915,473,0,49,1,3,18,23,442
20019,62625,27627,486,1514,418,417,2484,996,34998
21830,3808,1752,0,204,23,0,93,49,2056
8857,40335,19660,142,1123,368,144,1178,606,20675
10993,5433,2721,42,183,39,65,158,16,2712
11109,5981,2895,0,409,15,0,428,0,3086
28553,326,217,0,0,0,0,0,12,109
13402,1774,1138,77,35,3,0,12,22,636
52570,1104,606,2,28,4,2,45,8,498
53220,25879,12604,151,845,226,59,918,301,13275
54950,2901,1510,10,92,40,6,89,38,1391
36736,1371,761,40,39,0,0,24,0,610
10963,4276,2714,12,450,72,8,117,45,1562
76249,8550,4522,80,337,57,25,319,143,4028
77336,12424,5973,15,365,142,121,292,134,6451
65759,1454,708,11,28,35,7,52,44,746
72099,664,512,62,0,0,9,0,0,152
74533,846,401,2,13,6,2,38,6,445
42642,12423,5905,90,232,136,50,320,184,6518
44644,4949,2510,37,158,67,14,114,27,2439
56072,2162,1082,0,85,41,9,81,29,1080
47303,25545,12285,1082,335,242,830,587,211,13260
20024,13354,6159,50,863,137,49,623,110,7195
20744,54453,26893,412,1814,802,362,1639,1007,27560
50562,381,192,0,21,3,2,11,9,189
83235,91,54,0,0,0,0,0,0,37
84044,27454,13472,164,1215,103,190,1320,220,13982
78417,4558,2464,41,94,15,15,77,35,2094
61862,533,273,0,0,19,0,15,11,260
92281,2859,1387,19,50,57,18,44,43,1472
20139,203,124,0,0,0,0,0,0,79
24072,1067,536,0,14,72,0,19,24,531
4611,447,247,8,22,13,0,16,4,200
5487,1672,936,21,50,37,0,58,28,736
10969,1379,764,0,49,23,26,41,11,615
18230,113,47,0,0,0,0,3,0,66
38548,794,370,5,18,15,17,47,55,424
33559,17731,8429,65,557,85,297,507,148,9302
45204,5773,2863,85,156,67,66,237,63,2910
26431,5563,2645,21,170,132,48,204,58,2918
24237,922,347,15,9,6,0,16,55,575
25039,711,316,0,11,3,4,24,11,395
43434,61,33,0,2,0,0,3,1,28
28624,1339,614,0,82,35,0,51,26,725
29324,336,270,0,37,0,0,34,0,66
97204,1100,805,0,53,11,0,45,0,295
97543,646,333,0,11,0,0,22,5,313
82059,198,121,0,0,20,0,0,14,77
84051,461,250,7,14,4,18,0,7,211
75785,11265,6390,76,439,123,105,223,127,4875
75936,1095,547,4,32,12,0,17,29,548
76126,22825,11237,36,894,339,81,922,364,11588
76569,2297,1256,19,118,0,0,40,80,1041
77519,1129,494,0,44,0,0,83,0,635
67114,21586,10854,242,667,315,138,425,289,10732
67518,67,35,0,0,0,4,0,4,32
67837,954,513,6,23,17,3,12,0,441
68651,1465,716,0,29,12,7,48,33,749
57754,3788,2022,75,108,83,0,135,22,1766
58258,331,179,0,12,18,0,8,3,152
50076,1551,781,2,39,16,21,37,24,770
50527,224,139,0,3,0,0,14,4,85
51527,496,247,0,24,6,0,10,9,249
52001,43502,21230,678,943,390,237,1195,743,22272
62818,263,130,0,0,1,0,7,2,133
63464,13,7,0,0,0,0,0,0,6
63654,664,323,0,15,11,0,12,21,341
48915,10661,5066,32,315,57,84,334,82,5595
61027,77,48,0,0,0,0,0,0,29
28612,12338,6286,21,331,133,0,451,138,6052
34448,10620,5407,6,273,203,0,192,199,5213
36527,15262,7145,73,586,108,0,469,136,8117
30751,40,7,0,0,0,0,0,0,33
31650,3404,1695,32,137,47,6,168,22,1709
24210,16779,8326,91,567,208,27,591,315,8453
72107,170,101,0,5,0,0,0,12,69
72943,2173,1131,36,48,22,20,115,36,1042
75232,31941,14931,354,898,274,265,877,488,17010
80463,186,113,0,9,5,0,5,6,73
94938,790,387,0,103,0,0,54,7,403
95456,754,277,0,0,0,0,0,13,477
15840,2014,1004,15,34,35,10,42,39,1010
7820,36,36,0,0,0,0,0,0,0
8324,282,160,8,0,8,0,0,0,122
19426,40766,21854,287,1634,398,298,1035,591,18912
19717,4091,1876,45,0,0,82,0,0,2215
26050,1673,837,0,32,32,0,41,18,836
14742,276,129,0,0,10,0,0,0,147
14744,2268,1034,43,18,12,97,29,22,1234
4530,10891,5534,85,256,162,45,290,141,5357
1354,1608,863,5,85,32,6,72,41,745
74553,1249,615,14,25,13,4,43,17,634
76574,19026,9435,177,689,189,48,658,277,9591
77833,29737,14494,169,654,382,263,589,435,15243
81233,872,469,0,38,7,0,46,19,403
81637,8554,4594,48,224,312,12,445,6,3960
82844,18,9,0,0,0,0,0,0,9
98368,15848,7539,149,387,355,8,269,373,8309
95111,62392,31249,585,2080,495,405,1725,583,31143
92057,58347,28959,625,1935,405,532,1952,785,29388
93108,10896,5047,49,202,66,98,239,122,5849
28711,13398,6101,74,313,162,23,464,245,7297
32094,2254,1221,0,63,42,0,54,60,1033
43747,879,510,0,10,11,0,16,0,369
43787,3111,1601,36,44,35,27,93,75,1510
3779,807,400,0,48,10,0,20,19,407
4095,1181,629,7,25,19,4,35,25,552
4263,2233,1089,0,60,30,0,68,68,1144
24065,6536,3119,77,79,173,56,63,101,3417
16619,317,153,4,6,9,3,7,6,164
16659,301,147,0,11,7,3,3,2,154
16680,398,211,0,17,3,0,14,0,187
18020,21044,10310,91,499,351,117,421,395,10734
18342,523,256,0,0,0,0,0,0,267
18428,11996,6046,74,218,196,52,182,56,5950
14805,1080,551,3,17,10,0,28,12,529
92567,10228,5176,82,329,66,125,271,125,5052
93703,33000,16278,286,1040,204,433,990,528,16722
90263,1846,766,116,0,0,183,0,0,1080
62037,2205,1126,0,22,45,0,31,36,1079
62427,1690,795,5,83,11,10,87,3,895
63052,27400,13527,229,1011,168,180,1079,339,13873
63841,13094,6195,48,388,225,83,445,87,6899
63851,3818,1731,31,63,49,12,105,49,2087
78722,7110,3309,0,295,57,74,279,46,3801
80233,50478,25356,321,1929,355,149,2196,401,25122
80832,750,362,11,13,16,11,25,10,388
82845,29,14,0,0,0,0,0,0,15
83277,221,97,0,0,0,0,0,30,124
67209,13380,6486,117,503,92,73,334,175,6894
68431,286,168,0,3,4,0,2,9,118
70402,1904,660,104,0,0,142,0,0,1244
72762,39960,19728,287,1441,359,78,1681,575,20232
77058,16911,8617,285,485,118,85,754,137,8294
83544,6079,3406,34,214,133,16,119,131,2673
85226,38884,18771,190,1559,353,291,1685,589,20113
58365,237,123,2,4,7,0,17,2,114
56524,610,308,2,16,19,0,8,13,302
51346,2184,1002,14,35,34,9,38,41,1182
40461,3683,1898,0,232,62,74,85,45,1785
42021,1573,705,11,23,9,3,23,44,868
42060,0,0,0,0,0,0,0,0,0
42170,1645,758,35,58,12,3,42,22,887
32317,14665,7295,57,347,236,90,335,223,7370
35055,20884,9894,126,777,162,71,706,263,10990
45050,8773,4258,23,298,52,21,265,87,4515
45701,35704,17942,1959,923,361,1640,655,265,17762
61341,7999,3791,14,184,126,49,251,129,4208
61876,561,261,0,9,3,0,7,9,300
64118,42706,21434,160,1416,359,199,1469,683,21272
73036,20920,11161,167,1004,139,127,625,258,9759
73117,5680,2555,16,132,42,0,196,134,3125
78557,14022,7531,185,418,214,57,416,51,6491
75056,59211,29122,269,2845,268,220,2630,509,30089
77384,17926,8540,133,765,210,96,382,290,9386
64623,398,203,13,12,2,14,4,8,195
66007,7047,3482,18,333,107,76,256,48,3565
66755,941,440,17,29,12,0,33,17,501
67001,1508,825,0,43,17,2,34,10,683
58494,250,138,0,6,1,0,9,1,112
58571,490,251,0,8,15,3,17,10,239
17972,11238,5468,41,357,123,11,315,126,5770
18056,669,337,0,6,37,0,0,20,332
19344,11912,5691,98,337,133,46,266,230,6221
26259,53,43,0,0,0,0,0,0,10
2568,4103,2124,13,42,31,0,124,58,1979
31022,1715,805,8,84,30,5,44,31,910
32110,8009,3962,64,140,124,14,160,170,4047
32204,7507,3352,18,264,48,33,176,64,4155
23924,5962,2711,86,138,99,15,179,56,3251
8332,36119,17869,227,1356,341,345,1161,494,18250
11229,83615,40272,666,2319,1170,408,2986,1312,43343
20184,655,266,0,0,14,0,32,68,389
21667,235,141,0,0,8,0,0,22,94
21790,55,35,0,0,0,0,0,0,20
22191,70641,35035,367,3430,567,342,3209,957,35606
12927,262,138,0,3,8,0,3,24,124
81639,2361,1207,0,72,4,0,82,53,1154
82244,452,272,0,1,10,3,0,0,180
65679,2537,1284,9,122,29,18,66,11,1253
74930,2261,1111,22,61,37,6,101,26,1150
66224,13963,6930,86,372,93,66,443,148,7033
66611,10076,4810,25,322,113,71,422,168,5266
89145,24385,12337,145,673,307,120,583,571,12048
89405,145,55,0,0,0,0,0,0,90
70344,5646,2798,13,135,33,11,187,92,2848
97626,32,32,0,0,0,0,0,0,0
99371,402,200,0,2,5,0,0,8,202
97367,9431,4323,8,125,124,66,245,215,5108
93274,73778,36576,609,2176,480,506,2415,656,37202
61877,1803,944,0,71,19,17,100,21,859
69141,408,193,0,8,8,2,18,4,215
79701,30697,15585,168,1093,153,330,638,496,15112
64801,36279,17903,387,1200,558,310,1131,671,18376
56401,29575,14475,168,849,329,146,844,391,15100
63857,12352,6002,41,350,84,35,295,193,6350
72428,67,30,0,0,0,2,0,0,37
87830,1571,813,0,16,34,0,100,20,758
90034,55652,27996,214,2939,493,239,2339,451,27656
94928,44103,20803,461,1132,452,890,1216,675,23300
97734,3178,1615,9,59,33,36,117,29,1563
99401,304,174,0,0,49,0,0,0,130
99604,1101,574,9,32,3,3,16,15,527
95420,648,339,2,0,0,0,0,0,309
4575,70,44,1,0,0,1,0,0,26
4763,756,343,11,21,5,6,30,8,413
5489,3290,1733,46,47,32,5,91,97,1557
53088,404,203,0,15,6,6,9,4,201
53120,9422,4572,26,280,146,35,428,44,4850
55344,17097,8745,52,674,63,92,735,227,8352
42602,10111,5049,57,264,138,79,274,146,5062
47433,3902,1989,2,80,28,73,73,95,1913
2816,32825,15867,201,1172,313,234,936,555,16958
15531,4054,2092,13,96,77,26,104,79,1962
15533,1492,734,9,17,12,15,31,18,758
15560,184,86,0,6,0,0,8,4,98
60071,3581,1747,31,53,20,33,106,59,1834
60461,4917,2272,26,81,27,0,9,62,2645
60622,52793,27216,89,2824,281,164,2838,228,25577
61333,323,176,0,24,15,0,23,9,147
74747,187,67,1,0,3,0,0,3,120
76566,292,136,6,46,4,0,39,0,156
77095,71878,35719,619,2333,607,655,2566,902,36159
80487,18001,9330,165,890,244,26,683,325,8671
83433,4,2,0,0,0,0,0,0,2
89301,7901,4680,41,480,83,13,269,86,3221
78117,408,181,0,18,10,0,13,24,227
72672,282,145,0,15,0,0,19,4,137
65729,304,157,0,0,4,0,0,0,147
68023,2247,1189,3,65,20,0,46,36,1058
29075,3028,1608,23,130,44,71,130,19,1420
29617,28362,13585,169,1007,211,297,910,343,14777
29745,30697,14899,146,601,354,222,848,459,15798
10311,0,0,0,0,0,0,0,0,0
37387,3112,1529,9,103,71,5,108,49,1583
12572,8596,3888,32,153,243,0,167,215,4708
20664,3501,1734,13,116,39,0,126,109,1767
62965,88,32,0,3,0,0,3,2,56
64035,1104,513,4,43,6,26,43,26,591
23089,5366,2798,29,78,47,16,69,102,2568
71913,47060,22331,258,1034,602,199,1459,579,24729
57649,245,131,0,11,0,0,19,0,114
62906,6585,3376,7,144,70,44,204,69,3209
42035,990,519,5,48,5,8,37,8,471
64088,1256,662,28,77,14,0,54,8,594
70589,3377,1642,0,49,9,45,81,45,1735
23304,40,20,0,0,0,0,0,0,20
70762,902,477,0,17,21,0,23,0,425
4572,4993,2289,52,170,16,0,168,72,2704
65653,5981,2797,31,99,64,3,145,30,3184
15357,1337,636,0,52,52,2,68,38,701
84331,265,130,0,6,2,0,9,2,135
81253,445,218,0,0,35,0,0,7,227
83349,1258,692,4,56,17,12,50,5,566
14709,1450,794,3,32,22,1,41,27,656
16050,1488,731,7,49,11,4,38,34,757
16223,176,68,0,0,0,3,0,3,108
16422,468,231,0,23,0,0,7,0,237
30240,29114,13424,354,1022,354,368,906,414,15690
31783,883,394,0,8,10,8,7,1,489
24562,479,231,0,12,17,0,22,18,248
26041,15947,7674,138,594,175,0,512,238,8273
26250,5274,2628,20,131,82,9,134,47,2646
20117,2386,1054,0,26,40,23,41,86,1332
20155,35107,16888,112,1254,265,56,1394,251,18219
21814,603,308,0,0,0,0,0,16,295
28902,1377,708,0,23,23,9,26,21,669
29117,1056,561,63,0,0,60,0,0,495
29847,5506,3089,21,287,61,48,193,53,2417
12956,1370,729,7,13,0,0,36,39,641
13204,18728,9153,30,556,91,118,795,168,9575
53402,33283,16589,191,1028,472,95,1126,571,16694
37381,9105,4426,85,211,122,7,262,89,4679
38453,338,162,0,0,0,0,0,0,176
15611,738,464,0,2,0,0,37,3,274
7857,3237,1577,15,91,28,23,110,24,1660
10968,2363,1217,51,67,16,0,83,16,1146
11207,91972,41188,528,2655,494,694,3523,1304,50784
12754,6608,3399,47,155,52,80,173,82,3209
13833,3947,2123,105,66,20,0,59,60,1824
25545,4904,2409,14,181,59,111,163,61,2495
74936,1090,555,16,30,0,5,39,8,535
75068,61043,30190,249,3027,258,228,3332,435,30853
65810,22744,10956,24,633,276,125,632,311,11788
68516,44460,21703,438,1460,426,326,1604,653,22757
87729,29,16,0,0,0,0,0,0,13
79911,5732,2887,0,326,27,0,368,22,2845
70353,1480,902,0,21,0,0,0,22,578
71052,9090,4303,107,283,78,81,320,162,4787
10541,26656,13510,120,730,285,90,637,422,13146
685,38039,18624,294,1165,541,357,1261,751,19415
65605,12675,6084,42,242,152,93,401,256,6591
58856,107,62,0,0,3,0,0,4,45
53526,640,323,2,23,5,6,16,2,317
37338,3547,1890,19,216,89,0,107,88,1657
14724,2361,1208,17,71,11,0,42,41,1153
22960,10347,5194,86,438,175,141,424,61,5153
23843,552,334,0,48,37,0,0,15,218
43337,1149,526,4,13,20,5,19,69,623
98059,38362,19142,161,1885,380,170,1495,322,19220
54541,1227,550,7,46,20,0,34,29,677
54940,4000,2032,8,121,45,0,111,86,1968
57042,9338,4825,53,348,189,32,251,122,4513
63824,155,72,0,0,0,0,10,0,83
49068,14804,7224,78,338,148,100,375,273,7580
46241,31273,15167,329,1073,213,288,975,346,16106
49617,3196,1723,33,102,60,0,66,54,1473
41144,10268,5122,49,284,138,40,299,130,5146
34434,7731,3744,22,207,121,41,226,97,3987
34610,14656,7498,140,317,266,151,328,200,7158
35447,2898,1466,41,115,35,20,98,15,1432
39669,5226,3003,82,391,14,44,171,52,2223
87583,179,103,0,0,0,0,0,0,76
88021,19189,9164,303,582,200,111,395,368,10025
93426,1604,914,20,50,33,5,19,9,690
94022,19378,9554,66,396,258,34,486,254,9824
92339,1185,569,0,28,5,22,45,38,616
7746,18532,8779,50,458,254,147,502,288,9753
31547,1420,1181,224,23,0,0,43,0,239
48656,3885,1945,49,70,99,5,104,45,1940
49338,1621,882,8,87,45,8,40,51,739
30083,58323,27559,262,2479,285,397,2347,866,30764
32055,17114,8156,53,474,172,143,451,257,8958
25870,47,14,0,0,0,0,0,0,33
26278,702,285,0,32,13,0,0,36,417
49915,400,207,0,3,6,0,3,0,193
53586,2231,1182,24,51,54,9,72,42,1049
56755,86,45,0,0,2,0,0,7,41
58776,207,107,0,9,0,0,0,2,100
60479,934,483,0,38,8,0,38,14,451
46203,39227,19904,136,1165,358,184,1437,307,19323
47043,5460,2763,5,174,132,80,137,111,2697
67005,15696,7698,83,432,228,95,363,174,7998
68059,2999,1623,25,51,31,0,65,101,1376
63139,21933,11113,76,992,246,76,848,239,10820
64658,3239,1647,0,142,27,14,114,58,1592
49252,2442,1277,18,75,50,7,94,41,1165
54448,4487,2227,21,121,59,32,137,57,2260
61936,290,137,0,7,8,0,0,0,153
75067,67487,32957,327,3019,406,371,2692,425,34530
75501,35834,17768,345,1428,290,334,1119,567,18066
98199,21954,10634,85,939,182,53,747,349,11320
35207,9102,4273,52,174,140,64,263,57,4829
97624,3459,1727,0,91,144,0,44,114,1732
98349,4346,2091,27,103,72,0,142,62,2255
98685,29585,14109,93,898,385,66,986,459,15476
99129,806,445,7,17,20,6,17,21,361
99612,1074,631,0,43,12,0,39,9,443
56303,24674,12562,164,1072,315,86,896,341,12112
57747,5915,2936,0,96,120,5,70,135,2979
93654,30935,15801,401,701,236,215,796,244,15134
68058,266,124,0,4,30,0,1,18,142
61412,1467,760,3,54,6,3,68,10,707
49525,29439,14408,181,797,194,259,810,390,15031
49883,136,78,0,0,10,1,0,4,58
50234,581,290,2,21,9,0,50,23,291
51051,86,55,0,0,0,7,0,1,31
58233,228,115,0,2,1,0,5,2,113
62689,503,243,0,26,5,0,12,9,260
64165,215,98,0,0,0,0,37,0,117
74115,23347,11579,230,770,159,133,716,196,11768
70380,20902,10297,150,744,143,57,657,215,10605
71301,23293,11450,202,714,226,146,632,295,11843
98614,154,64,0,0,23,0,0,0,90
79369,135,79,0,0,5,0,11,0,56
57625,4410,2172,30,135,37,22,116,29,2238
59274,272,144,0,0,5,0,9,2,128
60172,24551,11939,277,670,243,102,746,362,12612
72639,826,387,0,4,9,0,42,0,439
73548,301,168,0,0,2,0,0,3,133
76077,342,223,0,14,5,14,0,7,119
50034,359,176,1,11,4,3,22,0,183
50501,28063,14489,441,1071,357,159,763,298,13574
51466,1024,482,1,11,13,9,14,7,542
51555,4885,2292,30,75,62,6,113,59,2593
63362,7346,3571,85,376,30,58,311,117,3775
63622,843,488,0,35,0,0,42,11,355
66524,2455,1263,29,131,39,8,39,30,1192
67550,5734,3297,33,271,132,65,136,57,2437
67831,824,429,0,24,9,0,34,13,395
36567,13935,7063,15,404,114,110,389,105,6872
37374,2403,1165,0,210,26,103,39,22,1238
38587,1473,734,0,22,51,5,36,20,739
40507,1727,920,10,93,0,8,44,58,807
54895,914,489,2,17,23,10,11,21,425
56080,764,361,3,19,4,0,23,10,403
50046,1595,740,2,72,27,63,77,36,855
50625,1042,590,1,8,18,0,43,8,452
41825,692,299,0,87,13,0,71,0,393
42141,30948,14590,213,795,318,225,1045,425,16358
43449,8219,4081,29,205,160,23,218,127,4138
15955,2475,1206,16,78,46,14,96,56,1269
15958,2184,1163,10,81,43,2,69,38,1021
22664,8969,4406,74,283,126,53,233,78,4563
3782,3006,1571,33,157,25,0,155,52,1435
4002,7530,3790,9,216,109,25,175,137,3740
4544,624,301,0,0,32,0,9,42,323
24521,10196,5048,59,210,164,90,385,284,5148
12871,4492,2160,16,122,37,20,237,65,2332
27932,12455,5736,91,511,184,58,406,169,6719
77507,0,0,0,0,0,0,0,0,0
83465,163,86,10,0,0,0,0,0,77
83526,314,177,0,11,2,4,10,3,137
65778,459,243,0,0,0,0,0,3,216
16840,553,269,24,10,17,0,12,30,284
16921,454,233,4,24,26,0,17,8,221
5764,3333,1679,47,149,26,47,94,41,1654
20001,46716,22598,434,2405,311,805,1805,374,24118
20147,64197,31037,216,2329,524,283,2603,556,33160
21780,1638,881,23,6,7,11,27,14,757
21788,11563,6053,70,331,132,68,312,174,5510
21863,4741,2308,54,186,58,85,96,37,2433
74852,1406,709,6,33,31,8,33,31,697
76628,34,21,0,0,5,0,0,0,13
95832,11518,5932,109,242,76,85,250,64,5586
89117,55061,27368,190,1727,565,243,1776,951,27693
98674,12445,6354,26,654,125,63,344,173,6091
78516,35097,17337,223,878,206,297,824,184,17760
48476,459,204,4,13,7,0,21,14,255
8807,38748,18848,138,1118,290,331,1371,440,19900
25880,6614,3140,14,149,139,23,134,95,3474
11770,57,34,0,4,0,0,5,2,23
2191,8298,4000,26,228,111,65,147,115,4298
2494,10477,4798,18,363,123,54,342,174,5679
27897,1690,696,0,30,32,0,40,8,994
28377,12933,6093,151,499,109,119,405,150,6840
67745,353,183,1,4,0,0,0,0,170
68847,16828,8484,159,568,242,223,497,232,8344
59633,258,136,0,6,0,0,6,5,122
59634,5431,2743,0,130,81,10,110,100,2688
97469,2878,1388,16,103,16,12,91,72,1490
76449,2506,1264,15,104,67,3,52,40,1242
76823,2840,1309,24,41,53,0,52,79,1531
81125,3630,1709,28,63,41,26,136,84,1921
64735,13124,6477,105,437,121,86,333,225,6647
66970,105,53,0,0,2,0,0,0,52
90270,27454,13858,154,1147,98,179,819,179,13596
45734,466,188,3,12,5,0,39,0,278
46124,8564,4565,34,371,60,29,251,120,3999
48104,43233,21434,2756,852,236,2945,786,299,21799
41472,10384,6056,120,438,124,36,277,217,4328
43571,7526,3727,21,257,40,27,317,228,3799
38455,166,85,0,0,1,0,0,2,81
59067,191,116,5,4,5,0,2,1,75
59411,678,494,26,38,11,0,0,0,184
63601,15106,7369,114,455,97,29,476,193,7737
55906,18745,9639,103,613,256,74,538,177,9106
56231,379,197,2,17,2,2,19,0,182
52774,129,72,1,2,5,2,5,2,57
44103,16519,8321,100,488,170,74,353,377,8198
7505,2423,1275,0,163,48,0,80,29,1148
17038,8779,4429,119,343,79,31,395,65,4350
17307,5964,2972,51,111,46,29,177,88,2992
24459,527,341,56,0,14,0,0,0,186
10804,14753,7397,97,414,290,24,472,313,7356
20197,2231,1045,0,20,0,15,36,12,1186
27713,54621,25450,255,1822,485,252,2748,696,29171
27960,564,262,0,33,0,0,0,0,302
18244,284,138,0,0,6,3,0,0,146
76457,3764,1801,49,155,60,6,91,28,1963
76597,2817,2816,0,313,28,0,1,0,1
79360,16243,8231,77,487,31,208,489,120,8012
52160,918,519,8,63,2,0,20,16,399
53179,7289,3738,0,268,41,182,193,31,3551
53203,1550,870,0,26,5,0,5,13,680
60563,37409,18220,90,1560,311,193,1511,415,19189
61342,8763,4476,69,251,99,68,236,174,4287
68774,191,87,0,0,3,0,1,3,104
70401,18256,8411,283,582,97,306,602,164,9845
70556,316,161,0,24,0,0,29,2,155
71839,374,204,0,0,0,0,4,1,170
57350,15604,8112,78,437,253,75,312,249,7492
63387,54,31,0,0,4,0,0,0,23
74820,31480,15397,217,911,345,422,785,362,16083
75040,63153,31212,431,1981,391,454,2040,733,31941
75681,2148,1134,2,33,58,0,45,84,1014
33015,66272,31745,438,2000,472,616,2410,741,34527
33498,14404,7028,76,215,138,57,273,329,7376
70544,10942,5077,46,280,126,3,397,250,5865
49847,1015,460,0,9,12,15,15,18,555
53186,33311,16069,398,1054,373,246,939,438,17242
58045,2253,1125,9,46,29,3,50,43,1128
53406,26038,11926,115,474,180,97,721,292,14112
55416,32171,15467,44,894,347,211,982,323,16704
49040,3246,1660,13,96,30,18,95,75,1586
49104,740,318,87,0,0,62,0,0,422
56326,1492,800,0,55,24,13,30,30,692
50446,459,237,0,13,0,0,12,4,222
30223,36986,18103,47,885,493,142,1176,356,18883
31068,5079,3508,30,283,79,12,105,87,1571
33028,27235,13268,215,887,228,207,620,320,13967
33606,19466,9272,134,474,70,396,374,197,10194
37181,1963,1001,0,9,0,0,25,2,962
37919,28636,13663,240,925,246,169,810,329,14973
38116,39758,18981,347,832,516,211,1324,612,20777
38582,1277,680,15,33,8,0,25,0,597
39567,11113,5410,159,277,130,103,345,208,5703
40374,1787,964,6,49,9,12,44,19,823
33839,3267,1728,47,167,34,14,111,55,1539
34113,21409,10706,38,364,367,78,590,264,10703
35087,2253,1022,6,121,0,0,62,83,1231
27358,15184,7563,94,480,213,53,299,242,7621
28308,607,474,122,0,0,4,0,0,133
41666,1070,511,2,48,15,33,48,33,559
29355,928,449,22,44,7,0,0,7,479
25243,543,249,0,23,33,0,0,9,294
49916,2929,1557,39,99,28,0,83,12,1372
73840,739,442,28,17,4,4,16,9,297
70121,11323,5359,31,397,173,45,389,168,5964
49289,162,98,0,18,9,0,0,3,64
13480,3398,1647,0,99,56,9,103,86,1751
20722,6022,3024,55,256,49,35,255,76,2998
12787,377,185,0,0,0,16,20,24,192
12953,15569,9552,182,815,148,85,393,72,6017
17776,242,125,4,0,5,2,0,4,117
18252,10577,5297,38,277,108,4,291,97,5280
83687,33923,17544,196,1550,204,174,1345,173,16379
90805,96708,46972,1035,3389,689,796,3112,1106,49736
99573,540,261,0,15,1,2,27,5,279
99685,4566,2689,47,205,39,40,135,53,1877
93608,940,507,0,59,17,0,34,0,433
94558,69142,34497,466,2202,809,313,1884,925,34645
95432,519,321,0,59,0,0,5,19,198
95444,715,222,0,0,0,0,17,18,493
79250,1321,617,16,65,11,0,28,15,704
52329,895,529,0,27,33,0,23,28,366
52601,28777,14045,153,735,337,227,794,429,14732
52722,37308,18044,40,1023,382,152,1562,479,19264
54213,1318,678,2,31,11,1,49,11,640
54909,2106,1111,11,45,46,10,71,21,995
55425,10435,5658,130,421,63,38,470,85,4777
67625,384,203,0,20,5,0,0,8,181
68358,1926,987,57,116,16,3,85,13,939
68746,396,208,1,10,3,0,5,7,188
68826,3986,1896,11,56,47,0,116,115,2090
62239,4715,2165,0,118,34,48,263,18,2550
62262,1503,732,3,38,15,0,24,12,771
48450,4575,2199,31,64,126,7,50,150,2376
4239,4659,2163,11,235,16,59,130,48,2496
17325,27928,13863,413,748,350,308,670,353,14065
8042,213,103,6,15,10,0,0,0,110
10034,42910,20361,462,1966,420,265,1705,787,22549
10038,22800,10696,176,837,147,129,884,424,12104
11215,70156,33597,92,3723,483,115,4075,691,36559
28748,12613,6333,18,447,309,102,574,93,6280
29208,760,297,18,0,0,87,0,0,463
30017,24416,11303,170,831,246,32,861,293,13113
12960,1099,582,0,93,12,17,56,12,517
12961,212,160,0,0,0,0,0,0,52
8340,1251,668,0,28,7,27,28,14,583
8850,8488,4041,107,387,55,75,440,119,4447
48456,698,362,13,21,11,4,23,16,336
39759,44145,22977,1870,939,406,978,1295,469,21168
40033,12823,6348,106,318,130,15,551,180,6475
53825,615,329,5,22,4,0,14,2,286
54159,1176,615,0,53,7,0,23,16,561
36759,1805,909,0,71,26,18,59,67,896
37323,31178,15468,114,974,403,135,858,496,15710
55756,404,208,0,10,10,0,12,8,196
56134,480,260,6,8,2,6,15,5,220
57076,373,191,0,10,17,0,2,9,182
43759,57,28,0,1,0,0,0,7,29
43793,4901,2417,3,90,81,26,86,62,2484
44484,21804,10309,72,483,283,96,683,396,11495
45621,309,133,0,2,2,14,20,10,176
51235,1336,741,0,78,10,0,38,2,595
45769,7058,3531,81,196,69,32,153,96,3527
56152,1400,702,6,34,20,0,23,5,698
56347,7165,3744,64,231,109,40,221,125,3421
56456,52,28,2,2,0,3,0,1,24
57054,495,295,0,7,18,0,16,7,200
58223,219,112,0,0,14,0,3,0,107
49663,6243,3082,33,135,70,56,225,97,3161
49887,2557,1318,6,68,25,15,99,42,1239
35040,17141,8402,80,827,104,18,895,228,8739
35244,31930,15342,128,980,314,112,1019,526,16588
4222,3931,1942,26,147,60,0,165,63,1989
6073,5515,2729,38,137,33,8,145,97,2786
6089,3156,1463,24,108,54,0,71,25,1693
7095,19540,9892,117,973,142,67,759,228,9648
2330,11661,5611,185,266,65,88,297,246,6050
92808,20667,9917,110,744,162,66,807,357,10750
92860,26591,14399,248,1091,220,119,597,351,12192
99564,61,30,0,2,0,0,0,6,31
82731,89,63,0,0,0,0,0,0,26
83847,1599,909,0,17,45,0,18,21,690
84725,1699,836,10,51,24,9,68,22,863
84764,270,128,3,6,0,0,0,0,142
81063,2867,1871,26,168,38,20,31,7,996
81146,772,377,9,39,11,0,50,11,395
92285,2142,1115,27,63,43,10,57,26,1027
69367,225,126,0,7,9,0,4,5,99
70392,8607,4321,42,247,122,15,289,136,4286
72067,2642,1332,12,47,85,0,162,47,1310
14211,21900,9847,166,478,134,229,1003,369,12053
15310,241,110,0,2,6,0,0,2,131
10154,0,0,0,0,0,0,0,0,0
10704,32223,15793,242,1066,299,129,1136,302,16430
10973,2123,1094,54,30,27,0,30,7,1029
12060,1551,751,6,11,16,5,37,18,800
4352,1489,643,0,26,20,0,40,35,846
1270,770,378,7,20,30,4,15,18,392
32835,46058,21698,395,1804,323,362,2020,611,24360
47923,3337,1705,32,94,63,15,121,18,1632
17952,197,99,0,0,12,0,0,7,98
18234,213,113,0,0,0,0,0,27,100
7020,12184,5704,43,824,89,0,638,127,6480
7457,4226,2008,40,174,63,7,157,37,2218
11719,3604,1701,22,62,36,40,130,87,1903
21866,80,40,5,0,0,0,0,0,40
22435,2440,1263,19,39,18,9,14,56,1177
24141,22475,10901,525,474,234,630,653,181,11574
2839,2062,998,0,69,58,0,26,58,1064
4037,3814,1844,41,86,56,67,52,66,1970
13802,562,236,0,3,4,0,15,4,326
19701,38941,19115,222,1269,322,277,1288,542,19826
21659,1355,630,2,15,16,0,30,50,725
1001,17621,8292,38,566,114,66,469,164,9329
76078,10168,5053,106,321,33,78,337,130,5115
84710,160,83,0,7,2,0,1,0,77
77554,8769,4425,161,143,156,148,95,221,4344
66509,2669,1387,5,79,9,13,30,52,1282
59754,1108,656,0,4,87,0,41,28,452
15626,5144,2419,10,75,8,16,84,76,2725
19335,48857,24421,194,1661,599,193,1651,591,24436
6114,28691,14202,285,995,177,239,981,394,14489
7927,3879,2165,14,81,45,0,195,42,1714
12923,589,327,0,17,8,0,7,8,262
27893,39372,17696,237,756,227,302,1265,622,21676
28398,7765,3882,0,147,57,55,205,96,3883
28723,11182,5231,285,176,82,431,196,134,5951
29493,164,87,0,6,1,0,0,4,77
22625,3134,1584,23,133,81,0,99,60,1550
14171,1956,1009,9,59,43,12,40,41,947
36067,28727,13836,229,983,199,140,1118,484,14891
37723,875,408,0,28,2,14,21,2,467
38111,43563,21540,551,1463,299,477,1357,547,22023
24880,215,88,0,0,0,0,38,0,127
43973,2281,1195,0,72,13,20,42,46,1086
39059,11951,5538,185,237,107,77,417,256,6413
46236,28147,14020,128,948,363,69,904,416,14127
47601,14019,7101,191,429,244,136,393,215,6918
27014,854,446,0,47,3,0,49,12,408
32968,14015,6787,90,304,141,145,235,204,7228
97810,1057,526,6,19,17,6,26,17,531
76011,22640,11457,194,967,128,226,822,127,11183
87580,466,215,43,0,18,0,0,0,251
99770,839,466,2,29,2,3,21,13,373
62862,330,150,0,12,4,0,1,0,180
64065,39,10,1,0,2,0,0,2,29
64649,542,244,6,13,16,0,41,16,298
59230,4613,2264,0,124,36,0,130,47,2349
60625,79243,39692,451,3994,545,568,3444,949,39551
61743,205,95,0,11,8,0,8,0,110
55391,16322,8257,30,423,305,10,470,353,8065
55717,381,223,8,10,5,0,7,8,158
19806,9930,4360,0,253,129,9,295,101,5570
20593,0,0,0,0,0,0,0,0,0
20693,947,480,16,7,7,27,26,19,467
21676,490,245,0,42,20,0,32,6,245
77455,2267,1175,24,88,32,0,68,68,1092
77954,11939,6454,71,542,200,68,415,148,5485
65354,666,261,0,13,1,0,1,0,405
67579,3380,1730,87,82,36,46,51,36,1650
76951,1141,622,4,17,8,0,21,13,519
69354,135,61,0,0,2,0,0,5,74
71935,492,241,5,19,10,31,0,8,251
64474,870,470,2,23,6,0,41,26,400
83213,1321,660,1,60,10,8,48,14,661
83328,5748,2920,23,155,6,27,195,48,2828
72747,316,168,0,0,0,0,0,0,148
74107,19734,9467,104,614,202,69,515,209,10267
90506,0,0,0,0,0,0,0,0,0
90807,32067,15847,76,1289,443,90,918,678,16220
91948,15,15,0,0,0,0,0,0,0
92236,45090,21773,163,1574,100,318,1945,271,23317
92506,45854,22499,343,1342,435,206,1277,679,23355
85266,12937,6549,0,192,258,12,160,367,6388
85364,74382,37373,751,2493,576,665,1785,818,37009
67876,1490,683,0,53,7,13,46,22,807
69024,1224,589,0,37,31,16,42,10,635
65567,1320,693,0,11,19,0,14,24,627
65714,33111,16480,145,1070,481,139,1200,474,16631
60145,2673,1518,12,65,28,21,85,40,1155
6022,95,54,0,0,0,0,0,0,41
7758,4113,2035,35,109,54,30,117,49,2078
67502,23549,11231,206,623,403,76,549,390,12318
68818,5493,2752,6,184,41,8,131,61,2741
68859,533,242,0,7,26,0,3,4,291
70729,965,380,0,32,0,0,75,19,585
70811,13261,6039,124,273,110,70,400,143,7222
62536,749,417,0,30,0,0,14,0,332
76859,1978,1059,26,62,13,6,12,5,919
77345,28804,13919,71,1013,264,141,834,281,14885
78335,0,0,0,0,0,0,0,0,0
78574,62040,29583,542,2240,288,567,2108,593,32457
58346,649,350,16,26,12,0,19,16,299
59211,145,76,0,5,5,0,0,5,69
60536,116,56,1,6,0,0,5,3,60
83874,0,0,0,0,0,0,0,0,0
84061,289,184,0,25,8,0,7,0,105
82716,17823,9226,230,509,153,62,582,196,8597
65017,879,464,0,39,0,0,27,0,415
66607,9771,4641,128,407,110,65,365,110,5130
74868,13443,6599,61,427,138,86,373,180,6844
91204,18720,8818,185,547,160,47,650,305,9902
92233,7618,5970,155,702,33,12,60,40,1648
92398,2098,1100,0,99,93,0,149,19,998
95674,913,446,28,21,2,0,14,10,467
96054,339,190,13,10,0,0,9,1,149
2893,29153,14277,182,1262,417,153,1165,460,14876
6710,11275,5401,63,417,64,117,292,135,5874
30189,38550,19413,277,1128,388,154,1198,334,19137
14611,16630,7487,174,345,69,172,616,268,9143
16611,2500,1246,6,70,40,15,90,48,1254
25062,120,45,0,0,0,0,0,0,75
25504,13287,6770,150,328,222,54,562,157,6517
19968,11267,5533,65,243,181,11,340,260,5734
20003,31213,16185,128,2055,240,151,1500,288,15028
20008,29457,13626,50,1324,322,57,1540,373,15831
17756,12242,5340,68,302,126,46,479,198,6902
13454,571,264,0,32,6,0,36,8,307
15064,318,160,0,0,19,0,0,12,158
3609,680,379,0,24,0,0,26,6,301
93943,0,0,0,0,0,0,0,0,0
95697,420,240,0,0,0,0,0,17,180
87745,769,378,0,19,0,0,13,13,391
96115,115,68,0,0,14,0,0,0,47
74556,359,178,0,10,0,0,12,4,181
74932,2397,1165,5,93,21,27,83,26,1232
65757,7118,3541,24,190,90,57,292,90,3577
64422,367,209,0,0,3,0,15,7,158
84737,17541,9308,208,605,191,112,533,269,8233
85308,66057,32090,531,1877,875,419,1724,1134,33967
60564,42513,21180,202,1234,323,311,1556,475,21333
61104,19454,9673,106,500,216,182,603,235,9781
62293,4427,2068,23,126,28,12,112,41,2359
79102,10395,5359,30,322,72,142,294,113,5036
79121,6252,3158,30,137,66,25,169,101,3094
70732,1378,641,0,55,5,5,30,22,737
72059,21,9,0,0,0,0,0,0,12
49677,7254,3520,14,169,105,49,161,107,3734
48208,9196,4526,48,248,32,115,238,82,4670
63552,7558,3771,17,265,83,28,325,84,3787
64646,151,64,1,1,0,2,0,0,87
67854,1253,636,16,26,27,0,27,26,617
44450,2041,1105,24,117,10,5,57,14,936
33868,12092,6701,64,528,104,47,246,125,5391
52076,2246,1170,23,85,41,28,55,64,1076
35983,3733,1918,11,89,32,7,107,60,1815
34142,30955,17086,319,1236,101,245,931,119,13869
63108,20704,10436,258,664,188,242,536,390,10268
64015,31219,15007,122,896,424,219,937,386,16212
19073,19566,9459,290,419,198,65,445,305,10107
71959,427,206,0,17,29,0,39,0,221
41015,20492,9872,107,400,225,79,554,262,10620
73632,3337,1617,53,105,78,20,105,58,1720
68456,1210,636,0,39,11,3,10,6,574
68711,338,191,5,19,4,0,21,0,147
54435,2106,1076,8,61,29,25,49,35,1030
54826,692,351,2,14,19,2,19,12,341
55320,5168,2554,46,163,50,16,154,63,2614
71201,20760,10011,150,717,159,95,573,391,10749
60649,46024,19172,217,1433,464,321,1898,1054,26852
60929,803,318,0,9,3,0,15,15,485
61432,658,326,5,27,11,0,21,8,332
54942,9699,4841,17,345,68,25,408,162,4858
80928,1390,660,11,41,18,10,47,28,730
78380,24438,12354,166,608,235,163,630,290,12084
78631,2856,1278,0,85,35,61,110,8,1578
79537,30,16,0,0,0,0,0,0,14
95651,819,479,2,30,0,0,0,15,340
98446,10424,5000,28,298,112,79,358,85,5424
87322,172,61,0,5,0,6,12,6,111
88009,49,46,11,0,0,0,0,0,3
95232,164,77,0,23,19,0,0,0,87
95257,433,155,30,23,19,0,0,43,278
91980,636,375,0,0,0,0,0,0,261
78040,42041,20458,280,1147,211,304,1065,455,21583
99649,91,43,2,1,0,0,0,0,48
99775,1358,756,151,63,0,91,48,0,602
31720,296,152,6,1,3,0,9,0,144
34756,3704,1876,95,88,19,78,56,48,1828
35647,1185,598,5,5,11,7,70,42,587
38050,615,275,8,16,10,2,0,5,340
40902,1359,716,38,86,11,0,78,11,643
40915,813,465,0,13,42,0,0,0,348
46160,6535,3405,53,154,142,20,85,175,3130
41014,7101,3373,87,347,100,31,274,147,3728
90638,49383,23994,518,1639,585,500,1384,893,25389
88039,333,221,0,0,0,0,0,9,112
99013,1808,844,66,35,9,94,13,10,964
99632,828,482,10,22,1,7,19,1,346
57735,1232,642,0,31,58,8,25,20,590
41513,334,170,0,31,0,41,0,7,164
43149,2414,1225,15,81,75,12,79,44,1189
43207,47265,23681,320,1775,503,288,1726,604,23584
44847,3344,1763,24,143,95,0,116,84,1581
45661,6956,3431,25,197,134,10,85,84,3525
32221,30227,14655,287,870,246,191,1102,328,15572
33143,32197,16110,251,1118,329,161,813,321,16087
51201,5972,3033,40,191,72,0,209,86,2939
48382,23507,11554,67,693,272,114,719,354,11953
37079,2471,1222,108,34,0,41,91,19,1249
37141,1323,625,2,54,9,19,77,15,698
38339,708,346,1,5,7,0,21,11,362
38762,2439,1024,15,44,21,16,50,56,1415
47356,5252,2573,11,106,47,13,165,90,2679
79544,567,285,15,28,3,0,5,9,282
80438,502,308,8,17,20,5,8,17,194
82420,879,420,0,12,0,0,37,2,459
72007,7295,3692,75,235,123,38,263,109,3603
67344,931,487,0,8,25,5,21,26,444
20678,12418,6120,90,275,129,66,297,133,6298
2025,8449,3935,63,134,132,33,187,107,4514
2652,761,346,0,34,17,0,0,49,415
4271,0,0,0,0,0,0,0,0,0
4364,5917,2897,0,137,79,0,112,172,3020
13433,1844,906,5,47,32,11,31,21,938
8701,100763,49782,311,2848,369,646,2965,523,50981
16153,2369,1232,13,61,45,7,48,44,1137
40045,3341,1716,25,121,15,19,58,54,1625
40347,2897,1297,10,108,23,39,116,21,1600
27041,7947,4014,84,113,121,100,141,118,3933
27325,6767,3510,10,156,63,0,170,76,3257
27601,10445,5446,99,448,87,57,347,125,4999
28425,11634,5816,138,275,184,93,299,173,5818
49646,8459,4243,69,358,129,17,232,109,4216
50240,2917,1529,17,60,76,0,83,31,1388
50466,1513,748,14,36,24,25,42,39,765
64857,440,206,0,21,3,6,17,2,234
68458,176,110,0,3,0,0,7,3,66
68845,20710,10348,401,660,234,484,702,254,10362
63345,691,299,0,51,28,0,55,2,392
63760,590,279,0,26,9,5,22,16,311
60460,1333,627,3,32,14,13,39,20,706
61068,14289,7438,135,532,168,63,345,288,6851
48203,22939,11261,225,543,278,222,585,340,11678
48624,15506,7674,44,483,282,38,417,352,7832
74037,18419,8938,126,809,138,44,700,181,9481
75002,70597,35883,274,2250,536,542,2413,754,34714
75240,28537,15290,345,1311,106,72,1032,244,13247
76155,5494,2578,44,213,29,37,236,0,2916
54529,1213,626,0,13,21,0,14,36,587
54559,886,460,1,30,13,1,20,10,426
56687,55,30,0,0,2,0,0,0,25
51575,1477,733,4,59,19,9,42,28,744
52535,1063,528,8,32,12,6,13,9,535
53022,19041,9147,91,710,162,66,685,219,9894
37095,2531,1383,4,139,24,4,80,8,1148
37880,3246,1681,19,93,64,0,156,101,1565
38141,22340,10538,97,696,169,144,566,192,11802
38869,512,184,3,3,0,0,29,5,328
38914,779,386,0,25,0,70,94,11,393
32134,7376,3987,65,193,131,2,57,160,3389
44135,27640,13243,176,882,262,149,1019,442,14397
34994,16909,8551,94,403,203,45,533,225,8358
43462,1191,686,0,43,12,0,22,21,505
29510,10493,5021,167,273,164,54,433,164,5472
29579,40272,19514,227,1049,572,106,1009,683,20758
50621,1491,660,3,40,42,4,29,10,831
51027,1352,624,0,42,33,0,27,18,728
14564,15127,7380,19,334,183,26,528,209,7747
14750,4483,1980,44,144,65,0,132,67,2503
15087,151,65,0,16,0,0,15,0,86
23350,3439,1673,0,15,97,28,70,47,1766
20112,26902,13451,192,693,302,76,753,341,13451
21252,2271,967,109,0,0,88,0,0,1304
21778,940,547,14,18,9,21,0,0,393
21872,516,234,0,56,0,0,0,0,282
21901,17698,8639,61,543,212,145,519,179,9059
22405,30950,15389,155,894,233,99,1153,496,15561
22958,2290,1162,0,36,48,0,13,74,1128
8402,6076,2923,0,69,82,0,82,132,3153
11377,86421,44369,335,4533,925,434,4015,880,42052
13159,5348,2819,34,141,65,27,107,82,2529
2760,27345,13468,162,889,384,109,923,426,13877
26501,22162,11723,309,798,323,421,723,225,10439
27249,12447,5924,12,334,115,88,419,137,6523
58750,535,302,7,10,11,0,4,0,233
60435,49863,23790,284,1858,293,435,1933,486,26073
61516,676,353,7,25,3,1,18,18,323
61560,560,268,0,0,43,0,0,12,292
61843,2368,1166,10,63,3,3,52,28,1202
62311,633,349,12,2,3,0,13,11,284
57278,816,405,0,16,7,0,16,16,411
33702,30562,14706,191,995,409,87,868,506,15856
35032,44,21,0,0,0,0,0,1,23
41537,5061,2518,89,120,132,78,192,55,2543
45872,4106,2025,29,157,30,28,229,59,2081
46156,1606,819,11,18,7,27,38,18,787
47342,2639,1324,65,63,17,22,53,51,1315
49448,3999,2041,34,178,14,13,153,61,1958
49643,6511,3324,70,243,97,37,294,112,3187
50156,4865,2390,0,116,65,14,171,57,2475
12029,1104,586,0,23,22,0,18,41,518
52316,1583,793,6,43,3,5,35,36,790
54138,780,423,0,11,9,5,19,31,357
28730,9248,4599,49,320,127,56,150,86,4649
26731,386,206,0,6,10,0,54,27,180
27229,3220,1583,13,128,54,0,76,56,1637
27262,24379,11979,380,566,188,347,591,246,12400
27537,24578,11878,137,603,168,176,592,254,12700
31091,4353,2738,61,217,59,0,91,92,1615
28678,6577,3170,140,165,19,63,270,49,3407
28689,2071,1107,0,44,22,0,51,59,964
93238,1015,585,0,30,0,0,56,16,430
93675,3759,2017,22,82,53,26,96,72,1742
98345,422,221,0,8,9,0,8,25,201
99361,1780,908,34,21,17,45,23,39,872
8821,377,182,0,7,0,22,9,0,195
4736,9177,4584,11,302,150,86,287,105,4593
67124,7993,3992,47,192,61,41,178,128,4001
59218,926,497,6,36,4,0,34,16,429
59252,106,58,0,1,0,0,5,0,48
30289,276,121,17,44,1,0,44,0,155
69355,156,92,0,4,0,6,4,2,64
71406,139,53,0,0,0,0,0,0,86
12452,252,102,0,0,0,0,0,4,150
31323,1213,623,12,39,29,4,23,37,590
13062,40,17,0,0,0,0,0,0,23
32256,45688,21789,227,1223,432,378,1266,498,23899
14536,561,292,7,21,7,2,19,25,269
37914,19866,9341,39,637,271,9,698,243,10525
64064,17781,8570,10,506,264,74,598,341,9211
40604,126,126,3,44,0,0,0,0,0
50070,1501,785,2,40,7,0,25,19,716
50153,823,420,6,5,10,6,15,12,403
34981,5139,2769,0,175,26,8,147,28,2370
48747,1348,657,12,28,45,2,18,12,691
41544,754,382,0,0,9,0,0,15,372
28685,1979,946,6,78,32,0,0,10,1033
72629,381,195,0,14,9,0,12,27,186
73542,4501,2196,22,197,59,20,98,83,2305
75209,14188,6766,64,489,225,0,367,239,7422
70552,1725,795,5,74,2,0,14,11,930
70592,24829,11869,95,1064,170,83,1293,237,12960
71024,1748,973,0,32,1,3,11,25,775
13337,595,339,0,22,36,0,11,11,256
23004,824,463,0,36,0,0,6,6,361
24012,30335,14782,267,847,310,84,945,512,15553
3258,2664,1345,0,27,17,18,72,58,1319
4938,9855,4752,137,171,91,175,247,150,5103
6795,13519,6641,91,408,217,53,445,196,6878
7701,23861,11492,96,805,199,77,700,308,12369
15501,16051,8468,138,522,153,110,366,220,7583
16735,5743,2809,7,95,66,60,171,70,2934
17237,1993,972,19,60,12,51,51,23,1021
12495,182,70,0,0,0,0,0,20,112
7946,3175,1576,35,101,43,0,116,34,1599
10924,13389,6975,117,328,170,131,381,188,6414
610,27073,13112,209,767,297,165,928,252,13961
81038,0,0,0,0,0,0,0,0,0
81504,28669,14121,209,988,257,69,983,433,14548
92117,56173,28563,534,2492,458,272,1852,876,27610
92280,19,19,0,0,0,0,0,0,0
88125,75,39,0,0,0,0,0,2,36
77442,794,467,0,14,7,0,10,14,327
54414,3514,1769,28,106,40,39,126,42,1745
56001,48214,24258,1524,1186,334,1116,1358,602,23956
69156,701,385,15,10,24,4,9,12,316
60157,2502,1316,40,75,50,0,91,18,1186
60449,9400,4498,123,194,146,11,154,74,4902
62274,7857,4976,91,452,49,0,171,126,2881
48236,29679,14204,164,716,386,110,834,644,15475
5657,81,42,6,0,0,0,0,6,39
5701,20031,10006,114,440,270,105,519,265,10025
21076,17204,8464,137,731,71,76,785,277,8740
16834,198,99,0,0,5,0,0,5,99
11209,67809,32504,431,2194,730,218,2517,1031,35305
11421,41002,20497,249,1498,444,398,1568,547,20505
23221,14933,6817,52,566,114,26,536,199,8116
29816,971,536,0,84,0,0,21,8,435
30002,5920,2731,0,166,103,5,201,47,3189
12853,1577,808,0,46,0,22,97,19,769
26430,470,291,0,42,0,7,10,0,179
8243,1955,929,14,38,51,0,18,72,1026
10030,29882,13233,281,1279,144,240,1536,424,16649
46928,4477,2349,8,115,37,23,109,104,2128
47577,1297,753,16,32,27,16,32,0,544
47807,12313,6249,185,358,81,345,287,94,6064
48726,5890,2968,30,144,82,47,132,89,2922
41669,746,300,17,18,2,7,51,8,446
42638,0,0,0,0,0,0,0,0,0
43450,3636,1773,26,87,31,9,73,46,1863
54729,32296,16539,187,1204,503,55,948,550,15757
37763,15350,7475,74,348,273,118,323,262,7875
55783,2394,1301,2,65,26,2,72,39,1093
56252,1200,597,5,33,16,3,34,12,603
46805,21207,9946,131,532,192,119,634,244,11261
47611,1559,766,0,54,40,11,56,15,793
48032,1882,958,8,44,33,7,40,16,924
48335,23174,11835,63,1032,209,149,796,389,11339
48741,1982,1024,14,68,34,7,51,41,958
43950,16446,9550,181,769,182,12,331,202,6896
56216,689,365,0,20,9,1,15,5,324
41016,5956,2887,69,206,22,22,223,76,3069
42084,60,31,0,8,0,0,0,0,29
42339,758,405,0,21,12,0,4,5,353
43030,113,57,0,0,0,0,0,0,56
43136,690,348,0,19,20,0,32,8,342
34109,24662,11282,0,863,271,95,694,715,13380
36305,15816,7413,62,496,171,123,514,250,8403
6712,9736,4876,81,265,88,27,400,225,4860
93924,6568,3088,32,38,181,0,139,136,3480
89445,16189,8410,135,540,221,131,586,257,7779
95724,20,20,0,0,0,0,0,0,0
97322,36352,17800,408,1394,302,211,1387,377,18552
85533,3527,1926,85,104,21,74,135,43,1601
75803,22170,14221,139,1693,285,63,549,192,7949
79220,225,103,0,2,2,0,12,1,122
79821,7482,4327,26,314,68,25,211,35,3155
88341,590,333,0,15,6,0,18,12,257
89141,33008,16481,127,1592,278,108,1585,348,16527
92069,51447,25337,581,1851,314,551,1986,514,26110
10928,4057,2029,20,119,64,20,87,0,2028
3063,16781,8280,189,583,119,61,485,264,8501
6066,29210,13996,72,1054,249,35,887,414,15214
17210,143,84,0,9,5,0,19,0,59
43212,21350,10743,117,825,89,111,728,157,10607
26424,179,70,0,15,7,0,12,0,109
32680,10111,5338,36,222,52,7,201,228,4773
33162,48185,22992,430,1580,302,325,1211,630,25193
17254,88,42,0,0,0,0,0,0,46
18357,119,59,0,0,0,0,0,0,60
7304,44233,20935,172,1789,451,130,1592,842,23298
4901,26834,12794,279,786,209,217,705,499,14040
13486,864,438,0,11,15,0,12,17,426
58311,68,45,1,0,2,0,0,0,23
16321,58,38,0,0,8,0,0,0,20
16729,915,449,5,13,19,25,47,10,466
24963,3768,1831,60,100,20,13,97,99,1937
27217,37624,17673,241,931,482,174,955,489,19951
10548,3817,2035,60,103,75,49,75,116,1782
13037,9442,4793,80,222,125,18,328,136,4649
29832,5247,2719,33,168,43,22,224,79,2528
23093,13712,6454,123,366,193,134,328,123,7258
15348,285,142,14,0,8,0,4,0,143
3044,4649,2342,29,120,41,19,104,62,2307
4941,1777,957,16,26,16,15,53,32,820
34987,8660,4148,0,454,137,43,337,50,4512
37658,4232,2078,20,81,41,9,170,44,2154
26180,2205,1140,32,28,0,0,8,48,1065
42351,4152,2113,4,132,42,14,138,38,2039
42374,481,232,47,0,3,4,0,36,249
39480,2918,1487,24,97,4,92,119,42,1431
39745,804,390,0,49,2,0,39,0,414
28783,1809,1057,0,50,4,0,59,23,752
28105,45786,21876,246,1443,378,283,1599,507,23910
32709,1986,986,0,82,42,22,18,13,1000
31738,1935,947,0,55,23,0,48,39,988
32034,34928,16949,124,733,657,132,740,567,17979
98230,17056,8789,0,503,332,100,465,304,8267
82323,143,87,0,20,4,0,0,0,56
84049,5442,2522,14,226,61,13,173,24,2920
76949,7,1,0,0,0,0,0,0,6
94804,41510,20138,297,1578,367,338,1228,436,21372
90025,47967,24387,238,2832,229,133,1826,306,23580
91773,34496,16196,138,1167,402,196,965,425,18300
62546,1624,794,15,26,14,11,28,19,830
56581,219,122,5,2,5,0,1,2,97
57701,45670,23146,396,1262,762,320,1289,495,22524
57770,6266,3126,115,291,23,33,188,30,3140
60091,27367,13355,77,598,278,68,843,388,14012
61338,257,150,0,6,5,0,11,3,107
55726,1062,541,6,46,18,0,34,23,521
67219,13398,6415,117,347,67,99,493,141,6983
68510,21765,10529,113,854,113,154,761,359,11236
61547,4138,2071,9,144,47,13,118,68,2067
63650,4120,2091,1,128,35,4,142,72,2029
79525,2207,964,6,32,13,33,57,26,1243
58464,228,122,0,0,3,4,0,1,106
58711,264,156,26,7,5,0,0,6,108
59405,31337,15634,487,898,263,344,900,348,15703
60184,2357,1160,7,80,38,19,55,56,1197
60202,32861,14994,108,1141,389,209,1358,448,17867
72377,9,0,0,0,0,0,0,0,9
72951,912,502,15,12,13,2,27,6,410
85926,453,182,0,10,0,0,14,0,271
83286,1390,692,7,51,13,6,45,8,698
64844,4944,2497,0,132,118,0,136,20,2447
65724,1418,708,0,11,43,31,0,14,710
74951,1307,624,3,32,9,9,51,21,683
75437,1361,721,0,25,12,0,38,23,640
93287,96,56,0,5,7,0,1,5,40
98328,9637,4807,38,267,121,52,244,94,4830
98601,3494,1926,40,154,40,32,115,26,1568
99101,1400,818,19,26,27,13,32,16,582
99761,422,225,2,9,5,3,9,2,197
96150,29357,14913,153,991,373,296,1056,504,14444
4411,1570,808,0,46,15,8,80,0,762
6016,6900,3320,29,166,69,0,194,45,3580
6096,12613,6114,58,475,156,63,279,132,6499
7503,18226,9512,144,633,148,108,580,193,8714
2093,11734,5764,26,279,144,42,320,188,5970
31035,1261,628,18,18,26,4,42,18,633
13760,43350,21326,355,1188,635,181,1425,546,22024
14533,2021,1050,0,68,33,0,50,42,971
16725,313,168,0,0,8,0,0,10,145
20841,10481,5455,124,425,56,29,306,91,5026
78375,2956,1833,0,23,6,15,36,12,1123
68321,332,146,0,0,0,0,2,0,186
74736,1122,573,2,24,19,14,32,7,549
75956,8510,4331,73,263,70,86,236,127,4179
76660,587,253,5,23,2,0,15,4,334
70436,689,344,0,0,13,0,115,0,345
71432,1436,758,5,38,0,8,46,2,678
63441,1085,497,0,15,11,44,21,14,588
64066,38,21,0,1,0,0,0,2,17
56472,7854,4058,24,208,100,38,213,90,3796
91326,37035,18341,141,882,651,114,940,519,18694
83810,1077,555,0,3,10,0,9,22,522
84017,4119,2045,48,165,51,16,150,77,2074
84047,33531,16813,161,1545,167,243,1209,319,16718
98499,31234,15998,248,1234,293,182,1003,365,15236
96814,19527,9360,119,657,258,67,559,335,10167
50220,8962,4634,39,365,17,103,323,97,4328
64630,593,270,0,2,0,5,19,19,323
64840,3065,1505,26,60,48,5,109,33,1560
53807,4837,2405,6,123,72,39,154,48,2432
15461,4266,1914,0,69,51,43,215,66,2352
17771,3206,1565,13,67,69,5,77,66,1641
11954,3655,1932,34,98,62,0,120,82,1723
6035,7525,3943,49,185,153,38,175,98,3582
4076,2710,1335,0,52,34,5,119,50,1375
95686,1209,632,0,39,22,0,52,24,577
87007,1004,524,0,52,15,0,20,0,480
87740,7163,3577,65,241,123,0,146,113,3586
89104,38703,20170,162,1412,468,194,988,398,18533
90740,24494,11512,61,480,309,79,475,408,12982
73006,3178,1629,31,111,20,26,110,74,1549
74053,4539,2298,13,152,12,12,133,56,2241
74437,9822,4804,75,215,112,76,259,152,5018
75556,1321,627,7,29,4,7,62,11,694
66101,12342,6480,75,482,72,64,439,102,5862
66118,0,0,0,0,0,0,0,0,0
83203,416,211,16,47,6,0,0,0,205
84601,34312,17617,445,1194,74,616,1127,194,16695
85706,55352,26284,338,1708,360,571,1928,635,29068
77448,182,130,0,41,0,0,17,0,52
61377,1421,662,14,29,8,0,50,13,759
35990,117,49,0,0,0,23,7,0,68
48224,41973,19564,282,1004,283,389,1381,569,22409
49043,2088,980,6,33,59,0,114,32,1108
26884,666,330,0,16,4,6,44,10,336
41619,173,81,0,0,0,0,6,0,92
42349,1135,551,0,7,28,0,25,19,584
21672,139,66,0,0,0,0,0,0,73
23665,6195,3432,132,293,0,160,264,13,2763
14752,263,75,0,0,0,0,0,0,188
15086,343,233,0,0,31,0,0,0,110
15146,27879,13085,78,509,275,117,694,435,14794
77622,1292,674,0,94,0,0,12,11,618
78640,56645,28786,421,2292,491,359,2154,570,27859
61569,1184,542,0,53,14,5,53,17,642
64098,3119,1591,17,48,57,32,56,41,1528
64859,1462,640,18,58,25,0,20,21,822
65052,3502,1967,2,4,149,1,19,82,1535
65731,561,312,0,52,5,0,9,0,249
67525,901,449,4,25,20,0,11,11,452
84531,913,433,9,30,0,8,7,0,480
85353,41818,20101,472,1499,172,322,1336,335,21717
74462,7495,3663,74,297,98,44,239,127,3832
75490,2518,1256,17,79,45,6,80,25,1262
83255,1338,704,0,48,25,0,65,26,634
14011,9470,6120,129,481,113,28,179,86,3350
14541,4255,3046,17,282,38,16,55,40,1209
17223,273,122,0,3,0,0,2,7,151
31039,0,0,0,0,0,0,0,0,0
20733,2788,1350,0,95,28,0,27,37,1438
22627,801,388,0,26,0,0,35,7,413
17601,52301,25430,210,1763,616,284,1626,696,26871
18706,15908,7737,81,320,151,76,421,208,8171
8690,18676,8598,176,476,301,163,719,504,10078
10307,15232,7448,68,369,107,139,470,180,7784
62835,993,472,2,20,0,0,46,11,521
72360,5718,2582,67,124,52,35,85,146,3136
72472,9092,4435,20,310,96,89,267,86,4657
71027,1537,746,30,78,20,0,72,11,791
13794,70,37,0,0,0,0,5,0,33
16364,1375,690,4,34,18,22,46,40,685
33444,23770,11528,141,822,246,270,641,231,12242
8103,14224,7025,57,415,79,218,537,170,7199
8223,4185,1937,46,175,112,0,114,40,2248
8863,12570,6282,80,534,68,40,430,190,6288
27589,8155,3795,32,167,106,114,204,155,4360
27923,682,373,0,97,38,0,23,29,309
29468,2197,1100,14,29,22,48,95,35,1097
29577,31816,15179,135,897,353,189,838,409,16637
36854,16045,7899,45,541,132,115,540,255,8146
11212,76527,32439,288,1785,424,431,2958,1232,44088
17261,284,182,0,0,8,0,0,0,102
17363,9406,4738,30,185,168,65,179,99,4668
18055,11631,5950,80,241,198,34,250,123,5681
18452,4880,2391,52,171,114,15,234,153,2489
72466,1612,835,0,21,0,2,84,56,777
41861,94,60,0,4,3,0,0,16,34
70339,5292,2581,42,133,69,85,61,154,2711
70356,1980,1018,0,114,64,0,0,29,962
70391,217,114,0,43,0,0,0,0,103
70464,695,284,0,56,0,0,58,14,411
46205,27869,13433,101,846,190,263,1033,399,14436
47177,1092,595,0,31,22,0,11,24,497
19030,11722,5789,131,355,129,69,507,210,5933
49855,33049,16691,889,904,486,847,809,340,16358
50536,4483,2244,4,174,60,24,167,71,2239
52772,5157,2466,47,251,21,1,252,77,2691
83605,46488,22946,332,1321,179,323,1298,413,23542
85739,18511,9084,54,291,469,72,304,343,9427
87554,0,0,0,0,0,0,0,0,0
87711,655,394,0,54,47,0,0,0,261
61482,671,329,2,26,5,7,15,12,342
61737,476,237,13,12,2,0,24,7,239
62219,954,413,0,10,19,8,69,32,541
15490,534,291,0,17,0,0,0,17,243
15698,507,270,0,0,0,0,0,0,237
19734,12855,6212,102,392,223,83,453,134,6643
22709,1276,633,0,101,31,0,59,27,643
23149,2911,1354,22,81,3,16,31,28,1557
23840,2889,1459,44,91,65,0,10,38,1430
23856,910,506,0,79,25,0,16,12,404
3597,435,233,0,7,4,0,11,3,202
3768,1682,812,13,53,39,0,39,30,870
4286,50,9,0,0,0,0,15,0,41
7086,14327,7347,34,517,178,0,674,212,6980
12545,4750,2280,7,76,125,67,92,67,2470
8092,3476,1818,12,73,45,23,97,49,1658
8812,14422,7082,24,512,89,98,600,354,7340
10932,104,31,0,0,0,0,0,0,73
2458,12522,5907,33,292,179,58,302,100,6615
40007,165,98,0,5,0,0,0,0,67
30438,31,12,0,1,0,0,3,1,19
43840,1253,664,0,16,13,0,18,7,589
44809,321,127,0,0,0,0,0,18,194
45237,20193,9337,95,549,205,95,484,358,10856
46616,5654,2892,47,173,54,30,145,21,2762
35457,0,0,0,0,0,0,0,0,0
26337,1336,618,6,71,10,0,61,11,718
27597,23538,12078,93,1130,115,117,767,228,11460
41085,994,519,0,22,3,7,44,3,475
43144,401,187,0,9,14,0,15,9,214
43463,39,18,0,0,0,0,0,0,21
29403,21888,10444,296,742,136,678,503,202,11444
48746,8004,4009,23,175,111,40,266,175,3995
95603,29244,14220,280,911,633,84,782,537,15024
95627,4263,2063,0,325,0,39,166,25,2200
96021,16228,7748,62,510,213,71,471,167,8480
97118,864,460,2,24,24,1,16,9,404
98377,1518,760,0,16,42,37,12,38,758
80601,39816,20933,230,1538,272,293,1432,277,18883
85202,39245,19964,317,1521,325,330,1225,440,19281
75022,25640,12688,62,752,116,134,870,203,12952
75156,16108,7931,91,463,217,104,342,347,8177
77099,53357,26846,288,2190,224,690,1688,422,26511
66218,8296,3961,0,211,62,106,412,137,4335
68502,26368,13880,266,984,194,199,846,212,12488
56235,518,249,0,12,6,15,8,5,269
58458,1162,642,4,37,15,0,43,22,520
59343,128,58,0,0,2,0,20,0,70
53105,29600,14524,149,985,207,131,755,417,15076
53951,2288,1190,4,81,36,10,87,36,1098
62644,4946,2442,26,89,75,0,120,62,2504
62825,203,112,2,5,2,11,2,1,91
63101,3307,1851,41,169,14,0,39,72,1456
63102,2201,1551,57,156,43,0,69,15,650
65243,2397,1223,14,14,48,12,74,45,1174
45036,38221,21266,338,1758,317,117,1079,457,16955
70446,7453,4346,42,417,269,0,326,86,3107
70761,549,236,2,3,6,0,2,44,313
71360,37527,18159,201,842,287,274,1201,239,19368
72055,905,413,0,40,9,9,52,3,492
55017,843,435,0,12,14,3,9,16,408
48071,30226,14337,201,1021,169,120,1154,458,15889
48893,5429,2841,9,177,86,12,110,72,2588
61484,832,406,3,37,11,7,16,10,426
28585,3674,1883,46,65,26,38,117,38,1791
42746,1746,863,13,107,32,0,86,14,883
43209,28516,12815,255,959,280,392,840,380,15701
36038,47,18,0,0,7,0,0,0,29
22902,24539,12002,31,1019,276,159,1316,391,12537
28146,27496,13110,49,908,310,244,872,447,14386
28401,24279,11666,102,720,199,125,759,394,12613
24430,3709,2876,41,310,66,3,33,62,833
32209,35436,16186,159,690,356,288,890,506,19250
72921,14292,7204,71,460,85,118,620,100,7088
73017,1568,809,14,98,7,8,32,27,759
82213,498,245,0,10,7,0,1,5,253
16689,487,260,0,15,0,4,12,3,227
7649,8134,4080,86,189,104,10,218,66,4054
8310,1270,722,6,74,0,0,20,41,548
11366,14650,6977,206,429,186,122,393,335,7673
12589,17017,9055,132,925,201,128,604,229,7962
20837,6225,2988,143,146,100,52,240,82,3237
21144,35240,17499,292,1102,188,201,1341,490,17741
24360,6030,3126,0,192,66,43,102,81,2904
25060,483,217,0,11,0,0,27,0,266
25156,171,84,0,0,0,0,0,0,87
14036,4729,2374,55,192,54,0,72,78,2355
765,8607,4231,0,259,247,41,137,182,4376
2339,14397,6985,87,505,153,125,489,102,7412
75140,7290,3485,65,205,147,29,201,155,3805
76550,12905,6363,0,469,177,18,442,193,6542
80135,3607,1843,20,86,47,13,51,73,1764
97210,12059,5965,0,355,210,0,484,172,6094
97868,1960,961,36,101,13,9,30,10,999
98503,39319,18354,313,1263,366,172,1309,472,20965
93437,3379,1989,97,128,0,34,81,0,1390
28560,27590,13364,181,830,199,179,874,503,14226
47130,46299,22281,286,1622,446,292,1735,780,24018
41847,434,221,0,0,8,0,0,0,213
44024,23834,11698,114,545,342,50,551,276,12136
3575,80,67,0,21,0,0,0,0,13
5661,5832,2713,106,217,59,5,98,46,3119
1467,363,128,0,0,7,0,9,0,235
2543,745,285,0,48,0,0,18,40,460
16620,343,157,0,12,4,0,6,2,186
10601,11612,5662,20,655,88,58,329,98,5950
94041,14394,7653,9,800,63,31,624,223,6741
94710,7461,3798,29,251,75,6,323,23,3663
96726,480,288,0,0,0,10,32,44,192
97751,78,40,0,8,11,0,0,6,38
98582,238,93,0,11,8,0,12,0,145
98660,12349,6255,34,502,206,79,549,180,6094
87718,370,202,0,4,0,0,0,7,168
89031,68201,32974,280,2762,605,399,2576,862,35227
62314,524,244,0,8,3,9,0,6,280
62843,123,65,0,4,5,0,0,6,58
62954,475,205,0,2,0,0,2,1,270
78877,777,402,0,57,0,0,29,0,375
82431,3534,1842,11,117,27,7,87,76,1692
68453,359,216,0,0,0,0,7,0,143
71663,510,265,0,11,7,0,4,5,245
83830,514,198,0,0,0,0,5,0,316
58424,291,162,2,0,2,0,6,2,129
59804,8294,3998,35,181,234,158,243,216,4296
60081,9660,4988,28,358,110,59,136,197,4672
64784,1126,609,0,28,16,0,33,23,517
54406,3390,1777,51,123,45,17,147,36,1613
56340,2315,1232,11,60,35,6,69,18,1083
57057,222,107,0,1,0,0,19,3,115
57341,108,54,0,6,5,0,5,0,54
57564,1030,524,3,16,13,0,30,2,506
48397,0,0,0,0,0,0,0,0,0
48615,2962,1509,13,109,31,5,95,54,1453
41650,422,180,0,25,16,0,0,0,242
42047,441,218,0,30,9,0,37,0,223
33851,1105,469,0,48,0,13,37,9,636
33981,10729,5379,102,242,276,0,159,162,5350
42567,5965,2838,21,100,25,61,161,171,3127
44671,290,131,0,20,0,0,38,0,159
45150,32618,15733,252,1135,412,65,1060,490,16885
36919,1748,829,20,26,51,0,51,29,919
38330,4354,2068,6,188,51,35,102,77,2286
53061,4983,2793,52,203,90,2,114,36,2190
61812,381,182,8,7,3,0,0,4,199
63648,1252,641,2,19,3,11,26,45,611
71667,6895,2934,50,81,52,14,346,158,3961
73521,20676,10228,221,757,177,62,561,197,10448
78391,244,78,0,12,0,0,0,5,166
78747,20166,10373,257,940,112,35,678,277,9793
79752,2444,1229,12,104,17,8,95,3,1215
81503,15763,7583,62,465,219,121,381,191,8180
75181,28882,13966,103,1038,148,238,1431,488,14916
77840,59971,31513,3396,1333,143,2935,836,289,28458
65637,1211,510,0,39,29,0,57,3,701
65806,11948,5858,478,216,64,607,192,154,6090
68960,113,55,0,6,3,0,4,0,58
18332,2710,1474,0,55,14,89,60,4,1236
18972,3429,1650,20,57,99,29,85,42,1779
19079,9286,4285,18,353,49,203,326,229,5001
14469,6071,3107,35,117,79,33,158,132,2964
14707,152,82,0,3,0,0,2,21,70
14903,7584,3925,0,187,69,81,179,166,3659
26141,400,165,0,16,25,0,0,0,235
31064,9071,4354,64,183,95,15,209,140,4717
32404,40029,20569,496,1650,345,186,1339,662,19460
33884,32069,14561,177,1063,572,178,1206,536,17508
36701,21301,9904,126,504,388,128,719,324,11397
37016,993,538,2,29,1,1,28,4,455
37355,26366,13267,97,750,234,83,813,227,13099
38109,44922,21651,473,1140,528,273,1318,577,23271
40041,385,84,0,0,0,0,0,0,301
44485,16101,7698,130,350,200,47,358,224,8403
45389,478,252,2,13,8,2,15,14,226
54418,941,443,4,16,8,0,6,21,498
49116,225,114,0,0,8,0,0,0,111
52581,322,166,0,3,9,0,2,14,156
14004,12496,6914,48,431,155,19,389,179,5582
14109,1131,477,37,0,0,36,0,0,654
15687,1234,656,0,25,28,7,6,13,578
17006,1018,537,2,26,19,1,25,17,481
20899,260,109,0,0,0,0,21,10,151
3836,1353,674,12,9,34,5,27,43,679
4539,1059,545,0,29,9,0,19,31,514
8086,8006,3941,46,247,137,43,265,157,4065
12446,4902,2401,0,91,41,8,143,110,2501
26656,323,146,0,0,14,0,16,0,177
77012,19468,10528,94,707,269,167,667,321,8940
78007,187,93,0,7,0,0,8,2,94
80129,30058,14948,110,877,217,170,916,299,15110
15861,122,69,3,3,5,0,0,5,53
21163,7158,3435,51,132,78,19,145,80,3723
22847,828,427,0,21,20,0,0,9,401
74339,2357,1190,12,65,13,26,88,34,1167
75554,2077,937,0,71,39,38,70,7,1140
76009,21041,10459,80,445,293,137,858,308,10582
12303,28233,13596,124,836,276,169,1179,568,14637
12417,429,222,42,0,0,11,0,0,207
13028,1109,601,20,0,57,0,30,13,508
13052,1522,771,11,32,11,8,18,12,751
52632,12636,6196,88,311,168,34,387,208,6440
8031,11415,5778,41,340,148,0,432,209,5637
12567,2951,1352,52,39,58,5,34,38,1599
13064,161,70,0,0,9,0,0,0,91
25261,195,83,1,23,9,0,0,24,112
1833,8649,4185,58,291,100,0,221,141,4464
2646,1868,873,0,8,45,16,17,26,995
19460,41911,21395,191,1479,370,154,1449,351,20516
76849,3880,1924,1,107,43,4,94,113,1956
76905,12769,6515,104,396,114,101,399,109,6254
83218,327,157,0,19,1,0,13,3,170
84341,23426,11907,334,653,104,823,665,239,11519
84730,294,167,0,16,8,0,11,2,127
85303,33380,15998,244,895,167,313,956,354,17382
85354,7547,4047,44,201,107,16,203,19,3500
85634,6637,3184,63,204,19,96,194,98,3453
67041,336,167,2,5,0,0,6,4,169
67564,246,117,8,16,0,0,4,0,129
68652,601,312,0,10,10,6,3,5,289
87109,39341,18728,183,1204,267,281,1146,571,20613
78263,5208,2514,48,331,25,0,120,79,2694
78885,86,53,0,0,0,0,0,0,33
74146,16130,7961,91,479,82,152,621,136,8169
92802,42248,21083,240,1629,249,297,1446,512,21165
7750,3211,1539,9,66,15,9,49,53,1672
10703,21854,10426,217,885,267,144,892,209,11428
11354,55200,25033,191,1356,502,269,1837,879,30167
2199,1149,446,0,62,15,6,27,18,703
64833,68,27,0,0,1,0,0,0,41
65486,3740,1916,25,83,43,20,113,50,1824
66543,1169,585,12,35,31,11,54,9,584
67019,1238,594,3,17,5,7,45,9,644
58530,1056,516,3,14,28,0,26,35,540
60444,1721,902,4,73,5,22,54,34,819
29020,21408,9910,175,334,299,138,452,241,11498
29138,11196,5601,56,509,143,85,395,201,5595
13636,271,123,0,8,0,0,5,0,148
13862,4429,2290,53,107,34,11,117,27,2139
43010,260,146,0,6,0,2,8,0,114
43525,1096,538,8,33,9,0,26,11,558
44054,12613,6377,62,432,189,19,408,199,6236
44089,15527,7554,87,366,256,28,394,238,7973
45369,3492,1728,12,84,106,31,73,75,1764
98279,628,349,3,18,12,5,3,17,279
61088,6052,3005,53,165,106,36,230,112,3047
61259,1283,611,15,87,18,0,27,22,672
62672,204,105,0,1,8,0,6,3,99
47229,3122,1576,23,129,1,21,77,41,1546
48080,22596,11067,89,787,268,73,722,395,11529
43716,1874,1017,0,46,13,0,49,16,857
45849,1084,487,1,27,25,25,36,1,597
41535,422,197,0,24,10,0,12,0,225
42140,1005,499,8,32,3,10,60,10,506
42366,5684,2832,37,220,114,9,166,62,2852
42553,5260,2727,43,122,96,8,105,121,2533
43112,4945,2439,13,94,98,93,124,33,2506
35592,4655,2262,5,75,106,8,77,40,2393
40818,63,26,0,0,0,0,0,0,37
87829,683,398,0,0,49,0,17,45,285
97621,283,162,0,0,0,0,65,0,121
94805,14208,6742,16,632,142,37,559,171,7466
92110,29911,14429,367,1389,154,414,1057,283,15482
2905,25488,12381,344,678,231,437,843,429,13107
794,28755,14162,161,997,223,91,974,364,14593
99639,1036,617,0,17,35,0,18,18,419
31631,415,201,2,19,18,0,0,5,214
49224,14103,6807,207,293,145,105,308,179,7296
38930,23367,10978,167,742,146,133,861,403,12389
40514,16143,7940,120,549,213,52,496,211,8203
35458,595,315,0,0,12,0,0,0,280
37863,6903,3446,70,288,115,76,231,71,3457
20812,325,161,0,13,3,0,11,2,164
21773,5494,2856,54,121,104,26,174,141,2638
22844,4855,2196,41,91,97,39,138,86,2659
25173,349,160,0,0,19,39,0,12,189
25649,1397,613,0,23,0,22,23,0,784
33189,26937,13763,149,668,155,150,1245,358,13174
28135,5999,3899,49,446,84,0,144,45,2100
50599,402,211,5,3,7,0,3,13,191
50659,5332,2773,12,155,32,33,134,99,2559
59225,491,251,0,6,2,0,13,3,240
59761,293,181,0,0,7,0,2,4,112
44302,5127,2417,36,151,34,60,158,48,2710
65708,13789,7001,51,491,146,75,617,215,6788
47905,41910,20035,322,1390,401,257,1265,529,21875
54426,4605,2348,8,154,45,13,107,32,2257
97364,536,197,2,2,1,0,15,2,339
97856,336,199,1,6,5,0,2,2,137
98001,32625,16532,199,1115,295,98,827,645,16093
98039,3260,1635,6,78,21,0,71,48,1625
13690,835,427,0,17,15,6,32,11,408
15352,918,457,2,11,9,11,20,14,461
6091,122,58,3,6,4,0,0,0,64
1451,4625,2353,10,63,74,0,57,69,2272
37132,2387,1164,91,0,0,57,0,0,1223
38028,6965,3750,0,77,110,0,185,85,3215
56525,100,55,0,3,0,0,4,1,45
57072,556,283,11,20,13,0,20,4,273
58361,228,114,0,17,9,0,0,4,114
59077,126,60,0,3,2,0,0,0,66
95226,16,16,0,0,0,0,0,0,0
90731,61850,31170,396,2239,604,412,2191,545,30680
91101,21394,9722,132,924,181,95,848,280,11672
92305,622,284,23,6,5,0,6,12,338
99678,768,418,8,22,5,6,17,8,350
69333,293,163,0,20,10,0,9,4,130
60119,10246,4863,81,91,97,79,309,153,5383
61062,1803,952,19,51,27,10,58,44,851
61423,519,228,9,6,9,0,11,17,291
52246,23517,11751,343,1026,143,336,838,135,11766
54119,782,415,3,5,12,28,5,12,367
58565,237,139,0,0,2,0,0,6,98
64127,15457,7062,31,552,158,119,548,189,8395
70563,19565,9402,134,654,204,112,776,285,10163
71726,1339,722,17,17,17,0,41,14,617
99160,156,81,0,0,4,0,6,9,75
56293,1287,617,0,38,18,3,37,22,670
57748,392,209,0,7,11,0,22,2,183
58260,183,90,0,3,3,0,2,0,93
59010,139,76,0,3,0,0,2,5,63
59078,183,100,2,0,7,0,9,0,83
50595,9041,4378,21,223,122,39,210,115,4663
54170,3576,1828,14,112,41,26,111,50,1748
63544,650,292,0,4,2,9,7,26,358
66053,7416,3727,32,268,45,19,194,92,3689
67512,206,95,2,11,1,0,9,1,111
67651,463,236,0,15,1,1,7,5,227
55707,3353,1731,26,146,58,12,130,65,1622
55917,3742,1768,7,102,32,20,115,61,1974
70643,187,113,0,0,9,8,0,0,74
84046,383,223,0,21,0,0,11,5,160
84304,0,0,0,0,0,0,0,0,0
80631,55857,27656,866,1935,425,975,1591,559,28201
99346,466,197,13,21,10,0,0,16,269
94534,38444,18635,200,1234,476,239,1025,709,19809
90755,11555,5367,72,570,114,63,471,126,6188
90810,38579,18863,335,1156,381,426,1355,450,19716
92505,51322,25359,488,1494,293,307,1469,467,25963
99706,4,3,0,0,0,0,0,0,1
30252,46286,22260,248,1374,459,148,1636,695,24026
35757,16379,7636,212,394,174,57,461,336,8743
36908,2069,983,0,93,32,7,39,20,1086
38849,6414,3162,19,148,17,62,166,54,3252
39633,1236,614,11,2,19,0,24,6,622
40348,490,269,2,7,17,7,13,13,221
45424,50804,24467,263,1358,446,267,1591,736,26337
47527,1572,796,0,81,28,0,35,34,776
42101,61396,30161,1302,1851,369,754,1988,604,31235
94965,11408,5076,68,318,100,24,367,177,6332
91801,54479,26079,393,1902,456,332,2117,534,28400
92225,22149,13966,294,1084,160,95,522,294,8183
93933,25015,12083,271,819,253,407,720,313,12932
94037,2692,1368,44,0,54,0,137,69,1324
87123,43960,21906,229,1753,403,194,1744,558,22054
88417,0,0,0,0,0,0,0,0,0
89139,40490,20181,100,1834,150,326,2159,376,20309
2575,2707,1160,7,74,50,13,16,94,1547
54424,1541,794,1,38,22,0,39,23,747
56307,5515,2759,23,196,36,16,202,57,2756
57268,456,260,6,14,2,0,15,12,196
57706,3035,1878,261,59,0,115,66,0,1157
43519,333,162,0,10,9,0,9,7,171
32460,5831,3849,55,368,35,11,145,130,1982
35957,16135,8081,33,478,214,153,487,140,8054
36426,15293,7250,118,467,171,110,359,336,8043
49456,19146,9469,126,534,242,82,536,291,9677
31781,2264,1156,0,18,11,0,101,11,1108
38011,9855,4861,10,313,87,93,334,159,4994
61318,845,357,0,14,4,1,44,15,488
63053,56,38,0,3,0,0,2,3,18
71820,74,29,0,6,0,0,0,0,45
72441,76,38,5,0,0,0,6,0,38
73115,21032,10344,110,529,190,73,689,189,10688
67510,292,148,3,5,4,0,0,6,144
68837,178,84,0,3,0,0,20,0,94
70668,7009,3434,71,179,93,19,274,101,3575
2723,14279,7329,76,521,100,60,363,171,6950
12723,1561,750,7,16,12,0,28,18,811
8005,24013,11609,37,860,258,125,593,343,12404
10472,68796,33428,707,2316,459,507,2388,828,35368
11580,43714,20745,237,1519,521,352,1601,584,22969
1566,5618,2485,31,153,51,23,162,63,3133
28325,444,204,3,6,11,0,15,2,240
33777,17179,8273,84,479,252,108,501,264,8906
39525,8149,4036,0,149,104,54,237,115,4113
50456,1836,881,2,46,3,0,47,26,955
52554,1346,657,11,43,15,4,26,27,689
53937,1140,597,3,38,25,12,21,9,543
68876,1655,849,33,22,35,10,24,18,806
62475,445,249,8,8,0,0,31,0,196
60103,42196,21153,184,1645,445,302,1557,643,21043
70546,16878,8146,177,525,165,122,617,227,8732
54646,4183,2080,33,91,54,24,115,68,2103
72539,192,81,0,12,0,0,6,0,111
44678,344,132,0,0,45,0,41,0,212
54473,2674,1437,22,63,37,0,98,26,1237
55702,549,297,11,12,7,0,8,8,252
55771,1639,886,17,23,21,0,30,19,753
37660,39062,17896,329,1050,301,125,953,588,21166
38375,8810,4358,18,368,200,62,161,80,4452
40372,2090,1122,51,36,6,0,71,11,968
40829,185,114,0,0,0,0,21,0,71
45227,18391,8674,34,609,175,53,650,359,9717
45858,2880,1501,3,79,18,2,101,17,1379
35205,20109,10085,90,692,228,346,582,69,10024
35540,2436,1172,46,37,15,0,54,33,1264
28531,1361,650,0,13,24,21,14,8,711
29635,1225,616,0,12,39,0,16,23,609
13743,3576,1804,19,127,65,38,92,77,1772
2817,6033,2910,60,239,74,0,192,135,3123
4652,1607,804,0,47,21,0,35,39,803
6756,2849,1361,49,98,49,0,82,64,1488
7006,25529,12137,59,768,325,104,827,474,13392
22538,78,29,0,0,0,0,0,0,49
22722,209,111,0,29,0,0,15,0,98
12414,10203,5300,189,304,193,52,96,299,4903
12522,4833,2313,30,57,36,14,95,14,2520
12827,3665,1922,12,101,89,11,101,35,1743
2347,11335,5751,58,289,120,56,284,240,5584
2534,741,399,49,0,9,0,13,0,342
58422,166,85,4,3,0,1,2,4,81
60539,273,227,0,0,0,0,0,18,46
60914,29969,13951,179,832,160,624,675,290,16018
61459,385,210,10,4,0,0,21,12,175
62225,5128,2930,85,193,0,17,262,12,2198
57366,2435,1211,6,82,40,4,87,20,1224
33063,54937,25366,330,1752,587,267,1969,939,29571
33135,39789,19996,208,1907,318,314,1272,549,19793
77708,12918,6162,86,323,87,105,408,170,6756
95628,41121,20009,186,1294,648,99,1319,682,21112
96722,2213,1000,0,57,45,0,82,52,1213
89822,2072,1122,8,129,7,27,56,8,950
90278,40649,20964,94,2083,278,54,1674,522,19685
93544,1181,647,0,31,9,0,0,31,534
78756,8323,4114,0,522,87,16,302,95,4209
79543,1179,600,0,29,8,3,23,16,579
48180,61574,29829,443,1636,587,524,1796,1013,31745
8723,32944,15958,264,853,385,89,899,586,16986
766,23201,11297,169,658,153,123,680,257,11904
1036,5191,2550,35,149,79,27,160,113,2641
30097,46905,22612,142,1273,283,113,1702,805,24293
28086,25037,12059,131,567,264,92,719,341,12978
42764,510,275,0,0,25,18,42,6,235
43605,26096,12817,72,686,248,143,847,336,13279
65074,2723,1327,3,103,14,54,59,43,1396
58524,91,36,0,3,2,0,3,2,55
59441,59,32,0,0,0,3,0,0,27
62093,477,243,0,11,11,0,2,4,234
98829,829,397,0,11,0,0,51,8,432
95970,551,258,0,5,25,4,0,32,293
67260,0,0,0,0,0,0,0,0,0
70443,10602,5346,64,453,97,3,577,178,5256
92354,21679,10199,117,880,169,215,649,291,11480
93526,570,305,0,26,7,2,15,14,265
93660,4228,2076,29,164,32,32,166,25,2152
80524,35753,18037,301,1090,366,381,1079,456,17716
75189,27179,13214,96,822,195,76,1262,366,13965
85654,0,0,0,0,0,0,0,0,0
64631,689,325,0,3,25,9,18,24,364
65739,1040,564,0,29,18,0,16,6,476
46511,4254,1997,10,110,51,24,129,98,2257
47441,9421,4724,93,248,70,64,365,197,4697
40322,3265,1712,6,60,35,5,53,25,1553
40840,176,78,0,0,0,0,0,0,98
37753,801,414,0,26,0,0,0,10,387
38226,266,129,0,6,8,0,5,12,137
39427,1349,749,46,52,34,15,75,46,600
60467,26628,12745,30,462,346,57,632,354,13883
62094,1148,547,0,2,6,12,41,12,601
63745,21,10,0,0,0,0,0,0,11
57242,405,204,15,9,5,4,10,6,201
52141,1372,756,0,21,31,2,20,20,616
53037,9976,4659,42,336,101,37,221,130,5317
50026,610,303,0,5,2,2,11,18,307
50441,5371,2549,0,112,28,29,103,72,2822
3867,21519,10594,91,608,355,137,768,317,10925
5062,694,337,0,15,18,4,23,3,357
6785,686,360,0,14,21,16,8,25,326
13468,471,233,6,28,0,0,3,13,238
15419,4358,1823,100,120,41,224,97,207,2535
23806,1707,740,136,0,0,166,0,0,967
26164,7553,3621,75,193,151,12,198,128,3932
20190,19204,9192,92,913,106,55,883,218,10012
20198,2175,997,0,23,29,0,35,7,1178
20260,0,0,0,0,0,0,0,0,0
21054,11009,5394,12,319,58,46,366,123,5615
27801,19737,8799,259,556,204,191,726,317,10938
28089,217,51,6,0,0,22,0,1,166
28217,29410,14903,185,1343,148,176,1071,413,14507
19032,6630,3256,74,286,44,0,271,77,3374
29379,17485,8512,130,458,249,77,529,319,8973
11953,13401,6342,51,462,188,71,473,175,7059
12187,598,333,12,11,0,0,26,29,265
12450,154,76,0,0,0,0,0,0,78
76844,3706,1657,0,52,54,19,73,18,2049
78736,9047,4304,0,161,35,83,258,170,4743
79407,22065,10559,189,723,184,211,562,202,11506
54623,2160,1126,16,54,27,16,74,46,1034
58356,1755,812,0,45,16,6,45,21,943
65721,30430,14891,206,1022,211,172,1153,440,15539
57421,129,59,0,0,0,0,0,0,70
63664,9076,4328,28,352,51,34,261,146,4748
72211,22269,10188,140,800,288,77,634,331,12081
54762,1302,642,7,15,18,0,29,21,660
43545,14182,6886,64,396,178,65,451,137,7296
39338,3834,1855,82,182,50,72,78,70,1979
40067,6082,3075,52,126,80,56,172,97,3007
36112,320,274,27,0,0,28,0,0,46
46106,6725,3461,11,217,27,17,155,71,3264
47957,1954,983,7,114,17,19,96,4,971
48749,1063,497,7,23,50,4,26,11,566
49301,20382,10185,54,693,175,27,656,456,10197
15638,190,85,0,10,0,0,10,0,105
19121,30733,13608,599,625,169,726,825,605,17125
5829,1631,788,11,53,24,4,42,33,843
6037,19272,9322,49,414,243,56,466,347,9950
28214,41356,19332,170,1539,225,291,1953,357,22024
28358,38760,18564,276,1053,312,296,1291,500,20196
28601,51706,25084,383,1230,529,401,1633,818,26622
29351,1329,709,0,95,6,0,21,0,620
13073,6475,3405,7,224,99,21,177,105,3070
24857,827,452,0,14,0,0,0,69,375
24894,312,132,0,6,3,0,10,24,180
25132,129,68,0,0,0,0,16,0,61
14711,1915,1003,11,32,19,2,24,22,912
15030,1089,605,4,31,18,0,17,31,484
95485,2688,1406,0,51,55,0,75,91,1282
95837,305,184,5,0,0,0,0,4,121
96093,3955,2070,0,79,25,0,333,0,1885
91301,25631,12447,103,792,221,156,827,425,13184
98827,396,289,135,0,6,0,0,0,107
3110,22388,10822,111,464,258,101,814,334,11566
60712,12539,6097,11,311,175,61,304,240,6442
62319,261,133,0,3,0,0,0,0,128
78677,19,12,0,0,0,0,0,0,7
79838,6376,3109,17,255,92,0,155,62,3267
80468,410,194,0,0,24,0,17,0,216
58266,167,110,0,0,4,0,0,0,57
64644,3264,1624,28,119,29,5,87,28,1640
67013,2824,1490,0,66,54,0,46,56,1334
73150,4770,2253,39,89,75,18,137,59,2517
75137,19586,9234,111,461,151,76,387,313,10352
52552,922,465,0,36,12,1,28,4,457
54667,4957,2477,15,119,43,18,136,42,2480
40334,69,22,0,0,0,0,0,0,47
44721,14149,6778,120,360,204,172,431,273,7371
46368,38715,18639,136,1409,391,205,1211,576,20076
46539,2540,1222,9,79,25,35,51,13,1318
60087,26678,13117,558,673,212,255,785,450,13561
57069,11970,5949,377,244,114,467,270,144,6021
58643,161,77,2,6,0,0,0,0,84
35651,1255,516,0,35,10,5,53,5,739
4274,5605,2853,2,123,76,0,157,53,2752
14213,24167,12199,267,765,275,151,797,223,11968
15241,20632,10108,96,553,220,58,442,246,10524
17256,211,148,0,17,0,0,0,0,63
30313,11529,7118,843,238,34,454,187,28,4411
30540,20169,10115,111,488,335,239,542,327,10054
31002,3071,1628,0,88,12,11,113,22,1443
31707,26094,11504,37,834,198,229,1295,446,14590
32220,13179,6620,182,488,131,17,458,133,6559
32257,38651,18677,95,1346,521,201,1394,412,19974
32259,49969,24131,251,1720,324,198,1760,494,25838
24554,3871,1892,19,75,59,0,121,123,1979
20110,48509,24812,301,1989,440,121,1747,572,23697
21783,9022,4530,59,327,101,49,349,105,4492
17562,4546,2336,17,112,42,67,66,54,2210
12508,19747,10034,213,891,247,82,763,322,9713
29385,7834,3487,41,193,88,70,121,52,4347
29401,9627,4289,250,86,127,202,72,55,5338
29512,18182,9863,28,817,313,79,502,291,8319
80249,30625,14929,237,1509,206,150,1532,217,15696
65686,5105,2458,16,74,114,0,98,25,2647
73701,23646,11999,217,877,253,243,743,251,11647
74060,450,232,2,21,5,4,9,14,218
74463,2145,1147,7,244,0,11,184,0,998
75201,15891,8694,26,622,208,10,635,143,7197
77017,32720,16721,143,1221,214,258,1047,375,15999
67663,2695,1182,0,73,19,0,62,9,1513
68020,520,258,0,0,6,0,5,8,262
89029,7707,3859,10,133,165,9,87,108,3848
90007,41716,21129,1703,1005,220,1428,773,271,20587
79506,725,383,0,16,18,0,2,9,342
71119,11087,5262,21,258,85,63,308,311,5825
92278,4737,4171,595,98,0,0,68,0,566
92371,17882,9162,132,492,153,48,627,425,8720
95691,37906,18101,283,1594,362,322,1719,247,19805
95736,198,99,8,0,0,0,0,0,99
95949,20519,9959,118,569,387,117,392,446,10560
94102,31067,17760,133,1830,425,163,1222,354,13307
48357,8340,4063,7,173,73,45,256,99,4277
43718,2926,1459,12,77,15,24,25,50,1467
51354,969,497,4,19,11,0,17,20,472
34433,5957,2835,52,88,188,0,195,173,3122
40057,3579,1899,32,205,61,25,132,47,1680
13844,758,387,7,19,11,9,52,12,371
14055,1562,883,7,10,10,0,21,25,679
16159,4572,2142,35,110,26,82,164,107,2430
30677,18337,8668,161,419,181,71,532,227,9669
32092,34642,17108,136,1273,543,59,1397,474,17534
33418,40225,19315,224,1002,456,61,798,706,20910
24729,182,87,0,11,12,0,12,0,95
8012,38407,19177,382,1229,540,187,1134,531,19230
8514,5046,2401,22,12,31,17,221,117,2645
8822,31119,14817,180,1071,226,177,1041,482,16302
11419,49618,24983,393,1447,486,373,1365,528,24635
11548,2963,1319,110,0,17,118,0,4,1644
11940,5404,2860,34,74,50,27,51,151,2544
19137,8482,4442,41,384,74,57,236,88,4040
36753,8,0,0,0,0,0,0,0,8
24325,907,496,24,28,14,0,0,8,411
24479,1521,799,0,33,30,0,28,15,722
26151,781,443,0,32,14,0,0,25,338
43203,8368,4030,76,291,56,63,398,51,4338
1775,7098,3332,17,190,45,20,250,109,3766
19086,11537,5789,39,222,115,1,322,190,5748
27924,3448,1349,41,175,24,0,59,123,2099
44470,3953,1968,44,99,84,16,170,12,1985
58761,895,457,0,42,11,10,19,19,438
59201,5583,2739,28,143,76,42,180,73,2844
59244,24,10,0,0,0,0,0,2,14
60194,18946,9011,49,796,157,98,705,279,9935
62074,1333,625,16,9,1,2,32,28,708
68361,2222,1108,2,82,21,6,95,42,1114
70520,19600,9891,117,723,226,41,828,179,9709
64651,666,338,0,10,2,5,5,4,328
64686,157,70,0,11,3,0,0,10,87
67639,155,96,0,7,0,0,1,0,59
64445,286,134,0,7,6,3,0,3,152
72631,3709,1683,21,51,130,0,57,85,2026
73455,673,326,4,15,8,0,10,3,347
80118,6395,3113,24,101,88,24,93,108,3282
75019,42597,20887,209,1454,260,71,1835,516,21710
84015,65730,32775,656,2474,291,609,2503,582,32955
92591,41107,19534,221,1265,316,324,1358,491,21573
94573,31,21,0,0,0,0,0,0,10
94920,12797,5987,0,272,181,16,271,271,6810
96725,2984,1623,0,85,47,0,137,20,1361
3894,6212,3079,100,0,48,0,68,173,3133
4238,1775,930,8,36,21,12,98,14,845
4418,1727,932,3,69,36,3,41,48,795
7058,5068,2420,0,213,0,19,191,68,2648
1238,5903,2860,31,116,81,11,250,135,3043
2149,45596,22379,180,1467,248,373,1623,413,23217
55758,143,72,0,1,3,0,2,0,71
40865,429,205,15,17,6,6,6,13,224
47344,128,59,0,6,2,0,8,1,69
47455,82,33,0,0,0,0,0,0,49
5034,332,166,0,0,0,45,0,19,166
5655,2932,1444,8,78,9,0,117,37,1488
85365,50690,26278,738,1241,581,209,1056,501,24412
96086,309,160,0,3,11,2,5,7,149
97214,26207,13533,95,1401,257,98,1483,152,12674
21045,39946,19932,230,1279,331,100,1468,391,20014
65589,73,40,0,0,19,0,0,0,33
22473,5168,2441,8,119,131,0,118,145,2727
55781,756,407,0,11,21,0,8,30,349
58838,151,76,0,6,1,9,0,5,75
29118,17232,8270,132,463,230,28,817,245,8962
35572,1319,659,23,0,30,0,88,9,660
39423,2623,1323,35,35,63,0,92,35,1300
43466,2059,1025,11,52,69,0,66,27,1034
48390,23818,11732,146,841,229,71,758,327,12086
50473,408,241,0,25,2,0,16,13,167
51036,1018,560,0,16,12,0,27,42,458
11951,12391,6147,118,298,53,74,407,92,6244
12095,12228,6227,51,455,77,84,324,175,6001
12945,581,245,0,45,25,0,18,11,336
27606,46589,24521,1212,1721,164,955,1153,413,22068
27883,2970,1381,24,117,50,0,89,40,1589
31780,2100,924,3,39,78,14,22,35,1176
32133,34,9,0,0,0,0,0,0,25
24104,3298,1591,27,114,42,40,156,26,1707
29570,3402,1617,10,69,29,0,162,35,1785
20175,33723,16552,63,1272,293,158,1137,470,17171
93637,39381,18240,318,1294,259,368,1813,338,21141
87828,350,83,0,0,10,0,0,39,267
95219,29668,14752,189,934,289,266,1014,531,14916
86035,2095,980,6,47,9,18,36,29,1115
98314,2353,1973,443,33,0,47,0,0,380
99568,315,179,5,0,13,9,0,16,136
7513,12447,6156,162,351,49,85,497,99,6291
25512,907,518,0,24,8,0,13,12,389
33566,20602,10079,86,745,261,80,614,270,10523
36528,1229,653,3,20,27,9,33,52,576
38118,38664,18042,201,992,175,520,1575,604,20622
22304,48211,22885,194,2258,510,379,2007,526,25326
23836,13601,6733,45,410,208,139,540,224,6868
21626,83,48,0,0,0,0,0,0,35
28751,3387,1598,0,52,119,36,70,59,1789
79932,28682,14289,201,802,160,52,966,216,14393
83460,227,68,7,0,0,1,0,0,159
70805,27365,13239,263,863,301,182,642,262,14126
71078,7266,3666,34,221,66,0,280,50,3600
73067,2336,1226,12,96,32,24,80,23,1110
73430,1336,696,13,67,15,0,24,18,640
74071,148,75,1,6,0,2,2,3,73
94516,148,86,0,4,2,2,5,0,62
95430,7,7,0,0,7,0,0,0,0
97007,72592,35603,325,2786,543,417,2777,947,36989
89429,7278,3599,0,167,185,68,333,122,3679
90804,39344,19256,796,1579,242,386,1567,307,20088
92054,42173,21422,421,1617,273,140,1632,570,20751
92223,53914,25865,365,1861,466,340,2109,577,28049
92582,16783,8175,68,755,43,190,550,192,8608
93653,1383,641,0,12,10,0,21,51,742
74436,5718,2824,91,153,80,6,130,79,2894
74723,1399,701,3,18,49,5,29,24,698
75925,4083,1808,5,112,16,17,190,51,2275
63901,35118,16742,120,1131,499,121,1117,562,18376
64106,9326,5213,48,374,27,64,296,46,4113
56578,705,386,0,15,9,2,17,20,319
56763,5157,2777,55,117,42,46,155,68,2380
58011,446,230,0,9,4,0,13,9,216
45886,502,273,0,14,8,1,15,2,229
46939,1716,970,3,56,46,0,53,12,746
47884,157,67,0,10,2,0,6,3,90
2802,671,371,0,0,0,0,17,0,300
57016,756,363,0,24,7,0,21,7,393
58505,0,0,0,0,0,0,0,0,0
62872,1067,518,0,39,25,6,38,6,549
72581,956,495,0,16,21,0,44,0,461
923,24028,11099,149,604,262,133,763,492,12929
2090,15880,7666,83,273,186,50,347,176,8214
96031,136,69,0,8,2,0,8,0,67
97042,3148,1565,53,86,69,28,119,74,1583
98053,22175,11024,84,774,229,57,912,355,11151
98572,680,379,0,53,0,0,24,2,301
98929,0,0,0,0,0,0,0,0,0
99579,83,57,0,1,4,0,3,0,26
93405,36550,21034,1752,921,133,1575,352,159,15516
94903,30048,14637,53,839,219,34,710,612,15411
40806,2424,1135,0,81,9,10,43,15,1289
44454,982,478,0,13,0,0,43,0,504
35228,10349,4696,90,282,116,74,467,197,5653
35459,1304,652,5,53,12,8,25,25,652
35759,7606,4001,49,363,39,16,242,95,3605
30291,21399,9035,306,521,200,105,677,303,12364
31558,21307,11109,326,684,175,157,554,209,10198
70076,248,173,0,25,20,0,0,0,75
73121,3558,1682,28,97,36,15,80,73,1876
50629,2220,1074,0,78,30,11,81,36,1146
51535,1861,964,8,41,6,0,24,17,897
46168,34478,17432,332,1118,266,176,1139,493,17046
46994,2892,1470,11,73,17,30,103,17,1422
50538,474,234,0,7,8,7,6,11,240
52205,8874,4829,69,348,96,54,203,128,4045
52345,1477,730,19,66,9,3,42,21,747
52806,27872,12934,144,942,375,228,740,411,14938
53192,51,0,0,0,0,0,0,0,51
36276,2615,1299,25,61,37,7,99,61,1316
36756,5792,2770,47,420,115,145,202,0,3022
36783,678,323,0,16,7,0,22,0,355
38348,950,561,21,23,17,0,0,18,389
56289,705,376,12,17,15,0,11,10,329
59105,31560,15757,201,1047,310,117,946,485,15803
38483,5568,2670,30,221,60,0,207,98,2898
12912,2119,962,4,49,15,12,54,51,1157
13114,6120,3136,19,162,85,79,144,78,2984
14028,1703,869,0,104,20,15,90,69,834
14143,940,494,4,31,21,9,18,15,446
32505,24965,11551,151,575,146,181,977,507,13414
2464,3103,1496,0,112,63,0,72,76,1607
2806,16192,7785,85,387,192,37,458,159,8407
4346,1996,913,0,73,50,0,79,23,1083
4694,2193,1086,0,72,25,14,83,51,1107
10920,9008,4547,132,151,60,37,208,73,4461
6255,4560,2499,50,164,70,47,163,88,2061
6810,51813,25614,255,2099,364,379,1760,551,26199
7306,52945,27423,272,2330,634,228,2010,467,25522
1009,249,134,0,0,0,0,11,0,115
54474,3929,1811,19,109,34,0,137,43,2118
54839,211,107,0,7,0,0,3,0,104
45153,1804,914,8,92,28,0,19,4,890
31601,32084,15609,374,563,195,430,959,287,16475
32206,16500,7954,70,436,158,73,582,180,8546
33144,30235,14268,126,1087,368,58,792,412,15967
33145,31465,15050,159,1276,326,190,809,602,16415
19950,7515,3807,31,183,71,100,300,82,3708
22530,45,37,0,0,0,0,0,0,8
23846,1127,587,22,0,0,25,15,10,540
25678,1409,673,23,29,24,4,9,36,736
28628,494,214,0,10,0,0,21,9,280
29448,2309,746,0,47,54,9,174,12,1563
35645,14011,6528,110,461,156,44,465,235,7483
27826,915,703,0,66,16,0,0,0,212
4109,100,46,0,5,0,0,6,0,54
4956,920,489,7,15,29,3,39,13,431
8246,87,52,0,0,0,0,0,0,35
2647,90,37,0,0,0,0,0,0,53
47950,894,491,0,22,17,0,39,0,403
46202,20007,10542,182,754,136,377,509,141,9465
37726,1965,1055,0,47,56,22,49,22,910
49633,3678,1902,20,137,58,6,89,65,1776
50124,4053,1927,15,117,45,0,160,39,2126
50252,205,134,3,0,0,0,0,0,71
40231,0,0,0,0,0,0,0,0,0
54511,1272,666,3,37,19,18,42,37,606
54731,683,381,5,19,14,4,12,4,302
54982,7079,3555,22,99,109,24,157,114,3524
55940,2795,1360,5,103,41,4,79,24,1435
60193,40248,19674,101,1519,445,76,1621,545,20574
61410,3892,1731,20,176,20,42,134,47,2161
61568,4223,2116,35,149,60,18,114,40,2107
61953,6067,3131,44,255,62,52,232,72,2936
66210,18691,9366,79,583,174,236,533,309,9325
74724,399,215,0,24,4,0,11,5,184
76567,9170,4815,26,279,103,11,246,93,4355
77376,535,270,0,0,0,0,0,0,265
79009,1728,902,27,32,0,19,56,27,826
73660,342,166,0,5,2,0,9,7,176
99023,627,280,0,24,0,0,31,0,347
99586,302,175,0,6,0,2,2,0,127
97208,0,0,0,0,0,0,0,0,0
81251,159,87,0,0,0,0,0,0,72
82930,14183,7193,144,586,91,37,517,145,6990
92356,6065,3096,35,170,115,37,254,91,2969
28667,453,218,0,3,0,20,5,11,235
29732,58571,28363,386,1948,663,339,2344,786,30208
37710,1006,462,28,28,8,11,18,10,544
37873,4447,2225,0,113,41,6,105,89,2222
44285,25,13,0,0,0,0,0,0,12
44880,2844,1496,23,54,20,29,57,25,1348
46143,56217,27743,276,2145,586,293,2200,753,28474
31321,7640,3765,125,190,127,46,267,163,3875
99150,414,193,0,15,28,0,13,21,221
83643,138,69,0,6,27,0,0,0,69
84537,1443,767,0,50,15,18,46,28,676
80501,41951,20576,463,1549,330,384,1685,503,21375
95374,1758,926,12,66,22,22,82,20,832
38058,9777,4832,57,320,127,120,401,95,4945
57626,1060,517,2,31,4,0,54,14,543
58712,108,52,0,0,4,2,4,11,56
54484,5024,2554,22,174,60,31,158,35,2470
55713,1084,547,27,8,20,4,14,12,537
56027,719,377,4,45,10,0,14,2,342
45431,28084,13893,232,848,207,350,881,304,14191
49684,40308,19552,219,1219,484,248,1168,602,20756
50144,2713,1385,0,100,24,23,65,40,1328
50539,625,327,0,24,5,2,28,10,298
52155,1473,760,0,39,17,0,65,7,713
40977,10512,5270,54,459,120,62,293,172,5242
42518,2763,1381,0,78,61,18,163,51,1382
61603,16655,7838,79,541,88,182,675,220,8817
48026,14638,6880,39,390,194,74,425,279,7758
31804,5865,3072,24,103,77,14,167,74,2793
19931,242,121,0,17,7,5,0,1,121
24606,170,73,0,33,0,8,0,27,97
33954,9294,4391,0,170,217,102,158,308,4903
37122,56964,28525,389,2007,643,109,2130,780,28439
18932,421,224,0,14,8,0,13,0,197
19130,27410,13171,82,928,294,98,1237,263,14239
27231,1963,1024,36,49,58,14,90,23,939
95542,2072,1058,0,21,51,1,19,98,1014
97018,2065,1042,16,59,44,0,37,44,1023
97466,1116,468,0,17,13,0,14,21,648
15479,1955,985,17,63,21,81,17,4,970
17026,3755,1839,32,108,18,39,89,49,1916
17239,247,107,0,8,4,0,2,6,140
19123,15681,7876,40,846,91,88,503,118,7805
32837,54051,27190,453,1799,402,334,2325,665,26861
25962,3375,1626,13,39,26,0,70,56,1749
28204,6725,3289,31,281,49,35,261,58,3436
7506,18802,9548,66,823,193,112,713,270,9254
8008,6921,3166,3,49,140,22,79,168,3755
10606,16600,8372,208,776,111,29,385,186,8228
13441,124,85,25,0,0,0,0,0,39
1540,11484,5954,17,222,94,44,495,385,5530
2779,6679,3235,0,222,76,44,282,102,3444
71462,1849,941,14,57,11,7,26,18,908
48876,4082,2118,37,112,73,43,112,29,1964
91790,45206,21972,263,1460,447,261,1413,605,23234
92128,51066,24071,152,1296,524,127,1660,951,26995
94587,74601,38120,503,2914,1040,303,2509,752,36481
95448,17482,8528,35,379,274,42,454,272,8954
77380,25879,12933,139,1153,258,158,745,250,12946
40063,291,291,0,41,5,0,0,0,0
46617,9422,4744,103,226,148,66,240,103,4678
47022,3169,1658,20,66,87,14,43,6,1511
47141,1650,812,14,68,9,45,55,0,838
65781,8476,3885,33,320,107,8,420,82,4591
65809,11702,5510,40,386,195,8,326,103,6192
66717,504,234,0,11,2,7,17,10,270
68418,1152,570,3,39,4,0,47,8,582
76059,5211,2376,47,178,30,118,121,41,2835
76706,38597,18623,1624,839,175,1743,875,337,19974
59410,607,293,9,7,3,3,20,2,314
79373,2875,1447,14,44,48,14,60,55,1428
30436,12092,5755,46,259,117,43,330,103,6337
50151,583,273,0,0,4,0,19,13,310
71336,1474,739,8,46,28,0,30,49,735
38305,52662,24535,378,1415,676,555,1735,764,28127
12932,1194,550,0,16,17,0,12,30,644
32250,26956,13914,55,820,376,31,840,366,13042
13810,1114,508,9,8,7,17,43,29,606
33155,47450,22392,241,1835,451,338,2058,981,25058
63548,1307,672,0,41,5,19,34,25,635
38328,580,352,0,12,33,0,69,0,228
39666,10265,5161,82,322,107,131,316,162,5104
71325,1094,529,0,42,27,0,86,27,565
45224,21402,9465,97,514,279,145,338,448,11937
45760,3823,1928,0,79,27,1,110,62,1895
46392,7940,3891,69,269,150,47,309,240,4049
41092,3891,2102,25,178,51,34,155,63,1789
55455,1108,500,22,0,0,57,0,0,608
55901,54721,25971,281,2103,492,511,1761,608,28750
42325,2515,1403,0,108,36,0,39,36,1112
42456,1296,585,3,50,17,2,35,17,711
30213,32729,15146,38,1249,217,293,2225,540,17583
30619,1277,725,1,121,5,1,41,3,552
32631,264,61,0,0,10,0,0,38,203
35649,89,35,0,0,0,0,0,4,54
45890,488,238,2,6,5,0,23,1,250
38080,2692,1368,28,38,33,8,52,7,1324
15954,2093,1063,34,55,26,12,21,30,1030
19453,1662,931,17,43,0,0,45,79,731
5851,6491,3431,130,182,79,80,170,68,3060
27813,825,384,4,7,8,2,36,5,441
28461,19897,9250,84,302,433,86,417,382,10647
29680,32031,15661,100,1237,357,207,1487,580,16370
29821,1558,746,6,14,36,9,29,31,812
11205,46064,21340,528,1924,217,673,2031,517,24724
11379,37851,17886,209,1305,347,126,1611,516,19965
11950,15884,7827,127,550,92,95,409,177,8057
21502,42583,23204,182,1609,628,231,1068,587,19379
14173,387,183,0,9,0,0,8,0,204
90505,37641,18656,241,1385,404,111,1200,508,18985
97527,35822,17629,142,1008,484,113,799,492,18193
97634,154,78,0,0,0,0,0,0,76
98266,3993,2036,147,92,33,3,82,50,1957
99605,95,25,0,0,0,0,8,0,70
99688,2624,1459,11,77,22,22,105,49,1165
1420,40737,20170,458,1292,201,505,1197,510,20567
61476,375,183,0,9,23,0,16,10,192
63048,3875,1878,0,172,19,0,114,42,1997
78133,18398,9007,27,446,276,58,497,360,9391
78258,46418,22520,247,1487,234,279,1721,460,23898
80643,4177,2182,51,136,73,19,135,51,1995
81073,1839,888,0,48,18,0,32,25,951
70523,788,414,0,4,3,0,92,10,374
58638,1143,626,4,40,14,6,31,12,517
59027,678,315,0,4,27,0,24,47,363
67456,4272,1884,74,71,57,67,119,52,2388
68436,506,267,0,9,2,2,6,9,239
68776,14879,7372,107,485,154,54,488,180,7507
75076,7847,3895,7,199,83,0,221,284,3952
75182,6218,3239,13,220,38,36,169,96,2979
76108,43178,21265,68,1885,445,342,1739,530,21913
77707,18609,8539,128,541,123,37,661,224,10070
95336,47612,23105,489,1616,557,343,1266,523,24507
54542,404,219,0,9,12,2,17,14,185
55150,225,119,9,0,1,0,12,1,106
37032,4836,2570,62,212,88,32,163,28,2266
37645,5044,2670,15,188,59,0,143,68,2374
40272,37984,17691,92,1129,503,238,1016,603,20293
47175,920,419,0,6,62,0,0,9,501
47846,552,330,0,8,12,5,29,10,222
47850,2386,1232,4,43,23,0,122,13,1154
59466,133,81,7,4,0,0,6,5,52
59532,168,82,0,0,4,0,0,9,86
58647,1230,557,3,54,3,4,47,6,673
58794,222,118,0,13,7,0,2,8,104
35130,2892,1380,7,81,46,0,52,39,1512
30314,24446,11225,483,551,193,625,667,240,13221
32530,0,0,0,0,0,0,0,0,0
32767,3273,1817,26,35,70,9,61,51,1456
26270,507,277,0,26,19,0,14,22,230
8063,3072,1422,5,127,23,36,155,28,1650
10314,90761,43762,506,2151,1302,676,2546,1365,46999
23039,994,565,0,34,10,0,0,51,429
19120,74971,35855,555,2057,554,574,2894,651,39116
19554,411,189,0,21,20,0,15,18,222
83233,0,0,0,0,0,0,0,0,0
77065,38265,18497,334,1319,206,312,1508,366,19768
66720,11363,5425,107,348,101,53,408,157,5938
67067,1735,834,8,50,9,16,63,41,901
88411,46,21,0,0,2,0,0,0,25
89115,61811,30255,613,2051,333,664,2251,531,31556
79528,719,311,0,3,4,0,5,3,408
71378,2275,1017,0,37,6,24,46,49,1258
71418,6589,3333,76,197,57,94,86,62,3256
71969,270,151,0,8,0,0,13,0,119
97882,8110,5386,71,367,81,26,83,121,2724
95923,28,14,0,0,0,0,0,0,14
41201,151,80,31,0,21,0,10,0,71
49088,3656,1890,24,123,54,33,134,69,1766
44287,7688,3704,87,179,85,36,188,139,3984
13461,3031,1488,4,59,32,40,80,64,1543
16353,2660,1406,15,42,56,18,50,26,1254
16651,5652,4051,56,460,67,19,72,31,1601
16732,283,163,0,0,7,0,0,9,120
33158,6641,3379,61,76,67,49,160,76,3262
10173,0,0,0,0,0,0,0,0,0
29162,3046,1402,3,74,44,2,56,49,1644
17813,2131,1053,12,44,25,6,48,11,1078
19506,7162,3577,39,186,101,31,173,125,3585
49342,1890,979,3,57,13,10,41,20,911
37213,100,87,0,11,0,0,0,0,13
42217,3254,1754,66,54,14,42,42,27,1500
2143,26151,12674,153,1012,218,57,1279,222,13477
17944,154,69,0,0,0,0,2,0,85
18846,998,507,0,42,7,9,19,28,491
18960,12200,5962,160,339,240,50,476,192,6238
26327,76,25,0,0,0,0,0,0,51
26338,809,461,0,51,23,0,20,24,348
45723,3481,1752,4,77,63,0,91,39,1729
47408,25723,13147,1345,742,178,1345,601,136,12576
58369,1111,604,7,16,21,9,23,23,507
59315,86,41,0,0,0,0,1,9,45
60936,4103,1902,17,108,29,0,162,101,2201
64741,220,131,0,6,2,0,0,9,89
65555,1215,618,11,43,42,22,18,16,597
66060,1383,724,9,27,6,4,34,13,659
56514,3674,1881,13,128,36,10,154,33,1793
57058,2048,1084,36,80,38,22,61,30,964
57362,2072,1054,7,61,16,13,64,22,1018
63855,1153,568,10,28,14,0,30,33,585
64440,592,301,0,27,8,0,20,11,291
72415,1532,841,6,48,18,9,44,13,691
80401,42169,22184,591,1610,517,321,939,883,19985
80816,6245,3199,0,75,226,0,84,168,3046
83455,5210,2554,13,308,38,94,247,83,2656
84311,634,321,18,22,2,5,11,2,313
86426,14587,7203,66,459,215,58,386,198,7384
92364,0,0,0,0,0,0,0,0,0
95008,46513,22753,202,1743,449,203,1857,796,23760
5770,943,428,0,20,13,0,20,15,515
54666,2810,1533,13,95,33,0,96,45,1277
41031,15812,7687,137,416,267,128,461,258,8125
42055,2577,1365,43,31,80,16,61,45,1212
47386,1176,557,2,52,26,17,36,25,619
4431,42,22,0,0,0,0,0,0,20
4474,3666,1795,26,105,44,13,143,102,1871
6482,11173,5511,55,164,33,49,186,140,5662
16049,2951,1458,26,60,48,4,103,46,1493
58744,95,53,2,0,0,0,0,1,42
61721,592,307,5,17,9,1,12,25,285
75249,16482,7737,132,781,169,40,680,308,8745
81654,1643,828,0,37,19,0,14,0,815
82190,1075,533,34,3,7,29,4,9,542
21522,164,91,0,0,8,0,0,0,73
21601,23458,11214,51,792,258,139,652,289,12244
21655,4966,2639,17,155,66,1,134,118,2327
55614,2327,1147,1,37,11,2,49,54,1180
57037,1023,513,12,65,10,8,39,8,510
57045,1117,539,3,21,10,0,9,40,578
90061,27646,13079,162,885,222,260,896,357,14567
70808,33756,15553,349,713,472,663,964,267,18203
92692,47576,23374,323,1086,516,166,1378,793,24202
30523,12230,5928,116,218,145,52,383,184,6302
77650,1860,806,32,0,50,39,34,86,1054
99025,4901,2621,0,175,118,0,133,41,2280
72828,45,24,0,0,9,0,0,0,21
38744,845,495,0,38,39,0,25,17,350
39561,2543,1310,53,169,12,0,185,40,1233
67159,108,65,0,0,8,0,1,3,43
45214,7791,3501,37,164,80,22,156,119,4290
11004,15234,7144,69,483,163,159,310,321,8090
36033,4426,2062,0,78,22,8,216,63,2364
63091,1534,736,2,27,20,3,24,9,798
41168,2333,1205,0,31,42,15,12,55,1128
57521,175,79,0,12,0,0,14,0,96
46704,38,20,0,0,0,0,0,0,18
41725,241,83,0,8,0,0,16,0,158
41751,195,73,0,0,0,0,11,0,122
42157,623,338,10,8,7,17,16,7,285
50511,6975,3291,56,173,147,65,156,141,3684
50544,410,220,0,15,7,0,7,3,190
51047,697,387,0,24,17,8,13,30,310
15622,1172,657,0,7,2,23,39,26,515
15677,375,179,0,0,4,0,8,0,196
15739,514,242,5,46,8,0,28,6,272
4006,154,66,0,0,0,29,0,9,88
4101,17252,8577,152,734,169,146,649,154,8675
4574,1456,771,5,39,38,0,30,11,685
4579,3089,1507,15,28,9,0,64,59,1582
24981,410,204,0,0,20,0,0,0,206
25849,302,193,0,0,0,0,0,19,109
21214,21177,10067,65,734,136,55,829,309,11110
21543,164,91,0,0,9,0,0,0,73
22942,8915,4268,0,200,88,75,220,139,4647
17540,10773,5325,88,320,148,41,297,168,5448
19055,14095,6981,69,628,126,96,461,184,7114
11214,92946,45577,426,3613,1109,585,3387,1024,47369
12211,10752,5212,38,246,162,70,387,101,5540
13331,120,65,0,0,13,0,0,7,55
962,19593,9356,104,513,165,284,594,321,10237
1431,3215,1643,26,74,49,0,77,58,1572
27820,2211,1036,0,10,37,0,90,33,1175
58382,189,127,0,0,0,0,1,11,62
60035,29734,14306,57,548,489,62,698,528,15428
62047,1443,722,0,45,33,8,33,44,721
35234,5450,2672,66,167,98,40,315,130,2778
40358,783,435,0,12,38,0,10,6,348
43164,2233,1093,19,71,3,0,119,20,1140
48111,40824,19901,341,1196,445,306,1246,450,20923
48845,923,495,0,45,8,9,18,10,428
50560,591,308,3,18,5,0,22,5,283
12845,4647,2225,22,80,94,9,95,51,2422
12936,409,195,4,4,22,0,5,9,214
38658,2252,1167,3,63,45,0,34,65,1085
53559,6225,3252,9,152,64,15,233,163,2973
29591,5350,2721,83,120,68,11,174,91,2629
22044,13489,6721,118,670,116,61,504,110,6768
23805,19410,9035,148,532,249,156,543,301,10375
13212,21349,10138,162,560,259,63,536,381,11211
28698,2247,1204,8,32,18,14,69,35,1043
25141,164,71,10,0,0,0,0,0,93
91608,0,0,0,0,0,0,0,0,0
86406,22995,11470,25,383,444,76,270,379,11525
97733,427,205,0,23,0,0,0,36,222
99114,12453,5867,26,363,193,66,334,218,6586
96130,20553,14603,383,1356,159,41,338,198,5950
7462,6250,3440,51,154,73,88,246,81,2810
3753,2874,1346,27,108,46,0,61,67,1528
5446,15892,7834,67,372,187,143,438,130,8058
6414,91,37,0,0,0,0,0,0,54
780,11653,5404,49,339,85,53,421,230,6249
19735,53,17,0,0,0,0,0,0,36
20165,32744,16594,173,1094,291,92,1333,264,16150
21530,1961,1034,0,33,18,50,106,9,927
29115,28744,12821,196,575,181,247,625,362,15923
81520,13801,6893,270,172,221,195,267,231,6908
72587,75,21,0,0,0,0,0,7,54
95341,32446,16544,217,1165,216,243,1223,203,15902
96092,254,193,0,74,0,0,0,15,61
89815,14368,7394,47,493,174,144,401,197,6974
90018,53256,25673,299,1885,282,366,1823,563,27583
92587,17468,9040,84,699,183,190,568,374,8428
75604,31011,15395,97,1095,298,186,804,459,15616
76265,1602,840,45,39,19,0,11,14,762
40743,281,145,0,0,0,0,24,0,136
40972,1051,503,10,21,8,7,12,6,548
63942,709,355,4,15,15,0,23,7,354
57473,127,77,0,0,0,0,0,0,50
46409,7350,3679,102,218,68,27,354,120,3671
46534,11453,5683,86,316,140,39,440,162,5770
46764,1353,693,0,39,63,0,26,36,660
48816,69,41,0,6,0,0,0,0,28
66830,126,54,0,0,0,0,5,4,72
67357,11914,5725,64,399,85,34,327,244,6189
69029,407,205,2,9,2,7,19,3,202
59074,307,160,0,1,5,0,10,16,147
62823,1700,789,10,35,22,8,43,11,911
63303,47906,23304,520,1387,520,277,1400,860,24602
72430,386,202,7,14,2,0,7,1,184
78851,33,28,0,0,0,0,0,0,5
97620,167,90,0,9,5,4,8,0,77
98056,35373,18077,305,1563,206,179,1311,337,17296
99115,1268,656,9,38,15,6,53,8,612
99173,1870,984,7,12,25,5,43,5,886
87743,245,144,0,5,6,0,0,3,101
94960,15725,7473,75,284,325,31,289,264,8252
89119,52278,28042,322,2222,530,495,1677,667,24236
39358,1903,886,80,14,0,16,8,23,1017
46988,1026,480,14,26,11,0,26,21,546
47123,80,37,0,0,0,0,0,0,43
33573,22412,9647,39,202,564,0,267,316,12765
63532,1397,695,11,8,12,0,25,11,702
17930,441,229,2,14,15,9,4,9,212
70711,4579,2205,12,132,134,28,112,44,2374
70730,3881,1790,46,74,43,11,140,72,2091
71260,2877,1386,40,42,57,0,187,6,1491
52646,330,175,0,14,1,0,9,1,155
53501,219,165,0,0,0,0,0,0,54
44092,16677,8378,70,549,304,45,487,299,8299
45331,22041,10473,136,728,288,120,579,359,11568
45638,21715,10805,181,683,194,215,772,234,10910
47226,231,164,0,17,6,0,3,1,67
47523,3316,1704,0,105,55,14,79,49,1612
49921,430,254,26,9,14,11,7,9,176
51244,78,34,0,1,0,0,2,1,44
58219,33,18,0,0,0,0,0,0,15
59758,1464,883,0,62,15,4,53,18,581
59914,208,109,0,18,11,0,4,5,99
49008,16719,8134,334,571,190,325,478,204,8585
42544,5490,2814,67,76,65,12,261,0,2676
55353,3540,1800,19,112,32,46,88,37,1740
30170,2943,1506,2,103,45,17,91,18,1437
17847,11424,5702,44,365,210,29,441,178,5722
21627,17,6,0,0,0,0,0,0,11
13141,577,256,0,14,3,0,17,4,321
13641,65,31,0,0,0,0,0,5,34
16872,1781,815,17,65,5,10,42,16,966
3579,344,186,0,22,0,0,11,8,158
4068,1548,765,14,38,7,0,33,43,783
4765,1070,539,6,35,7,10,25,10,531
8201,9908,4747,31,281,187,44,352,156,5161
10603,17843,8505,127,414,82,66,644,274,9338
93905,60408,31073,570,2588,391,412,2319,333,29335
54847,2194,1080,3,63,55,21,79,52,1114
14519,11771,5705,115,390,157,39,272,173,6066
15546,310,166,0,39,0,19,0,9,144
15715,451,225,4,0,0,10,8,0,226
21132,3362,1515,57,10,75,14,86,18,1847
30106,21742,9924,33,711,99,146,870,134,11818
33982,11025,6098,165,308,297,51,296,150,4927
36113,1809,1389,24,245,0,3,62,2,420
12846,3243,1605,54,53,37,0,21,54,1638
4986,1673,910,6,55,27,3,41,19,763
6120,14534,6850,162,368,7,110,472,130,7684
7432,7263,3610,0,220,98,0,265,151,3653
2186,27568,12972,250,1080,246,265,949,320,14596
49034,2744,1389,24,46,74,21,63,33,1355
39577,10699,5088,9,555,124,384,285,120,5611
44861,65,22,0,0,0,7,0,0,43
37394,88,31,3,1,0,0,1,2,57
38769,1843,838,14,80,0,4,69,9,1005
49403,2618,1305,4,81,59,9,112,35,1313
51023,3233,1519,15,136,26,0,66,34,1714
34450,10747,4886,0,155,184,120,125,91,5861
93220,58,58,0,0,0,0,0,0,0
54644,1486,726,0,42,48,0,83,35,760
55313,24379,12047,244,830,321,149,684,401,12332
60142,28121,13197,124,656,409,166,767,368,14924
61736,1750,874,3,72,10,7,38,23,876
65020,16373,7886,126,536,184,144,591,328,8487
65062,51,37,0,0,0,0,0,0,14
67107,2999,1406,11,96,25,17,53,26,1593
67207,28313,14031,271,1026,238,278,783,302,14282
74865,1791,887,10,48,13,3,51,10,904
75449,1351,705,6,23,7,0,23,34,646
75858,0,0,0,0,0,0,0,0,0
76051,52454,26147,490,1744,613,149,1484,691,26307
77864,7198,2972,41,95,104,25,189,90,4226
64430,742,362,0,15,12,3,8,24,380
56737,837,399,2,29,5,2,27,17,438
72436,897,410,26,41,1,3,34,27,487
71661,442,179,0,12,6,0,39,18,263
84113,248,135,5,0,0,9,4,0,113
85928,1327,720,14,37,0,0,21,6,607
95955,1435,772,34,69,7,0,31,14,663
93280,27698,16264,383,1334,183,90,573,271,11434
29180,14230,7046,66,340,218,78,333,312,7184
29207,11895,7918,481,29,0,282,15,0,3977
30363,3559,2083,37,84,0,95,10,0,1476
36540,696,325,0,13,10,66,39,10,371
38230,3696,1793,28,115,83,45,52,72,1903
39145,4634,2341,19,174,91,2,141,3,2293
39477,654,336,0,17,9,0,5,12,318
40241,30144,14853,181,828,349,81,899,443,15291
44828,73,24,0,13,1,0,13,0,49
33306,3378,1872,51,183,91,9,69,82,1506
94590,37377,18293,347,1438,271,381,1006,645,19084
95368,14520,7127,54,492,127,125,414,178,7393
98335,25522,12194,77,638,296,63,931,368,13328
99502,24671,12129,171,864,157,101,952,233,12542
84741,5981,3019,0,267,90,0,233,89,2962
83301,56870,27567,353,1625,555,394,1590,616,29303
95571,271,116,0,0,0,0,0,0,155
1129,6762,3174,52,217,101,16,205,119,3588
37406,13937,6371,30,248,292,82,593,247,7566
54657,345,181,0,14,3,5,6,9,164
43788,754,374,1,13,3,1,13,1,380
44638,1453,840,27,9,9,0,33,0,613
45695,657,323,4,4,7,0,19,15,334
49934,882,410,15,30,17,0,29,20,472
51553,1089,565,0,11,29,19,34,19,524
51650,352,177,2,12,2,0,6,7,175
53036,3050,1573,0,112,17,0,151,20,1477
41139,8004,3796,49,224,65,11,291,114,4208
42036,1299,556,0,7,33,11,6,14,743
42232,865,467,0,0,0,0,0,27,398
42712,1534,772,38,10,6,0,20,39,762
48220,22811,11443,112,1040,250,133,973,250,11368
31568,685,330,0,0,14,0,16,0,355
32501,11557,5766,71,374,78,27,287,126,5791
33157,68402,32133,306,2146,573,572,2106,767,36269
15360,1767,926,9,73,27,13,70,47,841
15370,14781,8402,166,531,160,143,292,168,6379
15765,1649,884,3,49,17,14,45,67,765
13024,1723,1723,8,272,0,0,0,0,0
13780,1036,546,0,27,5,0,23,0,490
14454,11188,5083,406,176,104,679,119,213,6105
24473,1102,560,0,0,60,0,0,0,542
24731,246,119,0,28,14,0,33,0,127
36362,5134,3166,99,224,0,33,92,0,1968
26801,1017,604,0,42,0,20,50,16,413
28428,6533,3127,42,194,45,13,136,216,3406
29128,5271,3006,15,143,124,61,82,57,2265
30045,40179,19642,287,983,251,380,1706,603,20537
95864,23733,11473,156,756,401,194,817,301,12260
97412,459,225,6,5,9,0,4,12,234
98225,49877,25100,1553,1325,486,1633,1481,487,24777
99012,823,424,1,12,14,0,32,15,399
18517,5301,2412,73,98,57,61,106,147,2889
32539,29265,15662,156,1330,412,78,870,468,13603
32825,61550,29726,354,1896,566,853,2212,580,31824
33637,17345,8212,191,370,130,413,691,281,9133
33711,20366,9458,279,376,266,356,654,117,10908
34748,39230,18711,280,587,533,106,490,723,20519
24878,562,273,14,0,20,19,0,0,289
82837,59,23,0,4,1,0,0,2,36
50042,257,137,0,17,7,0,5,8,120
71368,1364,705,11,6,0,25,47,0,659
39440,20872,10336,280,793,380,38,592,137,10536
60951,825,444,0,6,27,1,7,14,381
44145,32378,15840,122,729,445,174,941,633,16538
61072,11565,5605,51,417,153,20,413,160,5960
57034,830,435,4,36,3,19,16,9,395
62238,619,318,0,26,2,0,29,3,301
42528,1491,693,0,44,35,0,40,5,798
34275,20074,10085,54,290,665,98,213,393,9989
40204,14765,7420,29,727,145,47,524,172,7345
3466,1698,852,0,0,21,0,47,0,846
4562,2130,985,0,26,46,9,92,76,1145
5458,2193,1134,58,57,54,9,65,21,1059
2190,17196,8368,34,425,145,63,681,267,8828
59636,26,24,1,0,0,0,0,0,2
56355,555,289,0,8,4,0,15,9,266
95699,20,14,0,0,0,0,0,0,6
97488,1206,638,26,5,25,5,30,45,568
97880,327,182,8,13,6,0,3,15,145
43754,1618,780,2,29,52,20,57,16,838
83246,996,477,4,32,10,0,29,25,519
84144,388,196,0,21,0,0,11,0,192
37206,25470,12022,104,1255,219,151,1119,217,13448
54228,2794,1432,30,73,43,18,103,43,1362
60544,26498,12157,69,676,283,293,783,201,14341
60640,69715,35614,214,3362,652,347,2888,803,34101
93036,47442,23766,390,1416,293,409,1371,436,23676
70455,860,553,0,36,54,0,36,27,307
11579,5209,2505,65,116,102,9,114,144,2704
72834,10642,5227,182,384,87,33,404,188,5415
81425,5582,2819,17,99,85,42,119,43,2763
83287,237,137,0,13,6,0,0,9,100
75754,6304,3439,9,166,90,32,121,90,2865
16624,189,110,0,8,0,1,6,1,79
64779,2551,1227,0,64,41,23,66,43,1324
7723,695,310,0,17,12,8,16,4,385
59716,2612,1442,21,108,0,0,101,0,1170
68946,12,6,0,2,0,0,0,0,6
3082,1670,895,0,35,33,0,47,22,775
3237,2433,1200,24,162,71,65,88,32,1233
17034,2667,1239,5,106,26,18,50,46,1428
4912,933,457,10,28,7,0,34,25,476
15202,19566,9470,38,643,245,106,680,413,10096
698,36312,17401,259,1049,431,227,1146,416,18911
25882,2073,993,17,56,12,16,65,63,1080
30622,11803,6250,139,342,72,27,422,71,5553
31733,1319,700,7,12,35,0,46,0,619
34759,39850,19243,201,715,373,244,1340,390,20607
6092,4322,2223,21,90,7,20,143,62,2099
12125,1385,664,0,27,8,0,22,17,721
45778,821,421,0,45,13,0,37,0,400
23175,1800,839,0,3,71,0,33,59,961
51364,723,385,2,13,11,0,23,17,338
51441,471,219,0,12,22,0,16,19,252
52208,3033,1491,15,153,28,30,76,24,1542
36343,1343,599,0,20,10,4,31,22,744
24370,6634,3434,86,136,42,72,126,79,3200
14464,7555,3773,46,230,137,78,224,91,3782
25185,870,870,0,110,25,0,0,0,0
15428,2041,1071,6,59,24,0,76,30,970
43085,26216,12902,139,1142,354,198,1005,277,13314
39456,878,442,9,64,12,18,18,11,436
25019,642,324,0,14,0,41,0,0,318
47018,4348,2100,44,147,25,25,128,40,2248
27825,41,22,0,0,0,0,0,0,19
33132,12895,7672,78,1074,78,56,489,13,5223
75110,29213,13919,261,769,207,185,785,505,15294
31830,2571,1212,22,71,12,11,118,35,1359
93721,7611,5105,116,464,69,19,193,42,2506
83713,30688,15303,474,924,245,236,1221,455,15385
94502,14619,7201,16,530,136,28,596,521,7418
78130,74172,36481,436,2559,661,366,2800,924,37691
91916,1962,965,7,43,38,19,42,10,997
92678,570,265,5,38,19,0,20,5,305
62693,1510,770,18,31,13,0,34,27,740
68415,651,347,0,28,17,8,9,2,304
69170,286,153,0,7,8,0,4,9,133
61326,2297,1170,5,108,10,5,91,20,1127
61778,691,329,0,4,7,0,4,2,362
21001,24453,11919,225,655,290,321,551,260,12534
79061,406,170,0,0,2,2,5,0,236
79336,17406,8514,41,456,182,58,537,228,8892
75146,18986,8707,156,489,174,220,591,364,10279
63450,69,31,0,0,6,0,0,0,38
82401,7585,3845,36,204,128,6,214,113,3740
89061,5828,2858,1,66,131,0,116,114,2970
92694,29064,14077,36,1222,300,34,1434,239,14987
84729,236,125,0,5,1,4,0,1,111
85283,51119,25537,568,1579,376,494,1674,511,25582
98043,21126,10309,180,979,159,132,778,261,10817
99801,30106,15374,194,1106,379,194,1134,488,14732
95685,4711,2221,0,104,130,28,90,64,2490
96136,42,6,0,0,0,0,0,16,36
97028,166,125,0,0,0,0,0,0,41
50063,2469,1294,16,89,18,0,38,20,1175
67342,870,416,0,12,10,0,22,9,454
43778,1148,595,1,1,17,0,17,13,553
44634,2246,1150,9,52,37,0,13,27,1096
45417,29332,13019,112,764,195,169,840,407,16313
15841,379,183,0,19,0,16,19,18,196
17555,7431,3595,30,225,34,75,147,88,3836
18504,20531,10248,133,578,235,128,466,276,10283
18822,3305,1688,13,96,74,5,108,37,1617
10524,4227,2102,76,94,38,38,110,120,2125
12027,3815,1910,0,107,66,0,71,51,1905
7461,18522,8924,148,279,368,8,432,344,9598
8505,18078,8605,167,551,177,79,578,311,9473
71229,1412,817,7,81,30,5,27,6,595
62688,602,301,0,22,8,6,26,12,301
62930,6074,3089,131,205,99,18,190,121,2985
64034,8720,4274,46,364,38,10,241,65,4446
59020,46,25,0,0,3,0,0,1,21
80917,31541,15870,223,1135,323,314,893,339,15671
82334,441,230,0,14,11,0,8,17,211
75766,27008,13524,341,724,250,50,951,439,13484
97540,8349,3833,40,222,83,0,345,163,4516
89130,35776,17519,241,1221,594,195,986,483,18257
95494,125,56,22,0,0,0,0,5,69
3052,8395,4447,73,337,28,22,255,180,3948
7065,29370,14365,215,1390,249,38,1223,314,15005
7104,51250,25003,340,1638,233,233,1939,469,26247
2738,5100,2375,2,117,75,0,162,84,2725
2746,15552,7287,67,764,33,121,386,116,8265
33771,30346,14108,131,785,611,223,1083,673,16238
14784,1040,483,32,25,21,0,28,27,557
15208,9824,4404,1,243,141,35,167,199,5420
17853,3298,1644,38,98,17,20,120,47,1654
1612,4870,2521,31,77,51,12,131,52,2349
14013,1708,944,3,43,32,17,16,26,764
4571,402,208,0,0,0,0,40,0,194
95335,201,127,0,0,0,0,0,0,74
96007,23106,11679,99,748,195,182,706,336,11427
90029,37898,19101,276,1421,410,236,1338,443,18797
97054,2001,928,6,45,13,4,69,18,1073
97874,414,205,0,4,18,3,11,12,209
92064,49933,24332,365,1661,530,135,1506,737,25601
99164,0,0,0,0,0,0,0,0,0
66006,7861,4021,40,311,119,76,183,177,3840
66866,1740,895,26,38,32,0,16,11,845
67049,140,92,0,0,0,0,0,0,48
67739,181,89,0,7,6,4,2,5,92
62673,466,228,2,22,4,1,2,12,238
63828,215,120,0,14,3,0,15,0,95
64128,11379,5242,84,386,63,15,417,202,6137
77367,115,57,0,27,0,0,0,7,58
60624,36158,16906,361,904,186,284,1303,423,19252
50132,241,136,1,5,9,2,10,3,105
47854,722,362,0,41,15,0,0,11,360
48094,19215,9558,200,301,179,74,362,322,9657
27953,1013,510,0,95,22,0,22,2,503
42368,1355,725,0,66,13,13,47,22,630
20245,0,0,0,0,0,0,0,0,0
5830,1415,694,12,44,12,4,35,26,721
76429,119,104,0,0,7,0,0,0,15
77454,15,15,0,0,0,0,0,0,0
61032,29896,13985,142,673,405,296,827,381,15911
87724,21,21,0,0,0,0,0,0,0
74651,847,417,3,34,4,2,24,6,430
74832,902,439,3,28,0,19,14,13,463
74849,3061,1545,95,109,19,17,112,51,1516
75566,730,325,3,2,18,0,3,5,405
75644,13387,6546,37,396,127,186,328,212,6841
80117,2889,1435,17,52,38,6,75,112,1454
83227,119,100,0,0,0,0,0,0,19
13684,1107,654,4,6,10,3,14,13,453
30342,30187,14531,87,1085,228,201,1440,368,15656
30510,9042,3568,50,198,59,40,537,107,5474
31204,29686,12598,214,619,345,180,800,401,17088
32096,2179,1094,1,70,22,0,29,64,1085
32544,2003,1187,207,59,0,39,35,0,816
25503,1713,810,0,14,0,0,27,81,903
8110,18598,8916,91,568,127,107,743,311,9682
10001,22924,11671,180,793,220,184,762,409,11253
29526,46369,23410,580,1093,939,799,1239,485,22959
29654,9306,4379,55,191,169,89,235,177,4927
12084,4959,2431,0,175,53,57,185,41,2528
12781,240,153,0,12,14,0,0,0,87
27020,5717,2945,68,202,60,41,89,102,2772
28043,21075,10040,133,485,366,155,709,190,11035
52219,193,107,0,0,5,0,3,2,86
52566,197,86,0,14,3,0,3,6,111
54112,2345,1261,3,94,42,4,48,42,1084
55746,16882,7858,83,389,137,120,405,268,9024
37360,1440,676,2,20,38,73,15,58,764
8043,29223,13962,76,771,417,138,807,543,15261
8609,12759,6625,117,351,112,97,487,103,6134
18225,388,300,0,0,0,0,0,0,88
99721,265,160,2,8,3,3,15,1,105
99760,605,306,0,14,4,2,10,4,299
76050,6241,3004,43,74,45,15,86,45,3237
78045,65982,31404,342,2614,442,563,2754,772,34578
83444,1015,543,0,5,9,6,16,33,472
85643,8475,4575,105,361,79,37,262,91,3900
68747,123,56,1,0,3,0,3,3,67
87701,19039,9554,159,548,329,140,384,285,9485
89102,38637,20531,390,1238,471,254,1520,427,18106
79512,7716,4970,228,320,108,17,280,66,2746
2895,41539,20455,260,1282,500,458,1377,673,21084
3830,2095,1134,23,56,0,0,61,58,961
4841,7190,3310,56,134,120,0,428,87,3880
8074,15,7,0,0,0,0,8,0,8
2660,6257,2858,28,150,136,28,65,107,3399
58655,513,259,0,5,0,0,11,8,254
58795,209,102,3,0,2,0,0,4,107
53081,42601,21784,301,1244,522,176,1477,470,20817
15084,9897,5011,54,355,180,22,208,89,4886
21053,3302,1832,58,84,57,14,68,17,1470
24101,6428,3325,56,147,85,30,121,197,3103
41727,822,373,0,33,0,0,16,11,449
97870,634,308,0,16,15,0,19,6,326
99727,608,340,11,11,4,6,22,4,268
54814,2656,1284,22,60,54,55,52,41,1372
54960,2472,1311,0,23,36,0,36,59,1161
55417,26481,12952,65,1239,242,64,1306,423,13529
57029,2206,1087,11,41,30,0,25,29,1119
60555,13448,6775,54,505,155,34,501,207,6673
61111,23837,11428,189,779,152,62,869,256,12409
62563,5689,2886,0,148,108,35,144,81,2803
47861,853,435,2,31,2,0,30,0,418
43722,306,135,0,0,0,0,9,0,171
46323,22185,10993,157,648,241,169,711,280,11192
49675,1029,517,11,15,13,12,27,18,512
41555,621,318,10,51,19,0,59,0,303
42022,185,106,0,31,0,0,0,0,79
42603,74,25,0,0,0,0,0,0,49
35217,13286,6227,160,493,119,63,366,250,7059
88434,458,206,0,1,6,0,30,4,252
96821,18539,9164,60,535,282,39,565,302,9375
98366,33618,16865,172,1138,276,322,1278,380,16753
85362,700,304,0,0,33,0,0,23,396
64790,856,428,2,24,17,3,15,25,428
65049,6633,3071,21,95,184,17,108,143,3562
16346,3180,1714,10,73,58,0,138,59,1466
21152,5511,2498,63,97,49,20,158,112,3013
22182,26777,13305,157,775,378,46,976,518,13472
74720,471,235,0,13,5,7,6,11,236
76680,265,155,0,24,0,0,24,10,110
77385,25572,12928,8,1365,181,133,669,425,12644
80473,4,2,0,0,2,0,0,0,2
96853,599,465,55,0,0,19,0,0,134
85534,2766,1433,1,48,9,83,83,37,1333
93638,50894,25743,582,1553,253,617,1592,435,25151
93962,385,240,38,0,0,0,0,0,145
91607,30873,14501,168,1149,389,169,1363,477,16372
78746,28495,13800,88,932,257,42,829,417,14695
47941,1383,679,4,58,20,0,63,22,704
10503,173,71,0,0,0,0,0,0,102
11216,56308,26400,204,1974,230,295,2531,450,29908
11369,34118,16785,362,1063,303,297,1262,490,17333
24597,1088,479,0,38,0,25,29,0,609
43535,719,365,8,48,7,0,19,3,354
67671,1532,789,5,47,9,16,36,31,743
58443,217,84,0,1,0,0,13,2,133
97848,230,123,0,3,4,0,0,2,107
98258,32959,16793,67,1194,299,170,1318,540,16166
98290,35990,17678,205,1186,420,148,1175,664,18312
95816,17217,8108,9,905,80,33,702,167,9109
68116,30398,14728,213,1318,218,184,1330,303,15670
76848,64,29,0,0,0,0,0,0,35
77444,632,328,0,51,16,0,27,28,304
91345,19205,9761,220,607,228,96,607,259,9444
93042,107,107,19,0,0,0,0,0,0
95053,3678,1709,114,0,0,82,0,0,1969
82240,10489,5365,46,279,110,11,254,199,5124
83311,923,466,7,75,2,0,24,6,457
65769,2564,1327,2,70,63,42,48,66,1237
67024,874,449,0,9,14,3,15,13,425
45724,2113,1193,17,57,101,0,58,16,920
47916,62,29,0,0,0,0,0,0,33
37075,65123,31319,338,2039,724,130,2485,796,33804
38019,15978,7667,243,511,232,158,495,190,8311
38753,1263,586,7,49,10,0,45,13,677
60620,68096,30001,530,1323,533,531,2049,1014,38095
61285,1627,880,9,45,41,2,28,25,747
62814,1945,936,8,71,21,17,104,25,1009
56548,791,440,8,20,14,4,15,11,351
51548,441,229,0,4,13,3,16,10,212
52621,669,337,0,8,3,25,8,12,332
54486,2027,1026,22,55,16,15,51,43,1001
54722,4092,2011,25,118,50,23,94,68,2081
48817,6206,3123,36,230,52,19,206,80,3083
49645,1512,735,15,42,23,0,47,22,777
50008,880,438,2,46,11,10,2,9,442
50027,310,198,0,15,1,1,2,1,112
50830,1799,850,2,67,37,15,54,32,949
44833,16558,7649,91,456,208,134,445,178,8909
3590,940,476,4,23,9,0,13,9,464
6450,34884,16460,123,1139,376,150,1273,472,18424
16239,5188,4577,77,617,45,1,15,14,611
26301,29028,14162,175,773,360,212,760,583,14866
7840,29825,14710,221,958,272,197,1036,348,15115
8204,18608,9356,198,463,271,153,295,389,9252
11201,62823,30042,230,3259,354,427,3161,535,32781
20118,8,2,0,0,0,0,0,0,6
26362,3366,1696,0,74,35,10,56,41,1670
26405,1330,627,70,0,20,0,57,38,703
27295,38511,19201,164,1168,524,184,1098,425,19310
17961,6471,3161,20,38,113,2,85,114,3310
18612,18555,9768,128,685,346,204,436,226,8787
12054,16649,8205,43,570,152,27,485,201,8444
12411,389,180,0,0,0,0,0,8,209
13313,484,253,3,14,6,5,13,0,231
76201,27965,13287,1161,482,196,1160,368,72,14678
77021,26655,12200,148,834,176,184,1028,330,14455
77488,14533,7422,165,279,224,88,451,312,7111
77963,5712,2719,81,160,100,90,109,108,2993
78373,4174,1836,0,146,54,131,29,37,2338
78659,3061,1524,17,56,0,29,45,186,1537
51557,797,421,2,25,10,4,10,34,376
60026,14118,6931,30,259,103,23,341,172,7187
60604,782,369,0,6,0,11,4,0,413
66762,24933,12659,661,734,257,525,803,196,12274
71970,867,482,32,0,0,0,0,14,385
72063,2144,1136,0,44,43,0,32,18,1008
57106,46442,22408,325,1953,398,246,1859,593,24034
57544,506,284,5,24,2,3,10,0,222
73062,1296,625,0,32,14,13,37,19,671
73669,1750,793,6,44,12,4,57,36,957
73932,2304,1176,10,86,15,0,70,24,1128
75428,10951,4930,243,418,142,215,271,29,6021
76039,35394,17394,124,1404,209,213,1528,351,18000
32564,2931,1556,21,80,46,0,119,43,1375
33042,6524,3411,0,189,87,0,121,187,3113
6470,16680,8295,112,285,96,16,288,307,8385
22503,3770,1815,49,30,21,9,35,110,1955
32421,5256,2770,105,174,13,64,110,113,2486
28690,9125,4484,36,134,119,44,187,65,4641
28789,5281,2865,5,177,86,49,172,119,2416
35112,280,111,0,10,0,0,15,0,169
37811,3672,1933,5,118,51,14,124,59,1739
18708,8650,4228,0,154,181,18,168,171,4422
22193,82573,41795,582,2990,611,444,3391,789,40778
23022,1180,586,0,60,0,0,0,17,594
25063,1588,710,0,89,30,0,36,7,878
25938,1333,683,26,38,26,11,22,14,650
43156,201,98,3,6,3,0,4,4,103
50161,1817,918,2,49,23,22,46,12,899
51450,1455,725,5,67,28,0,30,18,730
56312,2622,1411,12,58,30,15,67,36,1211
60141,216,188,6,0,7,0,0,0,28
68643,974,473,6,25,4,18,25,13,501
69025,1126,518,8,28,6,28,27,16,608
48234,34156,16163,328,843,229,221,849,329,17993
61941,79,45,0,0,0,0,0,6,34
75236,19447,9347,130,826,61,106,806,250,10100
96143,3391,1789,6,134,18,0,201,23,1602
98203,35603,18293,63,1297,253,173,1366,524,17310
14580,52587,24792,308,1316,687,256,1406,655,27795
14856,241,58,0,0,29,0,0,0,183
34110,24008,11440,32,358,485,0,426,356,12568
37153,6568,3164,16,152,64,41,302,56,3404
97419,1143,556,0,52,27,0,75,33,587
56115,1446,749,5,45,26,6,44,32,697
59032,474,277,2,6,1,12,9,12,197
60302,32048,15135,35,1151,395,135,1285,323,16913
93239,1520,739,0,47,7,0,121,20,781
87461,1264,644,16,41,6,13,33,16,620
90016,46581,23041,360,1502,410,358,1824,462,23540
90044,96436,45700,781,3224,695,956,3452,857,50736
65610,4937,2494,32,196,37,2,145,85,2443
68844,309,170,0,2,4,0,13,0,139
52630,446,255,6,13,7,0,12,11,191
53405,24849,12104,92,818,312,78,811,334,12745
58041,1518,703,12,62,18,3,24,45,815
59070,866,490,0,39,6,0,10,22,376
63771,2989,1599,13,59,77,18,56,24,1390
72512,2493,1100,6,32,14,10,53,81,1393
74340,204,95,0,4,3,2,4,1,109
71642,615,319,0,7,0,0,9,0,296
98323,805,427,0,31,5,5,34,0,378
98570,4559,2357,0,145,77,40,108,83,2202
98610,3224,1647,0,103,30,17,103,34,1577
91311,40420,20113,259,1674,451,185,1497,504,20307
92310,9086,5140,289,485,0,128,459,0,3946
92314,11361,5701,44,263,115,55,296,259,5660
77090,39381,18042,359,881,90,528,1410,409,21339
77422,13542,7247,149,496,208,11,326,184,6295
57345,1154,566,3,35,11,0,24,36,588
58269,245,122,6,7,17,0,0,5,123
58366,1300,615,17,26,16,8,20,9,685
54103,519,282,3,14,4,3,8,11,237
63143,9572,4628,33,359,133,120,438,184,4944
65713,2462,1216,4,63,60,13,95,46,1246
65773,655,354,0,0,0,0,0,0,301
66097,1342,607,0,5,21,4,6,13,735
67741,355,188,0,2,6,1,3,10,167
54499,2972,1382,7,58,23,4,97,45,1590
54517,93,51,0,0,6,1,0,7,42
71040,9177,5847,30,588,122,9,142,100,3330
78154,40085,19798,472,1223,406,92,1499,457,20287
97220,30695,15061,165,1472,262,203,1585,413,15634
99031,1325,721,0,7,0,1,28,34,604
93630,20195,10350,179,809,187,58,774,220,9845
91740,26115,12659,204,780,378,142,818,364,13456
76226,25100,12547,84,691,231,27,1001,195,12553
76443,2056,1043,0,63,12,0,50,18,1013
76578,1443,777,0,97,7,1,24,14,666
76890,1100,456,0,27,21,8,23,10,644
77979,17648,8930,19,545,254,16,543,210,8718
99704,39,23,0,0,0,0,0,0,16
34436,8225,3904,39,52,120,58,132,130,4321
38721,1001,510,0,28,7,21,38,34,491
39095,7225,3567,60,245,60,29,225,97,3658
47401,43407,21539,952,1243,507,1014,985,630,21868
47584,140,77,0,3,0,0,6,1,63
42086,4142,2112,50,153,80,0,164,48,2030
94608,30289,14820,118,1782,276,117,1717,371,15469
95202,6001,2944,20,145,129,37,222,39,3057
96076,200,115,8,3,0,0,0,0,85
97080,44722,22585,155,1711,563,321,1370,669,22137
92140,3669,3560,320,18,0,5,0,0,109
93461,1451,749,0,54,0,0,63,21,702
93531,388,185,0,26,0,0,36,5,203
2067,18377,9046,105,426,252,104,445,268,9331
42240,41743,20205,218,1113,388,304,1219,578,21538
43928,21,21,0,0,0,0,0,0,0
44611,2121,1047,7,51,11,10,64,19,1074
44887,836,422,1,9,0,2,24,37,414
35118,3040,1529,15,158,29,56,94,44,1511
52637,2672,1257,8,90,34,18,37,53,1415
53212,30933,14773,206,967,272,349,1272,241,16160
53537,849,381,0,15,9,3,26,17,468
48383,13490,6926,115,331,180,81,395,245,6564
39421,2513,1306,19,28,19,9,97,18,1207
46637,15251,7539,146,513,122,404,348,230,7712
79563,1175,491,8,49,0,4,29,38,684
82428,180,87,0,1,11,0,0,5,93
60962,645,355,6,12,9,2,36,15,290
61744,1865,890,13,45,10,8,46,27,975
61756,2413,1323,3,73,7,7,61,53,1090
63656,377,194,4,12,2,0,7,4,183
72821,1831,822,0,60,2,23,11,7,1009
73733,335,161,0,16,0,0,22,18,174
74059,5664,2855,19,205,47,42,168,86,2809
67634,254,141,0,5,8,1,5,2,113
70444,10223,4382,42,162,151,21,322,147,5841
75488,566,254,10,23,5,0,32,8,312
17965,2073,996,0,50,6,0,77,15,1077
18414,5203,2575,23,121,85,5,110,117,2628
2343,10728,4979,83,372,87,66,277,165,5749
4069,1677,810,0,26,20,0,36,31,867
4843,4834,1989,0,154,79,63,82,110,2845
5346,5111,2582,79,123,88,41,138,112,2529
5871,1509,732,0,44,16,20,38,37,777
7011,40173,19499,332,1486,256,386,1904,495,20674
7728,55039,27030,231,1819,476,379,1846,639,28009
12780,2097,1070,0,90,18,0,38,36,1027
13068,5160,2587,19,114,29,11,154,45,2573
11742,12566,6177,98,299,124,37,343,189,6389
26534,2514,1156,0,122,33,19,130,24,1358
26855,627,299,0,9,9,0,8,0,328
28209,22694,10760,48,1015,108,74,937,160,11934
50139,1237,618,11,28,16,3,31,43,619
50510,1034,444,0,26,8,0,21,14,590
54245,2178,1131,18,61,24,7,51,17,1047
66781,955,454,4,19,38,0,37,13,501
56580,1379,717,7,43,13,10,43,19,662
59270,8806,4486,45,275,78,55,191,168,4320
59932,1240,673,22,45,55,0,37,71,567
61871,304,154,8,6,6,0,5,9,150
62458,1979,974,35,35,41,6,42,39,1005
49270,5911,3060,50,197,58,58,220,80,2851
71202,29709,15388,344,1024,162,163,874,405,14321
54643,2,0,0,0,0,0,0,0,2
55805,9556,4636,303,343,58,259,285,109,4920
73066,330,152,0,10,15,5,24,6,178
76014,36156,17860,309,1197,289,272,1340,410,18296
45217,7232,3354,2,150,85,83,166,80,3878
56020,88,51,0,1,2,0,3,3,37
56329,7524,3819,17,276,71,20,278,92,3705
54002,6399,3118,7,243,28,10,329,109,3281
55349,3880,1859,28,135,54,17,129,35,2021
37302,4920,2550,0,72,20,22,95,118,2370
40051,4264,2245,111,170,60,69,125,69,2019
40472,1782,966,3,47,42,2,2,20,816
30577,21204,9432,181,420,137,270,619,409,11772
30680,42975,20938,292,1695,359,222,1474,495,22037
32079,461,210,0,0,9,0,0,8,251
32081,13266,6980,0,607,260,0,743,56,6286
44272,5176,2504,41,181,35,21,250,86,2672
45309,12439,5793,11,236,100,0,395,176,6646
25251,210,126,0,0,0,0,0,0,84
92887,20194,10003,45,401,425,147,530,445,10191
32958,27676,13549,154,385,839,57,725,459,14127
72204,30377,14198,318,863,508,209,1158,348,16179
37172,29194,14686,330,889,350,69,848,611,14508
93313,52637,26086,370,1850,352,771,1818,558,26551
93628,239,87,0,20,0,0,19,0,152
40419,3964,1856,12,123,53,12,137,50,2108
68318,425,228,13,4,8,7,0,16,197
33896,9746,4811,65,345,111,74,312,38,4935
27612,38748,18620,182,1546,280,172,1563,467,20128
49701,1045,525,0,14,39,3,6,28,520
43206,22677,11262,73,830,198,73,671,225,11415
48069,2389,1184,0,69,35,19,69,74,1205
25692,1048,561,0,56,0,19,77,22,487
50072,2425,1224,4,74,49,9,66,27,1201
52047,700,369,4,22,2,11,5,4,331
52563,1429,743,0,85,28,4,47,67,686
53936,2533,1781,39,243,22,8,26,14,752
71670,1162,544,5,35,12,0,30,22,618
12123,5492,2833,21,191,51,9,118,93,2659
12849,346,206,0,0,0,0,0,0,140
20625,615,264,0,0,0,0,22,7,351
21782,4003,2036,26,97,85,59,99,81,1967
21862,68,27,0,0,0,0,0,0,41
22989,15,0,0,0,0,0,0,0,15
15620,577,266,0,30,0,0,0,10,311
17063,3398,1777,65,86,43,12,74,19,1621
13639,286,150,0,0,3,0,10,2,136
14416,3528,1861,11,155,15,17,63,26,1667
7926,11,0,0,0,0,0,0,0,11
18034,9094,4164,64,144,40,162,253,101,4930
81252,4003,1932,0,9,54,3,37,121,2071
81501,23950,11936,318,728,206,307,918,287,12014
91911,85365,42535,825,2323,626,451,2633,924,42830
95625,67,59,0,0,0,0,0,0,8
96108,56,32,0,0,9,0,0,0,24
75668,2285,981,0,96,9,46,68,26,1304
52747,1833,843,0,58,9,0,59,41,990
66215,26611,12780,171,873,338,89,776,331,13831
67584,225,110,7,5,4,0,0,11,115
67621,344,168,0,7,9,0,4,8,176
68935,566,259,0,22,11,0,15,22,307
59472,712,346,0,36,10,0,40,9,366
60970,6948,3169,82,165,114,31,132,142,3779
61572,1191,589,14,58,5,7,35,5,602
62253,583,289,1,5,1,5,18,17,294
14411,14176,7159,202,489,145,178,440,187,7017
14883,4670,2423,158,73,34,18,115,109,2247
5444,1685,853,5,88,48,18,46,22,832
5775,545,257,0,21,11,6,26,0,288
20746,27241,12174,198,897,272,132,1106,482,15067
21737,2304,1119,0,30,6,18,54,33,1185
17075,94,46,0,1,1,0,2,0,48
17264,2400,1226,5,94,42,5,54,29,1174
10580,17391,8441,117,372,194,67,480,175,8950
23423,303,141,0,8,7,0,8,0,162
23696,3827,1851,23,96,35,38,96,73,1976
23890,3708,1487,31,16,51,0,83,125,2221
46075,6544,3164,0,397,45,0,334,74,3380
46556,7269,3463,448,0,0,591,1,0,3806
42301,43295,20647,276,1149,472,275,1394,606,22648
52351,1455,751,0,51,11,9,75,21,704
52654,1571,776,0,38,17,3,31,7,795
54485,324,159,4,14,0,0,9,5,165
55051,9413,4748,30,319,157,25,233,111,4665
36693,20220,10045,118,669,220,53,647,321,10175
55909,1525,774,17,57,16,7,43,25,751
56647,848,432,4,48,11,0,22,17,416
58052,531,272,6,13,6,0,22,3,259
43932,836,442,0,26,3,0,14,1,394
44460,25258,12399,76,722,435,67,584,442,12859
45339,1385,753,0,52,115,0,34,10,632
34983,42737,21240,163,1529,422,343,1257,632,21497
34990,30101,14310,127,491,409,142,529,562,15791
50858,756,384,7,41,16,0,15,15,372
26763,1676,836,0,35,0,33,0,25,840
27709,914,471,0,23,0,0,83,0,443
32024,19378,9474,86,363,281,67,520,179,9904
7039,29698,14796,45,728,490,0,1068,497,14902
72342,4966,2407,56,222,65,114,189,104,2559
47989,1353,684,0,40,7,4,29,19,669
49849,12416,6310,42,403,147,89,353,212,6106
51345,432,231,0,17,6,0,13,0,201
51431,432,200,2,17,9,7,11,11,232
81021,31,17,0,2,0,0,2,0,14
92040,46261,23682,354,1756,494,529,1281,699,22579
74640,319,192,0,25,9,0,18,12,127
77837,1869,871,8,60,20,5,78,12,998
85009,49536,27117,499,2052,268,490,1359,369,22419
40109,2062,1140,0,43,59,5,53,35,922
47111,16612,8130,112,484,156,115,677,243,8482
64632,413,230,0,8,5,0,13,6,183
64778,784,420,0,8,3,0,3,9,364
68939,1166,517,7,20,17,7,45,7,649
74530,159,88,0,0,1,1,5,0,71
75144,3265,1724,46,22,41,29,52,37,1541
77362,5960,3153,0,107,78,0,124,38,2807
77656,16041,7421,86,612,157,67,470,224,8620
77802,26128,12288,114,778,136,350,676,360,13840
80722,259,162,0,16,0,0,4,7,97
84750,785,450,0,112,0,0,31,17,335
61745,4614,2343,23,161,33,75,146,47,2271
56425,8192,4146,98,304,96,13,264,38,4046
57361,216,115,0,8,8,0,9,0,101
59047,12530,6319,26,382,193,102,407,174,6211
59065,167,90,0,0,0,0,0,0,77
63432,503,264,0,14,1,0,4,16,239
73559,539,257,0,10,8,0,13,9,282
70003,41084,19523,248,1262,495,369,1146,654,21561
71065,1342,689,13,26,12,0,9,11,653
25005,141,66,0,0,0,0,0,0,75
13623,13,10,0,0,0,0,0,0,3
20878,64126,31695,186,1980,797,321,2149,1103,32431
21738,3416,1671,49,64,16,17,106,54,1745
28655,54594,27417,517,1509,753,147,1607,984,27177
53582,1129,551,4,33,7,5,29,11,578
37083,15129,7625,147,403,152,71,404,73,7504
39073,19911,9449,33,579,225,202,839,182,10462
47108,2249,1142,11,49,12,16,85,28,1107
11416,27125,13398,193,954,172,186,945,298,13727
11965,690,341,5,46,0,0,0,0,349
13117,264,121,0,12,0,0,4,0,143
75930,2026,1031,70,15,17,0,15,30,995
72458,680,296,0,3,0,19,10,4,384
72650,4005,1908,3,80,71,47,121,94,2097
72663,196,101,0,16,0,0,15,0,95
73084,6878,3393,49,209,173,63,268,161,3485
44672,4748,2368,58,41,23,31,79,51,2380
63965,3308,1659,20,124,43,21,177,51,1649
70764,16461,7776,99,417,128,131,844,354,8685
28554,168,71,9,0,0,0,0,16,97
29127,8339,4001,12,117,135,130,211,135,4338
54452,18503,9249,169,704,227,122,558,258,9254
55787,559,275,0,23,8,0,13,16,284
47232,3284,1872,41,77,34,52,61,35,1412
50315,35825,17229,145,964,234,264,1520,498,18596
52308,143,74,0,6,5,1,10,0,69
53057,1499,768,5,59,32,8,40,21,731
84180,0,0,0,0,0,0,0,0,0
84512,781,399,0,16,14,0,21,13,382
78605,6110,3097,11,229,229,101,284,136,3013
78730,9186,4595,40,168,320,0,214,82,4591
61039,1012,542,2,26,3,14,24,9,470
62053,626,317,2,6,10,1,16,7,309
92120,29142,14521,285,1112,327,204,898,302,14621
15449,463,236,0,0,0,0,35,8,227
15688,1161,558,6,31,38,12,21,36,603
16213,105,48,0,0,0,0,9,0,57
16802,11611,5494,524,8,0,502,0,0,6117
17329,2453,1113,0,27,28,0,40,81,1340
19804,17453,8526,109,647,179,7,718,248,8927
11702,13788,6881,50,304,136,74,457,288,6907
38115,40837,18254,294,1170,248,454,1329,364,22583
38573,2115,1051,36,68,25,26,95,20,1064
39216,3998,1705,0,100,58,0,76,27,2293
33068,51617,24427,374,1769,305,325,1733,772,27190
44114,6567,3830,14,243,32,117,118,34,2737
36205,688,391,34,0,13,0,0,0,297
37142,2134,1158,0,41,54,24,44,66,976
27806,2664,1129,0,66,31,0,56,88,1535
27944,11969,5737,14,267,163,15,478,212,6232
25090,195,80,0,34,28,0,0,0,115
41501,23078,11263,86,716,371,194,691,243,11815
28626,2474,1269,12,53,42,0,111,78,1205
29108,20890,10054,173,427,247,196,684,360,10836
29724,39,13,0,7,0,0,8,0,26
97825,308,167,0,7,9,0,11,4,141
80921,23618,11728,123,620,209,102,679,268,11890
67513,82,46,0,3,0,0,0,2,36
49835,913,465,3,29,26,3,26,20,448
52803,22319,11023,151,992,194,100,834,287,11296
63074,15234,7313,83,451,88,136,428,178,7921
64084,1541,787,0,36,40,0,64,25,754
45866,142,84,0,0,2,0,0,5,58
45877,2148,1113,20,56,31,14,69,27,1035
54631,1662,834,6,19,33,8,57,37,828
48188,41537,20461,215,1281,500,134,1523,471,21076
60520,2810,1327,0,106,11,4,78,26,1483
61606,7870,3938,296,176,65,434,81,41,3932
41534,268,125,0,0,16,0,12,30,143
44044,15400,9659,133,628,198,100,241,97,5741
44654,21043,10221,193,595,192,114,640,252,10822
33922,3731,1886,17,44,123,12,18,77,1845
36921,819,375,0,41,7,0,2,0,444
38962,136,64,0,0,0,0,20,0,72
39336,1364,697,0,0,31,0,0,0,667
39756,1898,802,0,89,18,0,15,62,1096
26587,352,176,0,8,0,0,24,0,176
72578,81,56,0,0,0,0,0,0,25
80808,5544,2661,0,156,95,14,116,59,2883
83660,6261,3038,81,188,39,19,176,95,3223
97303,40633,19844,202,1519,322,190,1488,607,20789
7008,23682,11178,150,696,223,125,822,464,12504
13034,1987,898,49,31,32,7,72,15,1089
19083,36282,18223,211,1059,322,113,1194,497,18059
24590,7745,3898,24,223,126,17,225,174,3847
22443,8534,4068,102,294,143,44,312,169,4466
23888,2120,966,5,23,18,12,34,12,1154
4261,402,192,0,13,3,0,22,19,210
602,38442,18842,405,1139,540,373,1332,560,19600
78121,13078,6597,106,306,161,110,277,101,6481
80428,824,398,0,26,20,0,36,36,426
83245,2144,1109,0,52,45,17,34,40,1035
83835,21559,9931,144,772,241,155,734,230,11628
84516,166,83,0,9,0,0,0,0,83
98022,21218,10263,117,740,214,130,641,324,10955
93601,1726,980,0,14,61,0,8,4,746
95010,9030,4143,0,231,124,26,247,84,4887
90806,42817,20865,417,1659,241,223,1612,434,21952
91913,53072,25871,310,1894,284,427,2228,322,27201
99040,724,367,4,24,4,0,11,3,357
99692,215,112,3,9,0,0,18,3,103
28676,4028,1848,13,58,71,11,106,70,2180
28709,2302,1259,21,99,25,0,99,57,1043
35747,5231,2575,28,82,57,4,103,95,2656
45780,3176,1542,0,110,0,0,64,31,1634
43056,19039,9371,124,604,246,83,651,116,9668
31077,1395,673,62,39,40,0,35,51,722
31638,1107,483,0,1,10,49,8,14,624
8016,33406,16099,204,901,289,182,1059,514,17307
94552,15412,7673,33,556,243,22,637,179,7739
94621,35287,16939,335,1271,172,278,1390,351,18348
98278,1731,1242,185,13,0,87,0,0,489
99553,758,497,1,51,0,3,7,5,261
36505,1965,879,0,13,0,0,75,0,1086
60652,43907,20784,464,1381,437,290,1673,659,23123
48204,24524,11150,169,687,205,116,1050,398,13374
45899,110,42,0,2,0,0,2,2,68
41773,1446,715,9,18,37,0,40,13,731
63379,25246,12476,105,832,178,81,806,371,12770
78379,1471,770,18,16,22,27,12,11,701
3301,33004,16632,137,1121,250,130,856,446,16372
68067,1245,638,12,34,11,5,21,13,607
77855,195,68,0,20,0,0,0,0,127
2631,9773,4540,76,72,152,33,132,167,5233
95307,44736,22432,508,1323,322,519,1135,411,22304
48225,14307,6728,270,348,143,89,409,198,7579
41729,118,23,0,0,0,0,19,0,95
33455,22415,10769,95,422,508,126,316,461,11646
96148,696,419,16,0,0,0,0,0,277
99622,379,201,2,10,8,0,6,7,178
45344,16104,8135,44,533,257,97,436,175,7969
81326,2203,1138,0,48,39,10,60,19,1065
46930,90,42,1,0,3,1,0,2,48
37188,15133,7324,168,352,76,26,401,173,7809
87045,1766,867,8,17,12,6,18,20,899
90403,24354,11396,12,913,204,49,874,410,12958
90404,22819,11391,325,965,228,195,1074,387,11428
61007,507,294,0,9,8,0,14,0,213
61920,24001,11441,783,673,255,837,614,227,12560
70390,7511,3247,53,279,34,87,289,97,4264
63090,22313,10746,56,689,301,109,482,317,11567
13108,6050,3068,64,110,73,37,130,67,2982
71647,2259,1094,18,15,39,2,54,11,1165
72210,17389,7928,164,267,134,122,828,123,9461
3869,2479,1167,0,43,12,0,52,60,1312
78950,1785,906,0,15,7,37,81,53,879
27007,2230,1164,2,48,0,15,53,43,1066
27513,44821,21735,234,1759,396,141,1484,794,23086
75455,28460,14055,347,637,213,200,988,337,14405
48006,4160,2215,13,157,44,21,196,49,1945
39168,6619,3111,23,196,77,61,222,134,3508
7641,3418,1716,21,44,66,3,60,60,1702
60301,2536,1142,0,94,0,0,97,18,1394
68066,5502,2620,18,282,39,8,248,113,2882
15421,39,19,0,0,0,0,0,0,20
27817,7773,3925,101,195,95,67,219,80,3848
66207,14473,7238,75,506,238,11,493,297,7235
19036,12824,6087,90,239,233,67,506,114,6737
5672,4436,2272,0,78,80,0,162,165,2164
11413,42443,19773,284,1151,355,179,1478,794,22670
47725,17267,8662,38,651,215,20,667,393,8605
14774,74,47,0,0,0,0,1,1,27
34744,55210,27361,389,1827,469,429,2502,539,27849
43515,8582,4203,60,266,67,24,247,198,4379
37029,6927,3638,41,345,125,0,308,78,3289
13624,5715,3316,67,279,118,9,145,119,2399
24882,300,197,11,12,21,0,8,21,103
15215,12471,6039,41,397,149,55,459,140,6432
25313,11816,5859,37,550,104,55,432,72,5957
39212,34977,16511,282,982,199,206,1416,332,18466
4348,2981,1579,18,86,75,17,84,47,1402
46047,137,66,0,16,0,0,16,0,71
27517,24092,11365,155,770,307,132,784,393,12727
47034,100,41,0,2,0,0,0,4,59
28390,23790,12033,363,693,119,222,830,169,11757
47561,1663,782,3,93,16,12,111,0,881
20783,45559,24901,244,2505,300,131,1646,418,20658
52627,12562,6441,69,452,134,42,305,159,6121
53035,2523,1253,13,78,24,13,106,31,1270
83354,25,14,0,0,0,0,0,0,11
95827,21185,10755,135,849,150,94,506,212,10430
88046,655,344,0,9,0,0,17,0,311
60634,75995,36934,343,2763,722,487,2418,989,39061
61910,4225,2010,14,114,22,58,136,30,2215
15026,3409,1864,7,112,35,0,91,42,1545
15077,150,84,0,5,2,0,6,4,66
15627,6571,3262,18,183,44,43,217,100,3309
21719,1036,518,0,17,15,0,30,0,518
11730,13860,7069,154,351,92,69,247,249,6791
18446,3307,1696,15,63,51,10,106,57,1611
1923,27457,12841,103,521,260,217,711,456,14616
39206,24653,10438,150,777,161,126,1086,483,14215
39342,1374,578,48,61,8,10,91,9,796
30293,2948,1466,0,81,31,7,81,54,1482
30909,43374,20127,358,1091,237,183,1298,539,23247
45371,19867,9953,98,445,297,76,578,237,9914
46986,1571,772,0,23,4,0,44,11,799
36572,6165,3021,19,197,113,0,196,122,3144
24149,3530,1806,0,89,62,21,85,30,1724
41775,44,24,0,5,0,0,0,0,20
28512,3236,1621,10,34,59,6,38,113,1615
29209,33590,16615,187,1011,285,131,1083,411,16975
29410,22836,11770,93,870,143,84,906,280,11066
29544,5301,2549,18,190,30,16,281,96,2752
29939,383,236,0,7,1,0,26,2,147
48206,15745,7291,282,425,204,134,361,231,8454
98937,3874,1995,9,77,58,3,97,88,1879
81243,101,62,0,0,3,0,0,0,39
84651,25829,12948,205,957,101,242,949,182,12881
75451,1135,654,12,55,13,0,50,0,481
76116,50640,24544,378,1458,359,240,1853,861,26096
76117,31860,15701,423,1348,182,227,931,437,16159
76444,3585,1606,15,51,63,13,120,18,1979
76520,7921,3856,18,164,93,32,181,145,4065
77541,18677,9570,222,505,152,104,656,220,9107
78212,29225,15015,390,1072,343,313,856,440,14210
67557,601,319,3,12,2,0,21,4,282
67667,158,95,0,0,4,1,1,3,63
58497,229,125,0,32,1,0,23,3,104
60151,4024,1974,11,128,63,17,82,88,2050
50130,1592,754,9,39,16,13,45,15,838
64420,64,27,0,0,0,0,0,4,37
45806,10608,5123,86,261,102,39,241,177,5485
54829,5344,2647,12,190,64,13,129,58,2697
55802,2384,1196,34,79,63,1,78,47,1188
61301,10088,5116,27,268,86,17,356,88,4972
29727,1441,745,8,60,9,0,35,27,696
36272,13221,6243,63,330,161,28,409,306,6978
38063,16536,7793,104,487,129,127,620,194,8743
40011,2617,1275,10,69,69,0,41,36,1342
23125,255,105,0,0,0,0,0,0,150
30182,2498,1206,0,36,3,8,38,42,1292
25315,3431,1599,9,127,64,2,101,51,1832
25505,527,301,0,22,0,21,44,0,226
83243,60,24,0,0,0,0,0,0,36
16246,239,117,5,4,1,2,12,8,122
16674,703,331,0,25,16,7,18,11,372
17946,205,113,0,0,0,0,0,0,92
7501,32028,15791,301,960,231,202,1132,414,16237
10309,33531,16842,306,1168,478,146,979,442,16689
22652,1339,724,0,35,25,0,51,16,615
3104,32603,16791,142,1055,373,276,967,384,15812
4253,2082,1017,3,115,27,7,107,37,1065
2717,4885,2495,29,103,73,17,175,97,2390
74464,31404,15223,416,963,309,327,969,351,16181
75057,14111,7318,33,574,61,50,698,178,6793
75852,4462,3988,124,579,9,9,26,9,474
77632,23288,11384,61,563,279,217,834,249,11904
80747,383,206,3,15,6,0,11,4,177
81615,2824,1391,5,372,164,0,0,45,1433
83325,849,397,5,21,21,8,15,6,452
85356,4889,2469,10,124,93,39,114,13,2420
79022,11346,6390,26,375,133,19,292,119,4956
79526,975,482,9,18,17,0,21,35,493
98032,38016,19276,251,1455,264,239,1318,427,18740
98586,1640,777,11,26,26,9,39,13,863
87012,255,126,0,0,10,0,11,10,129
92104,45202,22825,210,2634,205,245,1887,499,22377
29487,2999,1510,8,89,22,0,63,28,1489
33872,15778,7816,22,224,433,26,249,112,7962
35405,45473,21304,358,1549,335,567,1324,524,24169
45328,564,299,4,9,2,2,12,3,265
45650,460,291,0,29,0,0,8,0,169
47639,4261,2024,57,167,16,18,164,19,2237
42324,1069,566,0,70,20,13,47,16,503
3467,1685,797,4,24,54,10,24,32,888
22311,18952,9756,9,1331,117,48,1261,201,9196
16701,17297,8551,148,470,212,170,503,271,8746
18617,1897,1005,0,103,45,0,51,28,892
92508,39225,18975,232,1270,235,352,1159,376,20250
92662,2606,1228,0,62,60,20,30,139,1378
93023,20231,9602,60,498,374,74,651,433,10629
93240,6343,2923,40,94,38,0,86,181,3420
95210,41117,19718,435,977,225,406,1310,583,21399
97048,7579,3847,9,202,141,10,181,139,3732
97321,26382,12941,122,672,346,276,885,443,13441
98006,37769,18428,151,1010,446,211,987,556,19341
60525,30576,15276,146,1057,254,81,846,414,15300
61938,21840,10711,129,551,212,217,718,221,11129
62920,3354,1692,33,112,23,4,82,57,1662
63019,4335,2151,0,174,17,28,119,45,2184
79251,15,5,0,0,0,0,0,2,10
79357,2166,1088,0,83,51,0,76,22,1078
79742,470,240,2,15,2,0,13,9,230
79855,2155,1158,26,19,62,2,11,54,997
80513,12580,6383,97,536,203,50,361,209,6197
81411,52,21,0,0,0,0,0,0,31
83467,5978,3011,28,114,56,48,110,130,2967
83501,34888,17092,219,1106,385,271,816,450,17796
68416,253,145,2,12,3,0,5,4,108
71237,1950,1277,38,102,21,0,30,9,673
72331,3104,1527,9,38,38,29,74,31,1577
59714,20288,9924,108,788,212,162,870,310,10364
65619,7336,3508,45,345,156,28,325,119,3828
55961,407,194,1,12,5,4,7,3,213
57466,226,121,0,6,0,0,7,0,105
48738,1181,589,8,25,9,0,33,29,592
49271,2002,1059,3,24,20,9,30,15,943
49927,487,268,0,24,1,0,5,7,219
39744,5721,2810,33,213,103,60,134,101,2911
32277,32029,14871,103,1274,241,304,1048,457,17158
36316,1921,946,0,68,37,30,63,66,975
44311,8447,4296,279,112,39,206,182,47,4151
46531,1510,746,0,32,65,26,34,66,764
51458,1416,699,4,51,23,7,24,32,717
52073,1346,665,2,30,5,1,13,28,681
39323,1475,719,14,22,0,4,0,0,756
62321,3845,1868,36,113,34,0,117,49,1977
70447,14825,7445,57,647,82,35,758,179,7380
71463,10652,6269,32,735,94,18,52,27,4383
79225,1016,517,0,45,15,0,27,19,499
77450,73683,35890,478,2616,589,271,2384,970,37793
65483,4355,2072,75,95,40,7,153,45,2283
67649,212,110,0,5,4,0,4,0,102
18245,350,156,0,10,0,0,8,2,194
18328,7293,4104,85,145,114,40,125,79,3189
25666,619,325,0,23,0,0,46,0,294
27013,6135,3067,47,102,116,62,137,90,3068
28147,24878,12481,59,812,223,103,1045,364,12397
28306,41944,20511,279,1255,174,189,1656,628,21433
28375,135,62,0,0,0,0,4,0,73
34743,44335,21219,320,1596,204,240,1475,376,23116
36013,650,293,26,19,0,0,26,12,357
43931,375,176,0,13,0,0,14,9,199
27371,9102,4449,17,280,81,51,227,123,4653
62379,1725,905,0,57,11,0,52,29,820
62656,19535,9332,144,658,171,132,571,250,10203
21204,21628,10438,658,449,223,627,413,266,11190
64063,20690,9814,96,536,283,103,680,263,10876
68467,9483,4397,87,262,33,16,211,209,5086
4079,3868,1761,0,76,75,0,84,82,2107
64832,661,372,3,17,0,0,22,10,289
65443,101,36,0,0,0,0,0,0,65
66216,24727,12247,124,774,262,216,618,333,12480
66772,182,92,1,25,3,2,18,5,90
66779,639,324,24,14,4,5,21,8,315
67841,348,207,2,2,5,6,2,9,141
72636,6,3,0,0,2,0,0,0,3
17371,261,144,9,6,18,7,10,0,117
31201,8103,4413,219,303,103,82,129,146,3690
24920,243,144,0,0,0,0,0,6,99
17727,86,49,0,0,5,0,0,1,37
18101,4448,2275,17,110,0,38,150,61,2173
8035,7680,3581,13,249,67,26,224,129,4099
8328,1239,611,0,62,8,0,59,23,628
11370,32514,19284,331,1665,251,81,970,329,13230
11552,25178,12700,273,746,269,230,577,468,12478
54113,3570,1499,23,107,59,0,158,53,2071
55370,722,374,2,18,12,4,29,13,348
37733,95,56,0,0,0,0,0,0,39
38342,1523,729,22,43,36,20,71,2,794
16362,1029,496,6,13,12,0,22,16,533
8226,11202,5173,16,182,137,29,275,195,6029
13404,158,67,0,3,4,0,0,0,91
13750,919,509,3,3,0,0,11,51,410
25008,139,76,0,0,0,0,0,0,63
1095,14690,6827,118,265,344,75,510,283,7863
1535,4764,2261,2,133,42,47,120,23,2503
76015,16253,7922,252,496,89,93,479,184,8331
78159,1122,558,5,34,9,4,29,14,564
78675,340,213,0,40,11,0,0,0,127
71110,4884,3190,324,157,0,71,158,0,1694
73443,3885,2008,47,103,13,35,78,34,1877
2852,22031,10655,68,555,314,168,615,384,11376
3856,1670,796,10,31,22,5,52,41,874
4757,3016,1493,4,92,59,4,50,31,1523
5833,302,184,0,3,14,0,0,3,118
8833,8412,4112,66,129,72,81,134,100,4300
64830,710,323,0,77,3,0,37,13,387
66501,358,165,0,7,1,0,11,6,193
59864,7186,3620,62,225,107,36,245,66,3566
53137,1641,802,7,29,17,15,34,33,839
37046,5098,2583,16,161,29,0,268,50,2515
37180,3986,1935,32,50,34,24,55,14,2051
37210,17935,9071,226,619,138,196,721,242,8864
28791,14954,6928,125,395,238,29,263,281,8026
14701,39731,19514,207,1134,432,251,1193,616,20217
21015,29192,14152,103,868,305,171,762,446,15040
21077,271,125,0,13,0,0,14,0,146
21562,3271,1597,76,13,16,11,101,0,1674
45301,130,71,0,0,0,0,14,15,59
55346,16413,8153,87,539,239,86,483,287,8260
47983,254,120,0,25,0,0,36,0,134
49330,5590,2721,47,166,64,39,144,40,2869
52773,2472,1292,13,127,14,0,85,46,1180
43553,139,62,0,7,0,0,13,0,77
15042,8434,4125,13,157,139,6,226,147,4309
20874,61045,29786,222,2347,409,227,2623,478,31259
24174,2762,1528,50,110,26,6,74,115,1234
28733,10,7,0,0,0,0,0,0,3
29163,2372,905,126,140,3,38,32,16,1467
74560,608,276,6,11,12,2,14,17,332
75849,78,47,0,7,0,0,0,0,31
76036,25597,12216,237,784,157,57,1104,295,13381
76244,76882,38627,207,3019,160,255,3378,291,38255
86011,9124,3224,193,0,0,223,0,0,5900
64499,80,35,0,0,11,0,4,0,45
13685,2520,1170,2,47,5,0,71,64,1350
14539,171,91,0,0,0,0,9,10,80
15126,7899,3910,12,312,105,15,198,115,3989
75248,36829,18187,184,1573,408,144,1399,533,18642
86334,4351,2142,39,214,53,58,289,88,2209
87935,1570,741,0,0,60,23,0,24,829
99137,384,162,0,23,3,7,6,17,222
99552,416,226,1,16,1,2,9,3,190
25427,13895,6689,96,191,121,9,325,184,7206
26184,2562,1309,5,54,27,10,57,67,1253
13158,1539,776,17,51,21,4,22,44,763
1536,7786,3670,9,308,56,15,303,103,4116
1537,2289,1067,0,90,7,0,184,0,1222
28411,37995,18567,188,1475,387,108,1321,402,19428
41836,1316,673,32,45,0,14,37,0,643
59479,747,409,0,13,13,0,16,2,338
60008,21833,10604,120,741,214,147,607,357,11229
60185,36129,18710,182,1255,320,180,1255,387,17419
60530,484,257,8,29,15,0,18,5,227
61734,2765,1358,14,63,37,9,72,91,1407
62201,7570,3285,44,108,53,88,129,59,4285
96744,51692,25949,244,1466,665,187,1331,696,25743
97439,14413,6711,53,216,265,91,245,444,7702
67063,3580,1735,37,108,20,65,81,56,1845
80033,25323,12218,168,1065,203,125,797,561,13105
93101,31624,15681,313,1377,253,173,1299,474,15943
93616,2664,1478,59,49,20,49,79,24,1186
86033,7407,3652,47,99,104,75,242,60,3755
66725,5556,2825,16,131,60,7,240,84,2731
72120,33310,15813,169,1016,403,195,1190,385,17497
72166,119,67,0,19,0,0,0,0,52
72585,488,226,0,46,16,0,59,0,262
45844,3172,1697,32,117,26,12,142,43,1475
46074,33114,16071,70,1237,332,54,1232,347,17043
48243,0,0,0,0,0,0,0,0,0
39740,5303,2709,0,128,58,53,215,58,2594
41002,2656,1360,19,30,27,20,122,31,1296
41849,85,41,0,0,0,0,0,0,44
36545,10030,4650,110,308,114,21,388,151,5380
37408,1690,749,18,75,42,40,65,31,941
37869,4685,2340,19,107,77,54,120,61,2345
58642,303,158,0,0,26,0,12,0,145
61087,1493,726,11,17,22,3,18,22,767
63349,2186,1210,0,123,12,6,98,12,976
63830,6917,3284,75,231,54,104,283,57,3633
3605,911,440,0,31,37,0,40,25,471
4691,325,161,9,10,7,0,2,0,164
5772,692,353,4,3,7,0,11,9,339
6378,5505,2679,55,91,126,21,76,108,2826
23601,25578,12146,129,631,235,143,988,393,13432
25193,676,323,0,7,7,17,55,16,353
8554,3947,1837,30,122,13,0,116,55,2110
10597,851,398,0,0,15,0,0,19,453
21047,12096,6000,19,249,186,73,405,197,6096
27858,59652,28226,2264,1488,633,2638,1736,710,31426
17968,273,144,0,10,7,3,6,2,129
29585,15022,7314,66,165,319,129,127,204,7708
29621,40931,19267,322,1016,490,321,960,463,21664
77342,0,0,0,0,0,0,0,0,0
77861,2398,1103,28,82,46,8,87,65,1295
78207,54601,28588,477,1989,422,360,1611,435,26013
52302,40340,19645,112,1613,306,323,1571,505,20695
53104,5450,2926,56,142,126,0,72,41,2524
55703,630,353,0,21,13,0,19,14,277
59226,401,192,2,2,5,2,14,12,209
59851,104,66,0,14,0,0,0,0,38
60918,777,422,0,21,4,2,33,20,355
62091,380,173,0,31,3,0,24,2,207
68044,562,275,0,6,12,0,5,24,287
68733,1371,704,44,31,21,4,44,19,667
70130,14279,7261,97,609,136,46,490,156,7018
71018,1363,694,0,46,12,0,17,8,669
71666,37,20,0,0,0,0,0,0,17
56256,2386,1159,2,35,61,1,40,27,1227
57265,188,100,0,5,3,0,2,2,88
57471,585,319,1,10,2,0,21,3,266
58204,2347,1246,34,117,0,30,81,0,1101
72419,1581,816,5,46,0,0,48,3,765
76084,8453,4690,120,471,58,48,272,50,3763
50239,72,28,0,0,1,0,7,6,44
51108,5367,2526,43,110,98,61,158,72,2841
52033,3172,1525,44,72,57,27,89,45,1647
52147,1102,579,4,8,19,1,21,5,523
53017,5762,3049,27,133,86,0,106,147,2713
53075,3298,1683,12,75,47,11,73,59,1615
54922,1347,719,7,33,11,3,46,24,628
55016,35783,17865,165,1189,404,315,1219,325,17918
56119,958,486,5,21,8,18,19,10,472
56173,357,174,17,11,4,1,23,0,183
56349,849,479,5,26,9,1,36,16,370
43029,563,303,11,16,32,18,30,24,260
39157,24522,11595,119,727,111,306,1121,337,12927
39601,22633,10255,172,911,304,43,806,278,12378
40949,752,437,14,0,0,0,4,23,315
47265,20476,10134,183,751,129,67,594,254,10342
17046,30815,15289,241,915,308,247,1069,410,15526
6076,12577,5966,93,154,189,201,549,189,6611
27818,1335,656,0,0,65,0,84,19,679
27863,12855,6484,65,599,95,12,369,259,6371
29058,4671,2499,163,105,54,0,163,42,2172
12577,1972,981,0,33,14,98,105,22,991
21921,44896,22035,274,1406,571,172,1750,746,22861
22578,2315,1156,12,53,60,0,24,137,1159
23389,258,145,0,0,0,0,45,0,113
23464,76495,37236,500,2547,802,557,2733,1032,39259
24465,1388,650,0,35,28,12,29,25,738
21545,1725,815,8,70,21,34,31,32,910
25260,1375,612,0,39,10,16,25,10,763
94511,2010,1127,67,47,11,38,50,10,883
96124,329,143,0,2,9,0,5,0,186
90822,139,119,0,0,15,0,0,0,20
61431,296,161,0,0,7,0,5,0,135
61468,81,47,9,0,5,0,0,0,34
64469,2191,1083,1,78,3,14,78,9,1108
79518,30,17,0,0,0,0,0,0,13
71129,12993,6153,93,340,67,98,453,273,6840
72390,8106,3971,26,277,66,0,180,114,4135
82633,9933,5075,3,274,100,53,161,113,4858
58002,37,26,0,0,0,0,0,0,11
58049,386,173,0,10,4,0,9,5,213
67131,328,174,0,0,0,0,4,6,154
69134,388,189,0,6,1,2,19,6,199
66953,707,352,2,19,7,4,15,4,355
52060,8402,4016,99,235,118,52,175,171,4386
53188,35799,17297,177,1074,402,223,985,494,18502
54521,7782,3768,48,237,136,3,148,122,4014
54946,96,76,0,0,6,0,0,3,20
54980,103,48,0,0,0,0,0,0,55
55709,3851,1973,14,107,26,8,131,62,1878
39530,7954,3996,70,176,108,57,195,125,3958
40146,4251,2102,6,85,34,8,110,87,2149
45502,15779,7670,145,442,271,65,499,227,8109
46307,62274,30654,280,2231,666,289,2301,771,31620
47532,4499,2260,31,116,28,68,109,67,2239
48028,1030,520,0,10,50,0,3,22,510
48470,801,415,0,19,9,0,25,16,386
49017,21793,10199,84,565,257,175,616,432,11594
56120,954,472,7,20,24,0,16,8,482
50073,1143,583,3,43,4,4,48,17,560
33953,6885,3511,0,84,232,0,116,146,3374
2061,10987,5385,57,322,131,18,421,86,5602
13501,37646,18224,356,934,371,279,1107,381,19422
24578,955,481,21,16,40,0,52,24,474
25557,1797,868,0,30,15,32,74,20,929
10546,1496,743,11,39,19,65,17,0,753
11559,8181,3562,59,127,78,32,251,48,4619
12513,354,181,0,0,35,0,0,15,173
29223,50870,22801,376,1528,462,395,1965,692,28069
29836,405,205,0,0,9,0,0,14,200
84632,1133,506,24,25,9,8,33,6,627
74346,7479,3815,38,196,56,15,203,93,3664
68443,923,466,0,28,26,0,33,13,457
68834,162,81,4,0,2,0,2,4,81
68872,851,483,0,10,4,0,22,0,368
78671,759,335,0,0,0,0,0,8,424
79231,96,47,0,0,0,0,0,0,49
70739,14484,7003,204,404,169,72,467,282,7481
91205,37618,17509,203,1224,303,146,1466,523,20109
97702,47672,23761,117,1314,799,137,1657,828,23911
97710,136,62,0,0,1,0,3,7,74
97883,2375,1326,10,89,32,0,55,31,1049
99149,271,127,0,2,0,3,2,10,144
97224,34625,16992,131,1074,387,126,1056,394,17633
94546,44272,21309,97,1856,373,232,1779,684,22963
42539,9696,4745,30,262,116,50,198,93,4951
47710,19081,9625,83,749,226,101,526,295,9456
45322,21282,10276,136,717,359,80,857,363,11006
45817,6892,3465,43,300,151,38,321,96,3427
14823,3561,1814,18,43,58,0,98,57,1747
16137,12750,7189,30,511,154,71,299,255,5561
31701,18584,8849,260,533,295,212,471,351,9735
33805,25709,12483,129,876,407,220,899,309,13226
26296,75,45,0,0,0,0,0,0,30
21162,4354,2255,33,160,61,39,204,85,2099
18457,216,109,0,0,0,0,0,0,107
18844,1964,962,15,43,25,0,66,46,1002
27872,480,261,8,30,20,0,21,7,219
18104,44816,20766,556,1243,620,680,1435,687,24050
44140,15391,7660,49,494,179,21,505,354,7731
45895,17930,9013,113,413,327,155,609,215,8917
31220,14504,6874,53,468,184,122,498,243,7630
31415,12386,5824,133,250,85,62,372,194,6562
32113,5366,2870,9,162,139,0,65,154,2496
62425,502,279,0,13,0,0,4,0,223
69129,1165,551,0,34,20,8,0,14,614
76261,235,141,0,6,6,0,3,3,94
77436,48,13,0,0,0,0,0,0,35
78145,145,60,0,7,4,0,6,0,85
65737,8542,4219,70,126,191,80,165,92,4323
67410,9924,4959,5,287,97,32,310,126,4965
67524,632,332,0,22,2,4,9,2,300
72437,3556,1703,6,123,66,10,110,133,1853
72932,1645,895,8,109,21,15,88,57,750
85625,2211,1074,0,21,113,6,17,31,1137
93242,3541,1576,28,185,26,40,171,46,1965
95249,4854,2543,9,113,0,39,146,52,2311
98109,29154,15595,67,1561,235,214,1091,280,13559
98340,2912,1290,0,0,91,0,47,29,1622
98577,6909,3502,61,264,72,54,217,102,3407
97130,363,191,0,0,15,0,0,18,172
2825,5500,2654,10,78,79,12,144,94,2846
3849,1462,691,1,33,8,8,30,37,771
4061,2978,1734,62,65,36,0,88,23,1244
4357,3378,1568,25,36,37,10,64,86,1810
43522,3291,1701,30,129,78,26,123,71,1590
37022,6473,3241,79,195,99,47,149,94,3232
38544,7220,3436,60,247,83,58,172,86,3784
20611,1535,902,0,48,39,8,47,21,633
21090,10494,5116,134,395,117,42,270,114,5378
23005,17020,8163,347,531,214,138,573,218,8857
52359,253,159,2,0,2,0,6,1,94
55046,5463,2711,0,166,57,60,178,20,2752
41051,30166,14888,143,1338,187,257,935,256,15278
44086,2558,1280,13,43,75,18,52,18,1278
98270,50972,24530,276,1813,325,243,1749,628,26442
55382,3649,1844,27,123,43,13,107,53,1805
56210,5,2,0,0,0,0,0,0,3
58104,40832,19877,502,1578,376,377,1691,433,20955
61401,33685,17411,481,1044,454,286,869,519,16274
61419,114,46,0,3,0,0,6,6,68
48342,16431,7886,188,426,120,188,524,135,8545
49015,26950,13126,244,842,360,327,967,450,13824
44104,19640,8305,118,446,272,149,525,168,11335
45041,87,44,0,0,0,0,7,0,43
49623,1186,600,7,41,6,0,23,30,586
50452,947,455,34,15,7,7,26,14,492
42037,78,44,0,0,0,0,0,0,34
42064,8294,4183,64,281,83,43,313,100,4111
39204,17603,8475,197,509,185,225,710,143,9128
87010,1010,487,21,0,37,64,0,20,523
89703,9869,4925,62,236,138,43,138,199,4944
98221,21411,10279,101,537,379,51,483,473,11132
98602,160,39,0,0,0,0,0,9,121
99179,530,277,6,17,9,0,24,5,253
99740,533,283,3,16,7,0,13,9,250
99759,251,143,3,2,1,1,11,1,108
93923,12833,5874,11,149,289,27,207,152,6959
94618,17041,7942,18,646,288,53,538,163,9099
95013,77,22,0,0,0,0,0,0,55
95673,15753,7560,68,339,200,35,375,248,8193
96010,146,102,9,12,8,0,0,0,44
96069,828,425,0,19,59,0,19,20,403
3771,927,506,21,26,14,9,12,14,421
4228,0,0,0,0,0,0,0,0,0
5076,403,205,0,8,17,0,10,0,198
7112,25555,11625,396,606,71,127,959,333,13930
22201,37545,18326,36,1734,189,42,1428,300,19219
28616,252,139,0,9,1,0,20,2,113
29080,2859,1330,5,16,57,15,27,75,1529
30206,3609,1848,54,48,5,24,98,57,1761
30823,1837,837,81,33,16,58,31,23,1000
31331,7900,3920,19,87,126,0,226,83,3980
31519,3474,1674,40,57,42,14,68,81,1800
37127,17835,8886,258,681,181,140,624,231,8949
38320,10357,5128,29,396,167,70,313,125,5229
17566,12567,6577,114,266,114,87,264,123,5990
21202,21010,12439,222,1234,160,138,622,143,8571
21838,1810,881,0,26,29,6,100,36,929
22949,1269,614,0,19,20,0,0,33,655
42410,1464,713,17,69,6,19,73,30,751
27947,1431,759,0,107,29,0,112,0,672
40050,1796,831,50,35,2,0,24,65,965
40142,2148,1101,0,65,8,29,64,16,1047
54127,93,69,0,0,0,0,0,0,24
56229,1850,904,4,57,15,0,54,12,946
56352,6020,3001,8,249,70,56,162,38,3019
67520,290,142,0,11,5,0,16,7,148
62610,125,66,0,10,4,0,4,1,59
63458,117,69,0,3,0,0,0,2,48
63839,429,218,0,13,8,10,11,4,211
48374,15987,7996,0,622,189,77,474,312,7991
56071,12742,6370,39,459,151,76,290,70,6372
61375,1157,603,3,50,18,9,22,11,554
74014,40100,19759,194,1324,352,154,1493,576,20341
98051,4333,1967,0,97,61,73,49,136,2366
33037,10955,5430,12,184,195,0,220,163,5525
7005,15095,7505,27,382,193,90,429,213,7590
37409,2691,1269,23,170,24,0,146,61,1422
96716,2982,1415,62,68,51,20,91,90,1567
97712,71,38,0,0,0,0,0,0,33
57760,1158,614,25,3,37,17,17,45,544
59330,8628,4586,22,372,104,0,176,139,4042
78670,115,56,0,0,1,3,2,6,59
78843,577,423,106,0,0,5,0,0,154
68505,16945,8459,233,607,187,206,559,116,8486
68822,4580,2209,115,218,55,5,80,32,2371
61261,934,497,15,15,14,24,23,3,437
61283,1742,897,7,47,12,0,92,14,845
62027,494,268,0,14,3,10,19,10,226
62255,1279,677,6,37,18,0,26,4,602
49965,583,303,0,42,8,0,35,16,280
55742,361,182,3,6,18,0,21,15,179
56519,232,126,0,2,7,10,2,0,106
57779,191,98,0,0,0,0,0,0,93
64019,2656,1399,62,124,14,27,63,33,1257
64157,19918,9580,37,1082,133,146,1370,109,10338
97754,19803,9631,34,582,256,160,578,316,10172
56660,335,156,0,13,7,6,21,3,179
59538,2913,1512,40,95,66,38,61,35,1401
59728,311,172,0,15,4,2,7,5,139
60416,9164,4645,128,388,73,9,261,56,4519
53029,21433,10464,205,596,294,139,474,402,10969
64081,24088,11733,16,745,225,81,697,305,12355
71004,672,277,3,12,10,0,17,27,395
55049,2679,1415,19,107,23,26,78,16,1264
80926,1938,884,12,39,12,12,56,72,1054
84339,5402,2699,76,242,82,17,204,56,2703
85282,54649,29414,942,1879,591,692,1411,665,25235
98332,18321,8445,74,443,298,0,679,253,9876
95051,58123,29996,138,2691,554,117,2397,823,28127
30620,13644,6576,134,588,126,50,564,100,7068
35208,13864,6534,94,518,175,81,432,135,7330
38077,68,18,0,10,0,0,0,23,50
44805,32833,15853,417,1018,392,269,786,539,16980
47160,113,57,0,7,0,4,0,1,56
94549,29639,14149,71,639,421,105,864,301,15490
95236,4223,2106,1,84,83,51,169,95,2117
95612,1078,613,0,27,7,0,48,0,465
95916,1216,662,6,47,21,7,11,52,554
96764,592,312,0,28,0,8,22,26,280
87325,3089,1506,26,99,33,15,95,25,1583
99122,3825,1966,17,83,58,55,98,35,1859
55442,12831,5769,28,394,233,26,403,362,7062
56356,282,134,2,8,1,0,6,10,148
42053,5393,2769,11,159,91,8,172,119,2624
44050,6384,3107,29,100,80,7,92,75,3277
45433,2734,1582,154,77,8,9,64,18,1152
33073,34652,16531,234,1296,232,107,1412,276,18121
35007,26328,12996,121,743,219,221,1058,216,13332
35022,20271,9674,77,554,420,67,709,471,10597
52251,580,302,13,30,15,0,16,1,278
53103,3752,1967,14,75,29,5,78,69,1785
48027,3185,1691,39,81,29,44,99,51,1494
48766,1256,692,6,52,22,22,24,26,564
49751,2179,1154,4,36,23,24,62,39,1025
49776,1853,903,10,38,27,3,50,42,950
30180,37325,17694,172,1180,329,261,1132,461,19631
31309,923,450,0,31,0,0,45,60,473
37876,32425,15703,157,916,426,212,843,588,16722
38859,999,537,61,9,12,0,10,27,462
46036,11850,5931,94,351,124,24,407,95,5919
46501,3580,1790,3,98,26,40,99,16,1790
78410,28065,13577,136,799,360,320,1154,425,14488
80467,2145,1053,3,102,29,18,90,18,1092
80910,30196,14762,429,1158,134,286,920,387,15434
81124,204,74,0,0,0,0,8,0,130
60940,3433,1728,19,111,32,42,73,29,1705
64120,383,211,0,4,0,0,19,10,172
72433,3003,1579,44,81,7,15,119,52,1424
72450,38692,18817,430,1037,410,373,1477,329,19875
73077,6808,3284,17,100,70,6,151,117,3524
73761,350,174,0,8,6,0,9,8,176
73860,1518,692,20,39,27,4,26,18,826
75755,5303,2539,68,107,45,14,175,64,2764
89446,0,0,0,0,0,0,0,0,0
90045,41149,19877,415,1453,361,482,1368,456,21272
18052,27568,13174,183,913,216,188,924,428,14394
18068,0,0,0,0,0,0,0,0,0
6422,7248,3578,30,183,95,81,157,141,3670
6777,1294,680,13,26,35,0,22,13,614
12528,12871,6424,75,301,162,124,358,152,6447
13142,6338,3139,16,169,33,44,155,94,3199
13413,16382,7495,130,309,171,81,325,240,8887
39332,1509,757,4,104,27,0,100,5,752
28205,48539,24526,237,2212,403,283,2145,667,24013
40815,1198,628,28,0,7,0,34,37,570
52045,2478,1268,15,67,47,3,62,32,1210
52218,1800,928,6,75,31,0,58,16,872
54023,4154,2052,8,182,39,22,222,30,2102
64728,611,303,0,15,18,4,33,14,308
63462,1460,748,5,55,36,0,8,21,712
63551,360,165,0,1,12,14,0,0,195
58214,308,130,9,0,0,0,0,15,178
61340,245,117,4,3,2,0,0,0,128
48811,5323,3555,34,267,44,14,91,53,1768
48825,12770,6174,415,0,0,249,0,0,6596
49247,5621,2685,20,98,104,40,140,80,2936
70049,2053,1000,25,92,0,42,103,65,1053
56093,12329,5717,97,273,130,221,380,156,6612
73552,1512,774,28,60,9,1,19,30,738
43926,236,144,8,5,2,5,5,0,92
44144,21697,10868,168,706,184,128,793,328,10829
56362,5840,2843,24,152,92,29,136,106,2997
53076,4082,1976,40,64,69,2,105,40,2106
54488,1180,614,8,29,12,4,23,4,566
54745,1932,974,4,21,56,3,32,45,958
40026,6328,3171,121,169,39,23,188,120,3157
40222,21943,10448,64,750,181,76,698,254,11495
31642,4779,2473,62,133,35,8,232,31,2306
32432,0,0,0,0,0,0,0,0,0
33176,52461,25055,229,1871,567,417,1679,702,27406
44129,28276,13999,273,841,142,121,780,414,14277
46797,3597,1860,16,146,26,5,151,55,1737
48708,26281,13199,253,812,427,170,829,386,13082
29482,2148,1083,15,46,24,4,34,52,1065
49504,39401,19772,601,1243,366,510,1148,312,19629
14721,105,54,0,0,3,0,0,0,51
15821,131,68,0,4,3,0,4,4,63
26269,945,472,0,24,11,6,3,17,473
21864,645,274,41,6,0,0,6,0,371
18425,1190,664,6,21,5,0,16,43,526
8062,16312,7980,64,297,121,80,562,226,8332
11357,39902,18957,159,1007,607,221,1318,777,20945
13057,13772,6424,27,282,186,139,409,194,7348
13131,3736,1933,46,118,141,46,86,38,1803
27957,1298,705,0,0,65,0,16,19,593
58332,300,162,0,9,1,2,2,0,138
59317,1084,556,0,31,14,30,15,13,528
60420,4812,2485,62,191,59,19,179,109,2327
60425,8912,4032,86,314,57,18,228,104,4880
61957,1912,991,23,60,19,0,87,36,921
57025,2986,1432,14,100,32,17,112,9,1554
33952,33662,16379,255,949,652,131,736,517,17283
36319,1917,929,0,42,36,2,76,27,988
47220,5803,2740,28,139,41,22,197,45,3063
47519,930,420,0,22,23,0,12,1,510
47564,1186,598,10,21,14,0,9,0,588
49030,2441,1225,17,127,22,0,106,15,1216
11961,13330,6027,50,318,125,33,389,146,7303
12720,113,68,0,0,0,0,0,0,45
13211,6145,2865,32,157,24,38,174,77,3280
52162,3551,1804,13,89,48,18,51,59,1747
53211,35708,18219,1198,923,283,923,819,326,17489
28707,160,53,0,0,0,0,0,0,107
29434,456,244,0,21,15,0,0,0,212
26611,144,56,0,0,0,0,0,0,88
26720,233,107,0,17,0,0,0,0,126
27922,786,381,0,15,10,8,12,12,405
24122,1629,776,0,25,0,0,70,9,853
28472,18423,9164,25,756,182,128,594,333,9259
30094,34928,16214,387,986,299,77,1226,467,18714
19936,282,101,0,12,0,0,0,16,181
95317,906,508,0,33,3,0,23,6,398
84317,2083,1097,7,73,72,0,68,87,986
85043,39757,19258,429,2033,163,279,1813,364,20499
97218,15647,7554,50,745,276,148,654,125,8093
97463,3866,2144,91,88,153,61,120,42,1722
10028,47793,20516,67,1554,427,81,2015,711,27277
3816,1536,730,6,61,28,27,36,36,806
1083,2986,1413,31,52,59,29,175,63,1573
25526,22889,10922,38,784,287,94,935,280,11967
26230,98,62,0,0,8,0,0,0,36
26447,1424,720,0,60,18,17,83,15,704
26750,719,355,0,33,13,0,12,19,364
28117,39278,19430,251,1068,368,177,1417,431,19848
28207,9539,4666,51,304,115,77,287,78,4873
28376,44328,22111,284,1804,385,221,1557,469,22217
57652,423,230,0,0,0,7,15,10,193
59275,353,201,0,5,4,2,5,2,152
73055,10034,4854,58,300,95,39,284,178,5180
73650,1128,468,0,32,6,16,30,15,660
49878,3381,1626,35,53,92,27,71,86,1755
50633,375,210,4,4,9,0,0,9,165
30319,41839,20698,106,2113,387,201,2193,484,21141
32180,3934,2170,39,71,90,26,157,50,1764
37145,2092,1090,44,37,48,12,62,15,1002
46793,4662,2283,25,107,26,50,172,78,2379
27370,15678,7485,56,384,285,120,391,299,8193
27910,11833,5472,56,158,139,59,350,155,6361
27973,1143,588,0,47,24,12,32,23,555
43505,52,23,0,1,0,0,3,1,29
29479,6758,3276,42,205,72,110,213,111,3482
29613,1917,817,150,0,0,214,0,0,1100
29831,4332,2188,30,107,34,47,122,65,2144
29915,445,223,0,23,14,0,18,4,222
72347,644,304,0,16,28,10,13,14,340
73440,284,129,0,0,0,0,0,0,155
73507,22480,11725,224,726,200,167,810,351,10755
70733,1380,633,0,37,7,0,47,11,747
12045,475,268,0,26,9,0,26,0,207
12498,5005,2547,0,53,102,20,155,42,2458
12959,1108,515,0,0,15,0,0,0,593
4453,745,371,0,9,17,2,17,19,374
4847,1583,829,0,67,34,7,34,31,754
4957,4164,2052,14,72,53,13,143,48,2112
6350,46,18,0,0,0,0,0,4,28
6905,20493,9955,85,758,153,129,709,250,10538
14608,12019,5681,174,327,92,131,407,155,6338
15750,398,182,0,10,0,0,0,0,216
85623,5337,2597,0,91,171,0,119,81,2740
87735,75,53,0,0,0,0,0,0,22
77027,16962,7941,0,713,302,31,677,187,9021
89438,108,70,0,0,12,0,0,0,38
90040,12645,6114,55,495,119,111,408,186,6531
90249,26587,12512,157,893,295,67,814,420,14075
90631,69502,33901,396,2290,596,434,2186,714,35601
92253,40368,19905,197,1232,527,121,945,774,20463
92282,1373,740,13,82,17,11,12,42,633
78235,1176,681,0,182,0,6,118,13,495
78719,1815,920,0,69,22,0,19,8,895
79346,2248,1162,0,86,12,14,58,24,1086
97840,115,74,0,0,7,0,8,5,41
93614,11676,5340,53,169,187,76,224,199,6336
95007,681,346,0,0,48,0,40,13,335
97431,2381,1110,0,116,56,16,140,159,1271
68966,646,344,5,3,35,6,24,4,302
8830,17940,8880,47,728,240,42,502,374,9060
63660,3739,2253,53,202,17,11,71,22,1486
70809,25970,12920,215,1172,293,337,601,411,13050
56756,721,360,0,19,6,0,11,10,361
17025,17041,7992,61,572,195,122,798,250,9049
13328,1554,791,0,53,18,0,45,33,763
2539,4306,2247,75,43,45,26,128,55,2059
17578,7188,3589,30,198,68,7,243,183,3599
91040,20207,10058,78,530,330,84,602,385,10149
87519,482,264,0,0,0,0,0,0,218
98363,14083,7207,51,386,248,36,470,200,6876
98403,8146,3817,68,342,107,8,388,59,4329
98816,6120,3189,43,184,97,0,155,61,2931
97420,27764,13095,148,783,294,207,986,642,14669
77328,15928,7872,129,652,52,0,496,158,8056
51572,469,219,0,11,6,0,2,2,250
53216,34313,15610,289,969,349,156,1249,643,18703
53968,2216,1150,0,105,42,5,52,48,1066
54526,772,389,8,12,14,10,15,10,383
65050,859,447,61,29,8,3,26,3,412
66078,1362,744,0,20,21,0,20,15,618
68879,374,191,0,2,8,1,5,3,183
68936,264,154,0,12,2,0,2,2,110
60515,28566,13852,127,781,275,131,808,557,14714
60565,40773,20141,227,1286,412,180,1353,715,20632
61379,1488,772,30,66,13,16,47,30,716
61420,1121,574,0,24,20,0,13,19,547
63121,24634,10987,172,677,240,151,741,503,13647
63363,1878,1003,0,58,19,0,30,25,875
63469,1139,604,0,59,21,0,11,20,535
63845,5684,2749,0,66,59,19,150,61,2935
48436,3779,2090,36,83,9,16,107,58,1689
14874,216,120,0,5,4,0,3,0,96
5762,367,162,0,1,2,3,11,12,205
6376,213,110,0,0,0,0,0,0,103
7660,12934,6373,140,574,124,97,533,228,6561
17754,12471,5978,44,344,167,46,407,175,6493
3458,6904,3355,25,191,153,21,214,146,3549
4928,2032,982,15,16,20,10,52,65,1050
15747,2008,1066,10,43,12,28,45,11,942
15853,6331,3247,20,162,71,68,174,116,3084
16546,868,375,38,0,0,53,9,0,493
17360,6835,3309,24,176,65,9,224,132,3526
10454,38203,18469,318,1445,292,372,1489,387,19734
10526,1572,717,0,17,24,0,37,21,855
22151,18210,8945,101,883,207,264,617,254,9265
22306,35279,17949,158,1517,238,311,1765,413,17330
23967,1026,424,34,26,6,42,0,12,602
29827,4127,2607,15,250,88,23,73,23,1520
12448,464,197,0,14,8,0,17,0,267
27844,2955,1448,44,79,24,0,61,48,1507
8832,2706,1547,15,95,0,0,116,22,1159
10919,1491,843,0,39,6,52,38,28,648
47635,5529,2819,22,215,63,23,127,63,2710
47966,378,194,0,0,6,0,6,1,184
42453,584,279,7,7,5,0,12,0,305
43045,1982,998,0,38,12,22,40,5,984
44624,5308,2771,58,140,71,33,176,74,2537
50401,29033,13970,246,786,387,79,797,447,15063
49331,17579,8576,97,521,123,113,587,200,9003
46071,3382,1753,3,73,35,0,103,54,1629
46208,23081,10274,514,671,190,479,659,181,12807
40203,17801,8566,66,699,288,131,418,131,9235
3290,4860,2289,7,126,79,7,162,63,2571
4735,634,331,3,21,17,0,20,13,303
6472,6801,3332,102,217,51,48,197,31,3469
92276,7772,3962,41,104,88,24,222,125,3810
89431,38601,19890,298,1345,300,265,1132,418,18711
91401,41412,20939,366,1854,414,159,1717,582,20473
99018,179,74,0,2,1,0,4,3,105
99757,14,7,0,0,1,0,0,2,7
99771,294,145,1,2,3,1,9,0,149
76471,1940,869,0,33,24,3,39,18,1071
93301,12028,5948,45,454,23,113,313,119,6080
93720,47270,22638,371,1586,419,201,1472,642,24632
79764,21685,11366,165,860,117,121,627,301,10319
88418,213,134,0,5,0,0,0,0,79
90605,40957,20081,180,1228,363,280,1262,445,20876
90712,31063,14987,176,1353,384,156,1232,432,16076
8020,2742,1283,45,45,48,0,88,43,1459
2873,190,70,0,19,0,0,0,50,120
6447,6394,3126,0,162,82,0,161,69,3268
631,1568,752,16,70,6,10,27,28,816
1254,1014,504,0,29,21,0,29,14,510
43541,140,71,0,0,1,0,11,1,69
43721,81,27,0,0,0,0,0,0,54
26448,1618,926,30,52,14,0,61,13,692
27106,48351,22451,289,1474,485,708,1738,646,25900
48307,43694,21005,309,1571,337,174,1602,538,22689
49027,112,67,0,8,7,0,1,3,45
39461,758,398,0,0,16,0,0,0,360
16510,25735,12763,167,667,358,105,771,528,12972
18335,917,522,0,80,0,0,16,16,395
11435,59296,29447,503,2019,555,266,2342,859,29849
15327,1772,968,8,37,52,15,60,25,804
18660,3586,1863,31,141,76,17,105,40,1723
20032,42930,19488,334,1080,382,345,1606,613,23442
20630,377,186,0,0,0,0,0,9,191
2145,26868,13867,156,1310,155,48,1058,262,13001
25840,7906,3810,43,259,119,0,302,91,4096
75780,238,128,13,3,0,0,7,0,110
76133,51369,24229,258,1323,587,184,1690,531,27140
85624,1316,675,0,21,32,12,38,13,641
77502,38272,19014,254,1454,181,224,1453,256,19258
65542,6119,3514,19,285,29,34,140,78,2605
66767,517,256,0,10,5,0,2,11,261
19559,420,219,1,22,1,2,12,10,201
24845,285,126,0,0,0,0,31,0,159
8104,22441,10121,249,794,113,198,948,151,12320
11432,62053,29294,405,1891,543,539,2195,654,32759
12859,2489,1165,0,118,8,14,135,0,1324
28052,35302,17366,164,964,384,277,1004,549,17936
28644,1117,496,0,75,8,0,19,0,621
15144,4015,1846,47,124,47,32,112,88,2169
4252,4846,2457,0,159,44,87,163,34,2389
36374,691,376,13,19,33,0,0,7,315
36512,47,24,0,0,0,0,0,0,23
36522,7685,3279,33,195,77,16,119,109,4406
38126,6407,2618,64,187,0,82,219,44,3789
41548,909,477,0,76,7,0,26,12,432
42133,1456,780,21,49,18,25,33,13,676
38821,13133,6308,26,433,157,83,468,298,6825
44864,3718,1826,0,59,40,104,120,78,1892
30425,1339,650,0,35,8,0,79,30,689
27021,17539,8472,91,594,305,11,337,231,9067
28412,38213,18240,238,1254,372,111,1263,524,19973
32713,20697,10471,108,581,235,305,484,455,10226
94970,689,340,0,7,20,0,23,16,349
90031,38535,18994,323,1318,305,153,1175,365,19541
78726,13867,7017,87,337,66,255,517,106,6850
79347,7233,3752,76,493,133,0,180,131,3481
91206,34386,16227,31,1217,389,146,1327,536,18159
92661,3225,1702,15,132,67,0,27,32,1523
62554,1311,692,0,7,19,5,44,24,619
63040,8258,4070,42,208,67,80,282,78,4188
63784,194,95,5,8,2,0,2,3,99
57622,440,234,0,18,4,0,15,0,206
57773,188,100,0,3,3,0,0,1,88
68803,24780,12022,205,590,312,163,667,316,12758
60602,1244,693,1,151,5,0,55,0,551
61282,7820,3614,25,308,60,15,329,121,4206
61437,972,484,8,28,19,19,28,11,488
61750,154,104,0,8,0,0,8,0,50
54870,1537,750,8,20,23,2,28,31,787
66539,2787,1355,14,115,30,7,121,29,1432
67152,9134,4492,31,319,125,77,259,97,4642
83353,1358,827,24,8,20,0,28,39,531
83421,336,205,0,14,0,0,12,0,131
74075,24891,12974,669,595,279,793,650,188,11917
90716,14344,7173,171,455,130,32,482,154,7171
85932,378,124,0,0,9,38,12,0,254
86535,1298,604,0,55,7,7,61,15,694
88401,6481,2953,33,220,124,48,189,62,3528
99119,1088,589,0,6,44,21,36,0,499
97124,54101,27145,236,2246,439,289,1825,636,26956
97453,929,472,0,13,42,0,14,10,457
49905,1920,1016,11,46,17,18,64,9,904
50557,703,386,0,4,19,3,12,16,317
67672,2491,1256,0,49,20,15,103,49,1235
68713,2171,1018,13,61,17,3,57,52,1153
70117,27038,12741,52,937,229,86,1153,362,14297
70754,13120,6396,134,387,114,79,380,130,6724
65401,33221,17736,709,908,368,311,942,304,15485
44688,2816,1468,12,63,20,18,54,19,1348
52761,30619,15205,193,1064,188,126,868,460,15414
10153,0,0,0,0,0,0,0,0,0
68335,572,292,10,11,13,2,21,12,280
68401,698,347,0,13,7,23,19,3,351
68920,1788,956,6,23,18,0,22,15,832
70519,293,147,0,0,0,0,44,0,146
70548,10670,5254,33,195,92,23,320,121,5416
61830,337,178,0,23,0,0,4,2,159
64134,23874,11254,127,503,157,204,884,283,12620
76652,1352,767,15,40,8,0,52,36,585
59417,7653,3733,45,196,71,81,221,69,3920
59520,1130,565,0,21,14,13,26,19,565
60068,37736,18368,145,784,485,78,1235,431,19368
73122,12789,5952,125,357,155,118,306,287,6837
85248,33302,15903,109,639,498,113,788,559,17399
74422,820,385,0,12,10,3,20,6,435
29574,11446,5346,55,297,90,162,361,133,6100
78861,13965,8416,186,466,58,67,243,159,5549
71836,2839,1385,0,53,33,17,77,18,1454
98295,2733,1404,24,37,23,23,42,40,1329
99507,38424,19561,335,1393,357,209,1469,454,18863
75042,39178,20086,242,1298,300,177,1143,430,19092
75225,21296,9805,19,510,217,51,623,291,11491
75410,5726,2809,42,35,63,50,119,86,2917
75478,949,472,0,33,27,9,22,14,477
85264,1388,715,8,27,23,2,15,25,673
77437,16906,8085,88,476,239,94,539,161,8821
38631,1284,569,12,7,12,3,78,16,715
54670,1804,899,30,31,7,4,60,18,905
48085,25938,13166,195,672,257,135,825,391,12772
48640,33047,16172,297,790,506,188,875,406,16875
61872,898,393,0,9,1,0,11,2,505
62891,653,314,0,0,7,2,13,6,339
64114,24405,11754,69,856,187,67,732,302,12651
73537,578,311,0,21,2,6,23,14,267
71459,11658,7098,526,475,0,80,276,0,4560
79565,203,104,0,17,0,0,4,2,99
94569,205,122,0,0,0,0,0,25,83
44045,477,217,0,32,3,0,6,1,260
45144,4400,2220,12,33,27,20,119,15,2180
45381,5430,2787,55,237,53,33,129,83,2643
35750,12294,6115,42,492,205,122,237,84,6179
35987,2625,1165,0,73,26,9,115,67,1460
31055,8194,4740,67,758,178,13,153,153,3454
33703,25457,12314,47,853,233,131,902,449,13143
62950,204,118,0,0,8,0,32,0,86
70433,37896,18593,118,1214,412,238,828,618,19303
71108,19128,8566,306,502,111,121,622,453,10562
49689,1418,736,4,35,37,24,36,25,682
52044,126,54,0,0,0,7,0,0,72
44312,31064,15065,234,1000,380,162,799,661,15999
44661,153,84,0,3,0,0,7,0,69
47172,17806,8956,83,703,210,62,806,231,8850
47424,8842,4394,19,179,118,38,216,141,4448
49826,186,97,12,0,3,3,0,8,89
50839,45,21,0,0,8,0,1,0,24
53813,5889,2921,2,274,66,18,190,75,2968
54150,1177,614,13,60,12,11,86,13,563
35180,14092,6886,65,577,212,69,513,257,7206
37777,12067,5993,194,308,130,40,540,165,6074
56670,1471,669,18,34,19,27,16,9,802
59721,502,259,4,18,11,6,8,2,243
41745,454,175,0,0,0,0,32,0,279
42729,1464,749,0,42,37,47,18,26,715
55934,3080,1553,7,86,51,9,109,57,1527
29466,38267,18775,146,719,354,0,992,830,19492
17748,213,94,0,0,3,0,0,0,119
17960,3955,1937,19,60,35,21,152,110,2018
13490,1757,817,0,29,52,0,91,0,940
15868,1309,648,10,28,29,10,14,47,661
15923,1564,823,15,40,26,7,47,42,741
17113,10727,4746,15,406,108,42,258,106,5981
33167,19837,9441,179,767,278,124,671,376,10396
27857,1094,550,3,13,36,0,54,23,544
27970,2820,1176,0,7,50,29,41,115,1644
24073,30478,15449,171,1031,353,90,954,507,15029
24439,1208,633,0,47,3,0,5,41,575
2667,3387,1522,1,65,64,0,10,68,1865
4493,1899,966,22,53,19,18,34,14,933
7970,178,57,0,0,0,0,0,0,121
12047,20935,9472,75,503,166,192,593,353,11463
5837,337,157,0,3,5,6,5,5,180
1518,3919,1769,0,104,31,41,159,0,2150
52640,1422,689,20,27,23,7,49,25,733
53023,2476,1816,22,272,9,21,35,23,660
55315,5651,3094,57,283,65,0,239,81,2557
64835,2196,1153,0,62,21,5,70,17,1043
67068,4222,2128,15,102,21,20,84,55,2094
78593,6008,3062,42,431,11,62,174,66,2946
79087,647,351,0,14,11,0,7,4,296
56342,2661,1326,13,56,55,13,59,58,1335
56633,4490,2325,42,124,43,17,100,74,2165
57226,1900,995,17,51,31,3,32,13,905
58202,1737,985,60,0,0,42,0,0,752
70358,757,361,1,0,4,0,7,15,396
72065,5205,2556,18,79,61,42,131,40,2649
84115,26957,12662,155,1230,151,369,1225,177,14295
88053,209,153,0,10,0,0,0,0,56
97761,4290,2277,36,123,33,14,83,50,2013
98638,1296,722,0,9,7,8,23,29,574
80804,239,126,0,0,4,1,1,2,113
82335,49,29,0,0,0,0,0,0,20
89123,60138,30678,298,2232,699,404,2292,745,29460
92251,23388,13171,346,1233,132,77,635,161,10217
28716,17807,8856,62,465,135,71,564,351,8951
29576,31037,14429,75,348,744,93,537,889,16608
43758,3060,1525,25,59,37,8,61,47,1535
45220,13838,6731,253,534,63,260,211,67,7107
46103,206,98,0,4,2,0,4,1,108
46219,37006,18064,118,1145,385,229,1016,584,18942
32779,29737,14285,114,585,377,96,779,477,15452
55072,4535,2911,48,295,59,4,62,53,1624
55766,22,9,0,0,0,0,0,0,13
45315,4066,2099,0,143,83,15,83,40,1967
33186,70614,32903,715,2353,658,418,2490,1150,37711
25837,340,197,0,18,13,0,0,0,143
25981,443,223,0,11,45,0,5,20,220
29505,24850,11252,18,752,127,182,599,293,13598
33903,22122,10874,24,335,406,16,396,364,11248
33930,903,441,0,60,0,0,0,36,462
3225,3670,1735,34,128,28,18,126,82,1935
10589,8751,4047,0,144,155,0,171,83,4704
2553,97,14,0,0,0,0,0,0,83
48507,30996,14925,162,710,223,232,1146,406,16071
48603,26715,12332,104,591,313,141,829,292,14383
42160,1719,926,36,30,10,6,30,39,793
43447,3645,1695,30,84,53,11,88,56,1950
46528,27165,14127,186,1153,304,90,973,305,13038
46730,1021,489,0,9,17,0,11,9,532
36703,13502,6132,33,299,91,86,415,127,7370
50517,1094,575,11,31,5,0,26,12,519
33865,1078,466,0,0,10,0,0,16,612
35127,10185,4814,71,414,73,58,453,274,5371
35585,1215,654,26,12,6,0,32,46,561
30427,12301,6845,63,503,129,18,309,224,5456
94403,44300,21962,164,1811,404,155,1815,508,22338
97909,125,63,0,25,0,0,0,0,62
85250,17734,8188,77,390,164,167,575,195,9546
85637,1245,577,0,23,25,0,35,23,668
81033,251,138,0,6,5,0,5,0,113
50277,346,204,0,30,13,0,8,0,142
50323,14560,7163,0,679,69,6,539,84,7397
59457,9026,4503,57,359,158,13,292,139,4523
61530,7245,3551,125,201,0,93,309,37,3694
63136,45411,19862,345,1035,393,157,1347,614,25549
64192,0,0,0,0,0,0,0,0,0
47901,3702,1866,64,136,34,72,53,30,1836
48302,16019,8100,11,409,271,71,387,280,7919
49236,4672,2487,24,125,91,27,106,78,2185
22576,2193,1060,15,10,7,0,33,0,1133
16849,319,180,0,3,9,0,8,0,139
11749,3345,1594,48,143,30,19,54,29,1751
14040,2179,1020,4,70,0,6,53,19,1159
14423,4631,2235,16,132,40,38,149,63,2396
19145,46623,22138,214,1892,293,115,1463,637,24485
19520,5635,2729,24,142,89,41,139,78,2906
29031,1136,586,2,78,10,9,23,20,550
29059,5615,2859,58,263,94,19,148,67,2756
94964,3418,3246,150,322,34,0,0,12,172
15856,840,444,0,16,24,0,6,30,396
17043,5706,2939,38,354,27,29,307,66,2767
18246,247,177,28,0,5,0,0,6,70
18845,267,128,0,2,8,2,4,5,139
33154,14790,7212,34,435,46,53,657,200,7578
34292,16054,7720,22,91,351,54,243,278,8334
5680,2277,1147,4,78,43,3,96,23,1130
12421,274,147,0,0,3,0,4,3,127
1525,400,185,0,17,0,0,0,11,215
3601,390,218,0,7,11,0,21,6,172
3608,2926,1523,10,52,95,17,21,55,1403
70435,17999,8614,32,829,200,80,680,361,9385
71225,6766,3556,37,236,144,59,161,85,3210
72206,23158,11665,55,723,211,153,677,407,11493
74965,5055,2419,69,176,53,31,108,52,2636
75208,29720,15442,209,1309,347,204,1090,363,14278
92028,49380,24543,467,1358,906,446,1484,651,24837
97603,28929,13933,209,609,223,139,653,428,14996
73441,165,77,0,1,1,0,0,2,88
50163,822,345,0,7,9,17,15,19,477
99776,141,76,2,2,5,0,2,5,65
50520,85,47,0,0,0,0,7,4,38
51101,814,549,46,21,0,0,11,11,265
31549,2157,1077,11,57,48,0,17,57,1080
79367,719,351,0,38,6,19,18,1,368
79781,266,164,0,29,10,0,0,0,102
14530,5317,2676,5,107,127,30,159,54,2641
18256,352,211,9,11,6,0,5,25,141
14208,10805,4822,205,159,69,171,181,116,5983
76041,568,238,0,3,0,0,14,0,330
76266,15695,7493,90,298,136,85,390,136,8202
4953,3226,1591,12,115,48,20,87,55,1635
67751,242,135,0,6,7,0,3,0,107
68417,323,160,0,1,0,0,1,2,163
40165,35462,17602,160,1035,449,332,1034,589,17860
98664,22873,10628,137,795,239,185,683,364,12245
64507,13604,6968,60,681,73,120,439,167,6636
99116,1552,852,0,51,37,0,34,26,700
65079,3672,1775,84,82,131,0,60,64,1897
65232,274,142,0,2,2,0,1,7,132
67108,1601,854,12,23,45,6,27,21,747
69144,151,56,0,0,0,0,0,0,95
68433,208,107,0,0,7,0,9,0,101
83202,22963,11782,131,917,238,75,794,327,11181
68773,160,118,0,2,2,0,0,4,42
75089,34374,17104,111,971,151,332,1462,366,17270
76678,258,136,0,5,4,0,0,9,122
76131,40463,20356,208,2045,258,170,2123,446,20107
77357,25359,12769,178,657,450,470,593,180,12590
77060,44828,22677,395,1655,239,481,1885,437,22151
76687,1898,962,0,59,28,0,14,26,936
80503,34791,17096,213,1129,431,396,969,637,17695
47948,1488,738,13,32,15,0,58,19,750
49316,23140,11304,33,964,200,117,742,285,11836
5091,3391,1545,46,76,32,0,60,20,1846
6279,5912,3322,144,229,113,84,82,181,2590
55362,19348,9883,85,680,146,19,592,246,9465
57263,417,251,0,3,9,0,10,1,166
50127,17,9,0,0,0,0,0,0,8
48654,2068,1111,17,38,46,3,55,18,957
49240,9534,5084,101,234,130,33,239,155,4450
44844,492,262,23,19,0,0,21,0,230
45420,25145,12318,126,776,307,68,700,517,12827
56324,1170,642,6,39,10,0,36,14,528
56636,4979,2581,37,146,81,13,130,70,2398
43037,301,148,0,4,8,6,11,13,153
49922,763,440,14,40,16,0,25,8,323
50671,189,99,0,5,0,0,6,2,90
34138,268,71,0,0,0,0,0,0,197
40517,36708,16872,235,1189,269,313,1495,534,19836
4750,2228,1168,11,49,30,13,28,16,1060
7712,38443,18617,316,1217,336,246,1164,582,19826
90201,102433,51632,795,3556,564,915,3354,821,50801
83607,24647,11892,14,831,229,164,842,270,12755
85638,1871,858,9,36,43,22,69,10,1013
76901,30552,15076,170,871,250,174,1021,327,15476
94596,20822,9969,69,590,235,174,770,372,10853
92135,646,559,122,7,0,5,0,0,87
71353,1836,976,0,65,7,7,9,35,860
12985,1277,628,0,112,2,0,119,8,649
12138,3300,1716,10,125,59,10,141,86,1584
4221,928,421,8,9,25,10,22,10,507
1257,2003,1038,24,63,66,0,0,41,965
16937,208,110,2,0,2,0,0,0,98
10950,50895,26190,422,1412,236,296,1222,304,24705
21797,8672,4340,43,148,82,54,145,110,4332
2837,3505,1711,7,87,89,20,77,84,1794
13667,3118,1528,58,43,48,11,97,44,1590
14521,2357,1191,6,50,18,3,47,40,1166
21114,26759,13396,15,926,221,92,1004,267,13363
84539,268,129,0,8,0,0,10,11,139
85003,8419,4785,31,479,55,21,250,97,3634
85344,10741,5451,142,296,124,85,177,72,5290
58261,1281,694,0,20,9,0,17,18,587
58329,3362,1686,0,72,49,3,96,44,1676
18455,89,44,0,0,0,0,0,0,45
25203,61,51,0,0,0,0,0,0,10
25845,594,261,0,13,21,0,28,0,333
5441,906,455,12,38,22,0,25,13,451
11962,309,152,0,7,3,9,0,5,157
12431,1129,488,22,16,0,0,149,10,641
28079,36737,18104,308,1163,235,164,1612,317,18633
29147,0,0,0,0,0,0,0,0,0
29906,25149,12078,235,633,236,440,552,180,13071
3222,5855,3021,59,108,24,72,159,112,2834
4920,1681,923,8,56,26,4,42,37,758
35070,258,135,3,9,0,0,15,2,123
36784,7370,3401,49,154,62,8,228,65,3969
26039,901,397,16,0,17,0,33,28,504
44065,4522,2111,19,97,48,66,130,36,2411
29376,7842,3738,23,200,107,90,285,190,4104
30673,7626,3598,19,221,109,58,270,135,4028
26437,490,282,0,0,6,0,2,0,208
28108,118,67,0,0,0,0,0,0,51
33610,45963,21460,236,1777,241,513,1713,512,24503
95606,240,119,0,0,0,2,35,56,121
98155,35028,16596,216,1437,345,180,1184,600,18432
98862,2277,1079,8,85,34,0,129,35,1198
85205,42171,19952,220,806,709,164,685,740,22219
85377,3299,1752,0,0,111,0,0,49,1547
86036,400,215,3,18,15,0,12,24,185
75951,16183,7489,142,448,143,140,575,266,8694
76475,892,439,0,12,4,0,22,21,453
76491,318,134,0,4,7,0,9,1,184
77575,16640,8570,183,248,204,28,287,138,8070
86514,2936,1469,27,85,17,17,78,32,1467
89823,77,45,0,0,13,0,0,14,32
79351,1427,754,0,48,22,6,63,17,673
90710,28185,13484,125,1050,282,159,1066,329,14701
63049,17398,8527,93,552,241,44,614,209,8871
65464,1136,575,0,60,0,0,22,49,561
56222,2046,977,5,38,16,12,34,14,1069
66013,2334,1089,0,30,8,0,28,21,1245
67622,642,330,2,24,3,4,22,5,312
59855,1008,444,51,18,7,0,31,8,564
60617,82534,38160,676,2122,918,754,2430,1087,44374
61243,248,110,0,0,0,0,6,10,138
21733,911,540,21,26,34,0,21,16,371
79377,233,105,0,6,2,0,10,1,128
75098,56764,28081,179,2305,268,362,2577,472,28683
76504,23666,11439,169,820,175,187,930,203,12227
70354,4464,2182,65,102,81,53,74,68,2282
70529,12500,5853,18,651,150,45,481,171,6647
71366,1473,737,47,26,40,15,50,25,736
62643,561,304,9,22,4,11,12,10,257
62917,2275,1065,12,54,53,6,49,27,1210
63545,972,507,13,37,3,2,25,17,465
81141,1444,688,32,19,5,32,51,3,756
56266,1476,721,16,46,12,7,59,19,755
56443,1340,695,6,18,33,0,28,22,645
57368,1167,609,3,47,14,12,25,8,558
91103,28425,13842,134,1072,198,186,1087,287,14583
85123,11845,5549,15,225,166,19,419,114,6296
94704,29190,14085,1458,289,129,2492,317,102,15105
49861,526,261,8,4,13,0,12,10,265
51430,824,382,4,36,15,6,24,3,442
67446,556,246,0,8,4,4,6,16,310
70639,327,135,0,0,0,0,12,10,192
65604,3603,1749,12,142,87,12,91,36,1854
44666,2667,1400,14,29,18,21,70,0,1267
52802,10365,5350,74,403,125,13,436,121,5015
53508,5729,2871,23,152,80,39,217,75,2858
54110,5406,2655,46,198,30,78,205,56,2751
99754,62,30,0,0,0,0,0,2,32
15502,136,67,0,0,0,0,0,0,69
16932,773,388,0,24,17,0,19,6,385
6401,18787,9538,40,825,139,89,836,335,9249
70578,18089,8793,169,429,185,153,733,200,9296
59213,763,378,0,16,5,8,18,5,385
60411,57800,27613,610,1507,678,354,1818,524,30187
73531,485,257,0,8,17,0,28,5,228
73646,439,221,0,11,0,0,0,0,218
73717,7031,3946,190,265,32,102,152,104,3085
73756,349,162,0,3,0,0,15,0,187
85008,62992,32474,623,2128,258,359,1980,524,30518
85714,15693,7374,261,409,71,206,433,99,8319
80234,28254,14132,148,1021,151,248,1237,295,14122
83302,205,112,0,0,2,0,1,0,93
74960,13497,6757,121,358,144,56,301,105,6740
99321,687,471,0,0,0,0,0,0,216
90014,8335,5239,69,533,173,0,380,93,3096
97451,339,180,0,5,5,0,17,0,159
1922,3276,1467,0,84,29,47,53,50,1809
30233,23245,12644,209,939,309,190,673,213,10601
30733,2143,1059,2,39,12,1,47,33,1084
24138,2005,1052,0,69,0,0,15,52,953
24747,3050,1410,21,47,49,0,53,41,1640
24888,83,35,0,5,2,0,0,0,48
25007,774,438,0,0,30,0,58,0,336
1742,19350,9905,90,520,269,45,538,258,9445
13670,434,234,0,15,6,0,10,3,200
3234,4713,2421,25,170,109,40,116,94,2292
94109,56677,29771,133,2978,446,213,2654,574,26906
87578,245,142,0,0,0,0,26,0,103
98229,32211,15689,272,1055,445,373,1095,430,16522
93060,34181,16903,131,1176,444,219,976,258,17278
99123,998,551,0,19,26,9,0,33,447
99703,8859,5303,226,378,5,121,229,0,3556
75845,3137,1526,42,38,50,45,99,48,1611
65767,1772,950,0,36,13,0,40,23,822
68409,871,468,5,42,11,0,33,10,403
63069,15247,8083,25,569,214,68,427,220,7164
64744,8061,3835,28,148,46,18,118,47,4226
65584,11681,6124,133,412,96,172,337,70,5557
77560,610,280,0,9,0,0,32,34,330
78114,23091,11518,97,867,274,167,565,252,11573
61479,65,34,0,0,0,0,0,0,31
62049,8946,5540,86,639,86,63,163,67,3406
78363,29949,15281,253,876,150,631,846,233,14668
78564,207,102,0,0,0,0,0,0,105
79412,16590,8032,93,646,163,256,718,126,8558
35741,2984,1411,0,118,79,0,70,52,1573
48818,2516,1310,47,33,32,20,73,28,1206
49071,9921,4711,25,268,175,70,244,177,5210
43526,5890,2815,74,146,82,74,209,65,3075
19945,6630,3529,36,138,68,45,169,170,3101
22134,7534,5368,452,187,4,136,125,10,2166
23427,216,107,3,0,10,0,0,4,109
4347,2506,1168,11,76,39,0,73,46,1338
4786,1952,986,10,45,8,28,75,43,966
5734,1407,719,11,21,20,4,35,14,688
77415,85,46,0,0,0,0,0,0,39
79230,176,89,0,25,0,0,3,3,87
79364,7801,3570,0,210,216,47,213,164,4231
61376,2118,1076,8,52,5,3,48,50,1042
61531,3335,1647,44,170,27,37,69,48,1688
63130,28909,13412,520,833,238,598,1108,393,15497
68504,17411,8857,480,685,216,387,462,114,8554
69216,141,72,0,0,2,0,9,4,69
70555,7974,3959,27,311,29,0,363,73,4015
70654,181,78,0,0,0,0,0,0,103
71404,734,338,0,12,20,0,60,14,396
64660,539,279,0,22,5,0,11,9,260
72839,304,188,0,10,0,0,0,0,116
73068,12458,5911,91,196,138,38,438,162,6547
82443,4556,2329,52,222,73,10,121,69,2227
30740,8457,4439,68,239,115,23,213,92,4018
31518,927,448,0,34,6,0,42,12,479
23410,1727,836,2,76,30,0,12,35,891
24641,5551,2716,11,129,51,39,247,171,2835
24828,816,430,0,26,2,0,65,12,386
20130,212,123,0,0,5,0,0,8,89
20230,0,0,0,0,0,0,0,0,0
21140,3431,1735,0,94,19,0,156,9,1696
21251,933,564,96,0,0,75,0,0,369
22732,195,99,0,0,0,0,9,0,96
19713,30212,15037,183,1053,333,89,642,456,15175
28470,12089,5893,14,356,225,72,147,200,6196
27821,268,141,0,0,0,0,0,0,127
38261,15868,7422,25,374,218,112,432,151,8446
15724,2233,1047,0,53,35,27,29,26,1186
16328,198,66,0,4,0,0,4,4,132
16333,329,153,3,8,2,12,4,10,176
8093,9045,4333,146,293,98,78,279,130,4712
1583,7676,4772,70,541,98,9,181,99,2904
2632,10043,4951,0,214,122,14,170,175,5092
18088,8612,4504,41,267,97,29,253,134,4108
19605,19602,9930,76,649,244,80,520,197,9672
74735,1482,708,10,27,15,13,28,13,774
80920,39758,19900,386,1333,354,255,1211,471,19858
83252,4266,2059,36,128,56,20,164,35,2207
83318,17286,8612,140,448,140,98,512,150,8674
83555,526,281,2,16,10,2,8,20,245
84109,24448,12389,62,1179,235,144,902,295,12059
66508,4390,2202,37,92,40,21,154,43,2188
66714,251,133,3,14,6,2,6,4,118
67346,345,161,0,8,3,0,6,9,184
79342,450,250,0,21,8,0,19,15,200
91324,29617,15891,248,975,359,189,946,364,13726
92274,15118,8136,145,539,70,82,448,137,6982
3303,15834,7724,88,503,147,93,562,236,8110
4642,82,36,0,0,3,5,0,0,46
8095,36,0,0,0,0,0,0,0,36
60070,16049,8298,30,412,98,89,435,257,7751
52338,3693,1813,3,112,35,16,89,23,1880
52659,1397,659,0,57,13,0,65,29,738
29052,2111,778,0,182,16,0,158,72,1333
44235,1916,959,0,10,40,0,13,31,957
44446,20150,9584,186,480,233,127,448,288,10566
98516,24536,12424,49,987,555,97,711,359,12112
55967,1147,613,2,33,8,10,45,6,534
61281,2394,1244,0,62,53,4,81,32,1150
95122,57780,29193,514,2146,379,545,1822,789,28587
28521,2877,1409,39,15,42,33,13,15,1468
29596,2170,1190,14,66,31,0,25,7,980
30332,3115,1757,275,0,0,276,0,0,1358
30730,1933,873,0,38,3,0,52,32,1060
34741,45920,23513,302,1584,354,270,1525,703,22407
38380,472,238,0,3,5,0,5,9,234
44867,2557,1288,0,83,32,33,93,53,1269
45631,14630,7180,170,327,223,24,605,263,7450
46947,28125,14139,139,899,386,185,716,315,13986
41845,171,67,0,0,10,0,35,0,104
4258,2580,1297,7,87,28,5,47,30,1283
966,15710,7353,11,449,190,123,602,223,8357
23917,2917,1610,1,66,20,0,70,73,1307
25443,7913,4117,147,204,153,107,276,98,3796
17255,1049,496,3,28,16,5,43,23,553
18843,285,147,0,15,0,0,16,0,138
19142,28144,13003,169,718,175,103,852,527,15141
15038,353,126,0,16,0,0,41,0,227
7082,5192,2483,60,52,59,68,53,48,2709
8518,5414,2521,32,171,21,36,211,40,2893
93656,6323,3358,14,189,56,57,143,95,2965
94063,34503,18648,258,1856,277,173,1310,274,15855
94085,23612,12623,74,1436,130,79,985,157,10989
98502,34800,17124,360,1242,294,414,1071,544,17676
99143,739,385,12,20,14,2,4,17,354
20191,30069,14433,93,1101,208,57,1131,360,15636
80302,29109,15168,1802,623,165,1379,514,322,13941
73746,29,16,0,3,0,0,4,0,13
77623,439,208,12,0,9,0,7,8,231
83806,245,124,0,11,1,0,11,4,121
58790,1770,826,3,75,5,0,46,31,944
60021,5548,2677,34,143,29,52,106,28,2871
60480,5370,2540,0,106,164,0,125,77,2830
54636,14808,7232,43,663,160,100,606,125,7576
55450,9,0,0,0,0,0,0,0,9
56153,219,112,4,0,0,2,0,4,107
40012,512,239,0,7,7,14,9,7,273
35119,259,39,0,0,0,0,0,0,220
43076,8421,4017,35,250,131,94,256,146,4404
44278,17951,8520,89,571,257,75,340,284,9431
47337,177,98,4,4,0,0,5,0,79
62877,575,295,0,13,1,5,6,5,280
80512,1708,847,0,26,29,0,20,17,861
75412,567,243,0,25,0,8,12,8,324
66076,2599,1324,15,30,18,0,74,11,1275
67628,124,64,0,3,0,0,3,3,60
68450,3167,2060,92,216,18,8,66,15,1107
16855,182,53,0,14,0,0,0,0,129
17228,1135,609,9,37,21,5,28,4,526
18850,2409,1225,30,47,32,21,27,45,1184
14514,6821,3194,0,232,57,16,246,73,3627
14544,2026,948,26,69,33,0,55,36,1078
15219,16501,8291,328,398,80,474,281,188,8210
15445,2692,1237,47,94,32,11,80,56,1455
15776,51,32,0,0,7,0,0,3,19
30412,69,33,0,5,0,2,4,0,36
34210,17023,8052,81,369,173,63,146,281,8971
38006,5001,2425,7,81,38,19,189,96,2576
39061,0,0,0,0,0,0,0,0,0
55102,18346,8781,108,707,249,181,749,205,9565
55793,629,303,0,11,18,6,7,9,326
48617,8670,4083,42,283,122,65,316,134,4587
48622,6263,2865,40,112,113,16,136,110,3398
50165,109,67,0,0,0,0,13,1,42
50531,227,111,0,2,0,1,28,2,116
52169,332,183,0,8,2,0,9,2,149
13675,227,99,0,0,0,24,0,0,128
22976,789,356,8,11,28,9,8,16,433
3906,4712,2375,8,57,48,11,25,69,2337
4255,625,320,0,7,21,0,12,9,305
5843,2484,1216,0,85,67,0,58,28,1268
8015,19585,9684,309,602,194,142,507,347,9901
25275,2204,1241,0,16,12,0,69,99,963
28443,22138,10857,75,630,219,108,874,391,11281
29364,578,243,3,12,0,0,29,12,335
27964,653,309,0,0,13,0,67,14,344
28301,17600,8221,149,428,180,302,354,367,9379
19014,21101,9927,257,597,200,56,777,278,11174
75158,3859,1907,24,76,36,19,136,69,1952
75423,2801,1391,0,86,59,5,82,48,1410
76635,1216,608,2,103,5,0,29,28,608
76671,1722,844,0,9,26,13,25,24,878
78113,3029,1531,0,74,7,7,101,16,1498
80475,30,30,0,0,0,0,0,0,0
83812,58,33,0,0,0,0,0,2,25
13637,4057,2168,85,154,13,60,127,3,1889
14081,3130,1553,7,47,45,15,50,39,1577
14532,4389,2260,19,106,44,18,33,42,2129
17339,6935,3372,88,177,123,81,191,129,3563
6333,7125,3596,66,162,107,12,154,92,3529
20670,1552,890,39,67,0,10,55,0,662
75935,14025,6782,107,540,193,57,358,206,7243
76092,30908,15256,52,557,242,91,916,378,15652
80447,1937,894,0,58,12,0,62,2,1043
84076,449,226,12,19,6,0,29,0,223
84536,1869,923,16,49,30,13,87,15,946
98288,181,91,0,1,0,0,13,9,90
92014,13863,7014,0,380,146,49,460,337,6849
79314,62,31,0,0,0,0,0,0,31
24120,1367,680,0,22,35,0,19,35,687
1088,416,183,0,19,0,11,13,0,233
27260,25761,11926,60,618,232,117,863,425,13835
43357,3921,1859,26,157,34,23,80,89,2062
64671,1873,985,2,25,42,15,65,35,888
65440,432,196,0,0,0,31,0,0,236
66205,13433,6412,40,618,155,24,482,129,7021
67028,391,176,2,13,1,0,27,14,215
67578,1340,626,10,32,18,0,35,21,714
69340,135,79,0,0,0,0,0,3,56
58636,1090,538,0,34,20,0,41,7,552
59756,477,391,0,54,1,0,1,0,86
62431,1054,586,0,43,14,7,20,2,468
37705,3961,1954,16,117,72,41,160,21,2007
98233,15415,7472,124,487,133,58,548,124,7943
99155,1120,548,9,32,3,11,8,5,572
67104,2349,1173,13,41,17,16,57,29,1176
67450,624,317,0,16,8,4,12,8,307
68016,450,230,0,12,15,0,19,6,220
68663,723,378,11,30,12,6,45,20,345
71823,39,26,2,1,0,2,0,0,13
77464,173,82,0,13,2,0,7,8,91
77469,48824,24236,128,2001,511,196,1498,667,24588
90746,26996,12989,292,821,123,169,676,256,14007
92620,48952,22924,185,1420,418,223,2306,466,26028
92653,29986,14740,278,1042,413,121,1291,477,15246
82514,1724,821,13,35,14,23,55,3,903
74338,5353,2533,16,124,79,11,133,74,2820
84094,29015,14044,181,1055,192,115,1084,516,14971
66441,26238,13837,337,1034,166,181,807,318,12401
43148,2350,1193,26,98,33,0,92,23,1157
36524,1255,543,2,6,1,12,42,14,712
36583,843,416,5,13,19,0,38,0,427
37073,14318,7050,11,532,85,56,525,150,7268
61049,560,277,12,5,4,3,15,5,283
61426,109,48,0,11,0,0,11,0,61
61857,195,106,6,2,0,2,4,8,89
62977,744,355,3,28,2,0,48,11,389
56081,5835,2924,75,142,30,15,199,100,2911
52225,261,146,0,3,14,0,5,10,115
54759,1422,691,12,40,42,11,41,27,731
49435,4138,1992,62,72,48,6,60,40,2146
44511,19966,9334,63,489,288,128,627,311,10632
44659,136,67,0,7,0,0,4,0,69
44883,28183,13861,448,948,343,248,735,463,14322
3251,1229,658,30,19,10,29,12,33,571
4088,1363,641,5,35,6,6,56,40,722
5050,158,84,0,7,0,0,0,0,74
16727,186,111,0,0,6,0,0,4,75
23310,4549,2149,44,46,89,9,138,144,2400
25086,714,345,0,6,32,3,14,9,369
25428,13093,6645,53,659,66,62,445,165,6448
25625,1341,938,0,86,57,0,0,7,403
21930,180,63,0,0,0,0,0,0,117
26416,8177,4063,176,235,108,58,371,179,4114
28804,22189,10991,114,809,444,272,573,309,11198
76708,27467,13413,252,799,166,127,1004,298,14054
78222,25574,12707,77,736,210,153,881,164,12867
79236,210,111,0,5,2,0,0,4,99
54425,2025,1042,10,65,18,14,76,15,983
54742,4860,2409,12,148,15,59,139,55,2451
64831,6212,3207,87,221,49,0,188,93,3005
67447,297,157,0,9,0,2,5,9,140
71762,2189,924,0,64,26,0,74,29,1265
64110,17176,8479,410,595,112,416,767,178,8697
30516,2012,1073,2,116,11,2,72,21,939
45745,1618,780,6,119,45,2,97,35,838
50106,952,473,12,11,2,0,32,29,479
41041,7045,3556,30,186,76,24,165,84,3489
35474,6454,3004,62,300,59,25,112,98,3450
35574,1692,881,12,28,32,0,50,3,811
88002,1170,602,36,11,17,0,21,20,568
97886,1180,583,27,36,16,12,18,37,597
98038,35568,17633,152,1473,260,116,1580,471,17935
92805,74413,36951,508,2860,389,551,2530,413,37462
96757,580,281,0,19,14,0,18,5,299
2822,6581,3313,127,143,94,108,115,44,3268
30030,29490,12878,73,1085,102,257,1532,323,16612
48454,1168,614,9,48,23,12,35,27,554
24226,1165,497,0,23,33,11,37,15,668
24501,27543,12774,410,677,249,343,747,280,14769
22438,348,189,0,13,54,0,17,0,159
30171,3467,1899,46,117,17,13,70,58,1568
30179,19109,9709,264,844,136,126,748,189,9400
30315,35511,17261,197,1707,240,143,1150,383,18250
32082,30898,14678,83,546,455,101,766,721,16220
34216,874,395,0,0,19,0,0,39,479
34235,14671,6945,12,200,195,35,266,277,7726
34606,26274,12780,130,610,380,55,594,274,13494
18011,5593,2726,17,222,74,46,121,101,2867
20675,2161,1146,0,35,15,0,64,65,1015
27803,18791,8713,89,522,185,38,739,602,10078
40170,520,283,6,11,0,0,30,17,237
51105,9820,4727,73,358,77,16,372,91,5093
52222,508,246,0,6,10,5,7,0,262
52720,950,492,0,34,22,2,29,1,458
56263,519,294,6,9,14,0,12,3,225
56501,17313,8381,106,478,226,168,583,225,8932
57028,3504,1762,0,108,54,0,108,50,1742
60113,339,165,0,7,0,8,7,8,174
60466,21989,10285,39,685,123,143,851,318,11704
43963,1385,654,10,35,18,5,61,17,731
44442,3938,1987,51,153,30,22,135,73,1951
44690,213,104,0,0,31,0,10,10,109
46030,2813,1361,0,26,24,69,61,123,1452
46554,4963,2499,21,118,134,27,183,65,2464
47541,1173,626,3,52,23,24,34,17,547
65784,16,7,0,7,0,0,6,0,9
62631,273,162,0,3,2,5,4,10,111
63941,172,71,0,0,0,0,0,0,101
64166,285,147,0,21,26,0,0,14,138
64873,900,435,0,7,2,6,15,12,465
48428,5066,2581,39,74,76,30,165,148,2485
54983,4485,2369,21,184,50,7,113,79,2116
55122,32253,15619,100,1295,366,138,1288,494,16634
75417,2628,1188,24,64,37,0,149,35,1440
98154,0,0,0,0,0,0,0,0,0
98845,293,140,8,3,6,0,1,9,153
99154,27,14,0,0,0,0,0,0,13
1350,91,49,0,0,0,0,7,0,42
38225,5547,2623,13,182,63,21,171,48,2924
97873,261,120,1,9,0,3,2,8,141
98283,403,178,0,2,46,0,0,19,225
79539,169,92,8,3,9,0,7,0,77
93554,64,28,0,0,0,0,0,0,36
66606,10951,5311,31,223,106,132,359,252,5640
67150,58,30,0,0,0,0,0,0,28
68147,11202,5479,75,284,61,191,444,118,5723
69026,217,100,0,2,2,0,5,0,117
69337,7059,3648,106,235,86,97,138,75,3411
60120,50922,25201,318,2203,386,483,1608,533,25721
61018,1002,470,2,16,19,0,47,9,532
61544,590,302,0,24,14,0,24,3,288
50664,104,46,0,10,0,0,0,0,58
54749,1259,655,9,27,26,10,16,8,604
72533,406,198,0,0,2,11,2,0,208
72936,14868,7368,86,524,62,135,666,180,7500
72948,262,173,17,0,8,0,20,0,89
73444,118,36,0,0,0,0,0,0,82
71646,6121,3236,4,193,209,33,212,84,2885
98557,3363,1666,0,139,57,9,113,30,1697
76311,8784,6879,639,132,10,102,90,0,1905
56283,6291,3186,35,156,142,3,141,101,3105
56544,5531,2861,34,145,53,20,166,54,2670
72522,522,318,0,7,0,19,8,0,204
74455,3093,1582,14,69,36,39,45,78,1511
75043,61440,29332,468,1792,842,279,1849,691,32108
51552,279,124,3,1,2,0,4,2,155
77368,166,74,0,0,0,0,0,0,92
75088,26234,12622,212,678,162,117,940,353,13612
77962,3704,1779,28,149,15,12,138,31,1925
51577,1084,552,12,18,58,0,38,7,532
52041,1839,934,3,22,18,10,51,21,905
52584,622,290,29,4,2,3,4,18,332
63933,3423,1771,15,90,103,10,92,21,1652
66402,2904,1441,3,127,34,5,46,43,1463
66778,0,0,0,0,0,0,0,0,0
81331,320,175,0,23,16,0,0,8,145
85530,1824,951,0,31,0,0,37,17,873
79237,403,192,15,1,20,3,18,17,211
96783,1645,776,0,46,64,14,41,43,869
96816,49664,24248,391,1532,735,250,1379,827,25416
87943,146,88,0,0,0,0,0,0,58
88007,23350,11615,327,624,321,293,609,390,11735
91766,72332,36297,639,2589,381,636,2952,944,36035
76519,401,212,0,0,13,0,0,0,189
29575,18727,8934,154,514,273,53,383,332,9793
30507,30076,15094,183,965,225,147,957,197,14982
30755,8813,4259,18,292,34,31,266,95,4554
30808,4499,2228,51,123,30,4,171,67,2271
41095,3652,1912,32,115,10,19,71,44,1740
42159,1624,771,2,4,42,0,53,20,853
43026,62169,31033,231,2280,498,240,2344,876,31136
97333,22994,12147,611,719,254,482,653,317,10847
97465,2003,977,9,46,62,0,28,31,1026
87036,1618,867,0,88,44,10,18,43,751
98277,38632,19096,261,1307,425,505,1428,329,19536
98524,4659,2350,67,42,35,0,130,97,2309
1904,17142,8194,98,637,93,112,581,171,8948
57433,231,116,0,6,0,0,5,6,115
41543,185,72,0,0,0,0,0,13,113
44127,4375,2151,3,157,32,34,155,57,2224
45247,22544,11224,74,598,324,115,408,324,11320
35051,9000,4468,50,533,53,34,237,77,4532
50459,3014,1547,20,99,24,16,85,24,1467
30623,130,72,0,0,0,0,4,1,58
38620,3118,1460,0,39,48,1,93,83,1658
47023,1691,820,1,33,14,8,19,1,871
79778,1071,531,0,46,4,13,35,11,540
61855,104,58,0,0,0,0,0,0,46
63559,1476,736,5,56,18,9,13,29,740
63880,145,84,0,13,0,0,0,9,61
71438,2085,1112,0,84,24,0,99,0,973
68831,769,404,10,17,5,2,15,2,365
87831,275,211,0,0,10,0,0,0,64
99733,74,46,0,2,0,0,3,1,28
19050,28340,12887,183,555,210,98,874,404,15453
14614,1232,1123,21,127,0,0,9,0,109
15076,834,419,0,0,0,0,31,0,415
10024,59001,26607,74,2121,426,51,2539,966,32394
12042,196,114,14,0,0,0,0,0,82
12149,2388,1193,3,96,19,10,56,28,1195
44614,12628,6130,94,371,198,44,462,305,6498
40060,1060,519,3,25,26,19,23,13,541
40380,7291,3597,22,374,32,23,269,166,3694
67154,1512,817,3,28,3,3,33,11,695
63382,4935,1585,20,46,35,26,311,75,3350
58430,109,63,0,3,5,5,0,4,46
61378,333,176,0,5,12,1,4,12,157
62075,3662,1682,0,89,37,13,135,83,1980
47714,34250,16558,266,1045,374,244,957,580,17692
72027,1404,742,0,22,27,0,46,38,662
73673,236,88,0,2,0,0,5,4,148
45206,10825,5204,35,371,151,45,306,237,5621
56534,1246,594,11,37,21,2,55,24,652
51639,686,349,0,10,19,10,11,18,337
53079,1421,694,2,37,31,13,50,19,727
38106,24029,11507,149,525,403,143,705,406,12522
30268,10434,4780,42,242,138,51,527,95,5654
32234,5780,2964,118,214,122,5,109,49,2816
32693,12186,6499,265,277,140,49,254,137,5687
33585,1394,573,0,45,16,0,25,33,821
45303,2724,1443,22,162,28,9,96,23,1281
47331,22508,11073,169,721,248,72,610,306,11435
42154,444,195,8,18,0,4,0,0,249
15412,465,219,0,25,7,0,4,2,246
4496,3898,1866,0,118,52,41,116,67,2032
23233,31089,15264,150,873,303,97,1105,385,15825
21742,33180,16181,70,920,307,205,1176,447,16999
13134,208,101,0,3,0,0,0,0,107
2019,17016,8749,163,536,113,9,434,216,8267
2703,44548,21785,311,1630,482,133,1498,714,22763
59081,20,11,0,1,4,0,0,1,9
33955,11406,6264,70,364,190,74,173,267,5142
41256,3253,1464,0,67,58,0,70,18,1789
46068,2811,1373,20,51,48,12,111,49,1438
47920,2498,1295,26,80,37,0,113,51,1203
48034,13819,6202,101,278,107,69,191,378,7617
48885,833,447,6,58,20,0,4,19,386
49013,5596,2839,15,142,51,69,151,136,2757
49817,659,327,0,13,6,8,12,13,332
12870,1576,798,6,26,18,5,84,4,778
38549,3761,1806,2,64,102,57,102,51,1955
53168,8313,4331,29,236,65,34,236,171,3982
31419,58252,27815,541,1915,403,481,2350,604,30437
31543,4292,2137,0,178,41,42,110,67,2155
32102,2195,1066,37,58,54,0,61,69,1129
12206,15944,7256,165,380,86,140,585,105,8688
13407,5155,2468,90,136,50,48,145,59,2687
28501,18334,8622,85,544,235,114,620,351,9712
29133,919,478,0,52,0,4,42,1,441
29307,18121,8344,78,299,269,60,445,244,9777
87517,346,165,0,0,0,0,0,0,181
83443,1107,533,16,28,13,10,6,24,574
85920,434,227,0,19,9,0,1,19,207
99166,3058,1615,0,105,132,0,55,90,1443
99580,80,37,2,2,0,2,0,0,43
96708,10243,5200,0,444,293,99,470,102,5043
715,2972,1459,36,58,12,53,70,33,1513
777,39994,19017,457,1237,300,441,1479,398,20977
27355,2475,1245,4,86,68,3,25,2,1230
35671,2185,1174,27,53,24,41,164,64,1011
35748,7257,3511,9,198,84,65,187,116,3746
36256,1638,894,4,31,21,0,62,10,744
37183,3121,1585,14,51,9,2,89,53,1536
21842,10669,5566,74,286,172,45,219,217,5103
22731,30,23,0,0,0,0,0,0,7
23415,1489,696,13,13,63,0,51,0,793
21158,20929,10268,99,493,269,147,617,328,10661
78935,1396,653,0,7,43,18,17,68,743
79111,2333,1240,15,83,3,31,68,29,1093
80757,211,103,0,8,5,1,3,3,108
71021,668,300,0,7,0,13,11,3,368
72003,698,361,3,17,20,0,15,21,337
72389,200,97,0,9,13,0,0,8,103
94404,36905,18351,57,1483,434,100,1359,492,18554
87041,772,358,6,24,2,16,31,13,414
93605,188,73,0,11,0,0,14,0,115
75114,6392,3144,19,248,103,0,274,46,3248
76044,3810,2083,4,167,17,21,188,32,1727
77585,998,419,16,14,46,0,18,78,579
39203,6360,3207,112,188,80,179,64,87,3153
39347,1686,804,33,0,59,0,78,22,882
61943,1660,770,3,31,19,0,68,32,890
57428,695,321,7,12,2,0,14,12,374
47404,23466,11965,838,690,328,918,777,276,11501
48324,18086,9119,58,506,170,65,562,258,8967
56588,502,264,0,19,9,0,9,15,238
50673,171,88,0,0,1,0,6,2,83
54845,119,61,0,8,4,0,11,0,58
55085,498,248,0,3,10,0,10,4,250
56123,468,233,0,6,13,0,17,8,235
41048,15560,7287,53,582,121,146,654,228,8273
44837,4408,2360,40,187,81,6,130,40,2048
45306,2370,1267,12,69,33,8,77,37,1103
38574,8377,4165,11,135,86,47,262,95,4212
39701,13264,6276,58,571,104,170,225,237,6988
35442,6237,2404,0,124,102,10,375,175,3833
36250,4958,2169,0,208,47,0,133,90,2789
46773,3351,1661,4,106,52,44,72,49,1690
47970,1830,928,0,49,3,36,16,33,902
37031,4198,2234,0,169,34,13,112,96,1964
37692,4989,2666,19,159,63,13,102,59,2323
18443,447,205,0,13,0,0,6,0,242
18614,2233,1150,9,63,41,5,42,44,1083
57035,1154,621,8,49,41,10,47,0,533
57329,313,155,0,1,16,3,9,5,158
58444,199,110,5,9,0,1,4,1,89
63138,18582,8712,101,327,172,183,636,184,9870
73127,25134,12637,303,758,254,259,823,300,12497
78669,12106,5543,26,549,239,42,421,252,6563
5472,1675,907,22,56,29,0,31,31,768
98223,42880,21247,141,1300,719,234,1309,660,21633
91210,689,421,0,99,0,0,39,0,268
91371,0,0,0,0,0,0,0,0,0
94526,32539,15955,178,704,425,122,703,651,16584
38456,5403,2670,30,106,29,50,134,56,2733
39328,5239,2892,78,235,90,31,108,84,2347
45146,1458,748,5,38,8,5,116,10,710
30250,656,596,16,141,0,0,16,0,60
2833,1144,516,0,0,0,0,33,0,628
63390,10946,5410,28,509,188,118,478,144,5536
64449,528,322,6,18,1,5,12,8,206
1375,3659,1921,24,122,42,101,68,37,1738
71254,6505,4003,150,265,82,16,111,64,2502
53714,16291,7861,85,569,174,144,635,287,8430
78945,10463,5362,17,156,190,35,273,139,5101
47122,10910,5315,97,249,138,72,401,154,5595
83348,372,158,0,0,0,0,0,0,214
38060,9463,4483,30,232,161,59,356,202,4980
56374,10622,4621,61,380,72,312,248,149,6001
67764,480,249,9,23,15,1,24,1,231
38901,18722,8815,337,715,165,157,571,253,9907
42721,3570,1708,18,164,37,37,108,24,1862
95315,14019,7106,48,420,132,58,665,150,6913
37333,517,272,0,4,0,0,20,7,245
44082,2464,1250,0,51,0,70,36,0,1214
44304,5028,2583,215,77,22,179,106,9,2445
14843,12911,6647,93,294,150,85,345,148,6264
16102,5967,3073,18,186,95,17,149,61,2894
46920,1085,543,11,20,17,0,19,27,542
16861,297,146,3,8,3,0,6,0,151
32244,60712,29252,488,2047,413,566,2262,929,31460
61822,25829,12329,54,865,264,94,1133,460,13500
24312,1708,903,17,0,24,0,64,32,805
58757,897,474,0,24,10,3,2,2,423
24846,55,23,0,0,0,0,0,12,32
49345,14488,7412,81,600,241,47,466,232,7076
51246,3385,1622,47,144,30,14,175,39,1763
4975,0,0,0,0,0,0,0,0,0
12019,14429,7041,62,423,248,58,459,160,7388
5664,175,66,0,28,0,0,27,0,109
6351,15975,8184,73,393,281,86,388,209,7791
53551,8700,4383,0,320,97,4,202,139,4317
54733,1252,624,3,29,13,5,39,14,628
55350,17872,9031,110,555,235,180,543,223,8841
30511,4009,2042,38,187,38,66,99,17,1967
60556,2029,928,8,95,28,5,95,14,1101
30624,3256,1699,25,72,38,24,86,32,1557
74959,7150,3663,68,299,69,92,176,131,3487
23405,858,434,23,0,4,0,0,42,424
79511,1165,555,3,23,17,0,25,7,610
19533,8148,4436,74,348,68,46,254,64,3712
72426,188,93,0,0,0,5,4,4,95
28547,25420,21000,3129,177,9,213,283,0,4420
83815,34141,16840,109,903,376,107,878,387,17301
83428,394,200,0,2,3,0,5,15,194
85352,510,296,0,0,0,0,0,0,214
93543,15135,7365,81,449,64,106,520,212,7770
76955,180,91,0,20,25,0,0,0,89
38570,9403,4593,113,225,101,64,212,214,4810
89442,1125,540,4,31,6,7,14,9,585
44123,16515,7594,121,422,203,43,554,345,8921
80020,49657,24849,241,1797,356,246,1857,631,24808
32128,19806,9394,149,479,426,60,713,305,10412
71250,162,71,0,0,0,0,0,0,91
34683,33162,15538,95,783,393,198,907,587,17624
35031,8060,3856,84,129,116,50,235,89,4204
45132,398,206,0,17,2,0,12,0,192
44444,9563,4765,186,197,152,27,194,196,4798
50643,2862,1529,0,71,62,12,73,51,1333
15411,639,310,2,11,6,0,11,11,329
15463,33,17,0,0,0,0,0,0,16
40023,5178,2614,42,195,42,0,155,140,2564
15673,1328,629,3,32,18,3,53,14,699
33054,32035,14892,401,721,172,219,657,415,17143
11430,198,188,0,25,0,0,0,0,10
33461,46344,22459,411,1900,265,257,1719,375,23885
13207,13135,6250,110,350,164,85,403,215,6885
29365,11211,5664,0,433,111,51,391,71,5547
30143,21487,10673,58,548,382,141,387,380,10814
26571,2379,1177,0,69,6,0,133,35,1202
18602,252,131,0,2,1,1,3,5,121
33412,14918,7814,42,263,223,48,347,282,7104
28211,30789,14180,34,980,277,120,1233,431,16609
60961,725,375,3,33,10,0,60,3,350
8825,4327,2129,22,52,104,38,83,74,2198
62089,501,296,5,9,4,0,0,9,205
62465,964,492,30,7,9,0,30,12,472
42461,1113,588,13,44,6,2,27,33,525
68929,200,115,0,9,7,0,7,7,85
70537,437,253,0,0,0,0,0,12,184
46011,17467,8261,65,605,281,97,652,259,9206
66220,7169,3596,0,173,159,15,238,39,3573
33993,24856,12678,45,618,285,98,642,229,12178
68017,1694,868,8,17,44,11,42,47,826
56577,4,2,0,0,0,0,0,0,2
36321,1744,882,20,48,18,23,53,15,862
88011,31196,14092,303,914,497,430,454,243,17104
64116,15576,7584,139,418,204,202,441,179,7992
88121,95,44,0,6,0,0,0,0,51
75551,10679,5142,27,173,63,50,221,187,5537
84732,33,18,0,0,4,0,0,3,15
97630,5123,2799,18,148,64,35,96,30,2324
89011,25826,12558,128,990,256,170,899,245,13268
98802,30878,15249,164,1168,399,133,1004,338,15629
95066,15217,7581,179,513,222,102,403,135,7636
83244,328,182,0,0,6,0,6,0,146
98651,861,477,0,30,5,0,31,20,384
97148,3735,1889,22,100,71,3,139,130,1846
1057,8745,4274,44,179,179,19,150,158,4471
96035,3731,1963,16,131,33,0,157,94,1768
53520,6432,3230,22,174,96,51,156,116,3202
1830,26695,13204,120,954,162,57,1076,328,13491
54564,408,227,1,10,20,0,5,17,181
63105,18333,9164,218,393,194,185,519,157,9169
42236,635,363,0,17,30,5,12,32,272
54005,2944,1607,11,109,53,4,106,44,1337
20684,1362,696,0,54,0,21,23,14,666
21869,1100,555,1,22,26,9,9,8,545
71801,16956,7798,124,393,146,59,645,202,9158
23168,7257,3398,0,229,60,0,351,54,3859
15226,13884,6722,63,491,95,61,455,223,7162
27379,5601,2569,9,155,53,28,169,64,3032
12094,2550,1376,15,243,0,0,202,18,1174
43050,28508,13840,123,608,371,308,770,598,14668
24719,25,13,0,0,13,0,0,0,12
24421,3931,2041,13,26,122,0,46,58,1890
24737,182,68,0,11,0,0,22,0,114
28651,7419,3570,0,226,238,66,154,110,3849
51531,656,313,0,9,14,0,12,14,343
29205,24756,12287,594,708,228,276,602,194,12469
71029,156,84,0,1,4,0,6,0,72
29717,1400,715,2,58,39,36,34,33,685
15634,235,96,10,0,0,8,12,0,139
48242,0,0,0,0,0,0,0,0,0
16853,180,108,0,3,0,0,0,11,72
5641,16382,7967,126,495,249,241,672,221,8415
32607,30624,14104,991,565,136,1561,469,291,16520
59041,1773,964,15,45,97,0,47,30,809
27042,610,274,0,20,0,0,0,31,336
32080,21943,11071,156,430,447,69,302,279,10872
5492,707,376,7,33,13,0,29,18,331
6442,2624,1349,0,17,14,48,24,69,1275
8810,9049,4537,19,203,44,19,432,70,4512
11709,6708,3404,45,171,109,93,181,175,3304
12929,3916,3541,88,483,21,0,36,0,375
13435,287,141,0,9,1,0,8,2,146
1107,11582,5786,78,308,98,111,318,85,5796
2482,11039,5132,48,127,135,126,161,118,5907
74081,1823,982,33,53,17,0,15,25,841
48509,8823,4174,18,248,85,69,248,124,4649
78245,76177,36927,403,2626,310,589,3309,975,39250
80424,10120,4986,66,317,104,50,580,236,5134
80820,751,376,0,6,41,0,34,27,375
93562,1723,888,8,45,34,0,73,14,835
87520,1237,633,0,11,16,0,23,33,604
89121,64340,31386,367,1368,728,412,2206,876,32954
74558,410,197,3,7,12,0,4,3,213
68341,1066,580,2,19,2,2,49,14,486
38623,245,153,0,6,5,0,0,0,92
84034,150,62,2,5,0,0,5,4,88
85335,35004,17388,173,1174,178,287,1296,290,17616
60152,12345,6113,157,346,193,14,360,275,6232
60928,775,345,0,11,7,4,34,11,430
56274,137,68,6,1,8,0,4,4,69
79033,76,24,0,0,0,0,0,0,52
73546,1036,517,0,15,18,0,31,5,519
70706,23001,10757,12,963,158,122,834,465,12244
71342,7333,3380,28,146,118,95,277,88,3953
23488,321,147,0,6,0,0,0,0,174
13633,332,215,0,15,6,10,7,10,117
31006,4476,2178,62,95,66,28,215,135,2298
21781,159,96,0,0,0,14,0,0,63
8070,12392,5921,59,269,203,51,353,112,6471
10458,83960,40415,856,2121,534,1108,2528,1021,43545
28392,1628,820,5,42,6,0,15,0,808
18059,1119,581,0,10,0,0,18,11,538
29625,28813,13499,53,828,416,221,740,407,15314
52166,107,49,0,0,6,0,11,0,58
52769,705,335,0,42,3,8,37,40,370
55926,833,417,0,19,12,12,12,11,416
37215,22414,9929,151,414,225,97,644,386,12485
11701,28149,13455,162,671,287,83,787,325,14694
12147,529,281,0,15,13,5,4,10,248
15781,98,60,0,10,2,0,8,0,38
16845,950,556,27,18,10,1,29,9,394
17543,44216,21471,277,1201,530,193,1210,793,22745
17841,4827,2424,21,140,58,42,118,70,2403
1906,28165,13698,126,629,362,74,755,526,14467
2584,12,0,0,0,0,0,0,0,12
3260,736,370,0,35,10,0,25,5,366
4096,8501,3971,11,200,123,24,167,139,4530
77350,192,70,0,5,2,0,5,2,122
66085,7825,3878,0,212,75,12,215,158,3947
72945,226,111,0,3,5,0,2,2,115
41605,727,409,0,53,23,0,0,40,318
42215,1254,598,28,25,20,0,27,0,656
44493,29,15,0,0,0,0,0,14,14
63110,18208,8440,59,942,195,170,695,394,9768
71261,1130,505,10,4,2,9,37,39,625
55127,18487,8943,25,531,487,79,523,319,9544
45015,11714,5650,174,329,83,143,283,151,6064
46220,36731,17513,47,1535,307,56,1353,441,19218
46320,13703,6375,9,331,119,128,546,264,7328
50103,462,239,0,3,1,10,7,2,223
50835,88,41,0,0,7,0,0,0,47
51025,2018,1038,18,42,52,5,70,21,980
52557,64,64,2,18,0,0,0,0,0
81325,192,107,0,0,10,0,0,0,85
81650,13356,7047,39,695,261,108,492,218,6309
77008,34184,17428,78,1772,365,29,1522,368,16756
80205,34381,17619,62,1923,231,246,1734,505,16762
91201,23619,10765,55,662,234,228,874,290,12854
77318,15380,7645,73,500,196,34,361,246,7735
98852,15,3,0,2,0,0,2,0,12
93612,35450,17650,345,865,283,494,1117,304,17800
94539,52802,25468,216,1466,625,220,2176,629,27334
95258,3881,1956,19,94,75,14,53,89,1925
95410,1159,577,9,7,0,9,26,25,582
95928,37558,18834,856,1123,413,1291,1090,479,18724
65053,1687,857,0,44,32,18,22,10,830
66521,1651,804,0,49,23,0,76,8,847
69028,800,420,5,22,4,1,25,6,380
7856,5028,2425,0,58,31,0,12,98,2603
8720,770,316,0,0,6,7,28,0,454
11234,95666,45456,565,2702,1088,347,3185,1408,50210
11412,37458,17167,222,913,297,336,1197,621,20291
38964,168,55,0,14,0,0,0,0,113
14120,44437,22362,307,1279,604,193,1096,885,22075
62934,902,420,37,19,20,0,50,13,482
70510,25897,12599,75,703,277,252,864,255,13298
70817,35142,17636,355,1140,226,151,1101,628,17506
71409,5396,2903,11,122,115,65,73,59,2493
72040,2894,1388,10,29,76,24,44,53,1506
50529,798,409,0,42,4,6,25,16,389
57271,286,129,0,7,1,0,6,0,157
48178,34308,16595,203,1001,285,225,1001,472,17713
4030,2654,1172,53,131,1,1,189,11,1482
4781,568,308,8,8,2,3,13,17,260
15083,710,326,3,10,10,2,18,5,384
15530,5179,2636,24,117,108,27,125,126,2543
15770,238,119,0,0,4,0,9,0,119
12037,4444,2150,6,133,62,46,91,45,2294
13495,2197,1210,12,84,11,11,103,20,987
735,12404,5870,145,284,161,62,370,198,6534
2030,5987,3113,95,77,60,22,125,63,2874
2635,3131,1521,38,164,37,3,99,138,1610
17557,14298,6728,78,287,117,258,264,208,7570
19078,11240,5576,62,161,96,34,361,236,5664
81638,153,104,0,0,12,0,9,5,49
92082,18065,9005,189,663,269,79,481,320,9060
97499,1800,897,13,30,17,0,9,18,903
99686,3870,2077,2,121,130,0,67,193,1793
94523,35096,16881,171,1180,472,287,1193,645,18215
95412,402,221,20,16,29,0,19,3,181
77086,29178,14078,214,1057,221,251,908,346,15100
78562,4163,2459,50,180,16,51,121,26,1704
79245,2400,1198,9,77,5,0,89,22,1202
66783,2246,1085,7,73,18,4,62,31,1161
67458,231,113,4,5,3,0,17,0,118
67492,250,128,30,10,8,0,7,12,122
67623,172,84,1,0,13,0,5,2,88
68970,1434,673,1,32,17,23,26,28,761
60661,9926,5109,15,756,16,61,555,49,4817
62374,345,196,5,0,8,0,2,3,149
62864,23586,11247,154,568,321,183,722,425,12339
63388,644,310,0,0,9,0,0,10,334
63452,1289,695,17,29,29,4,41,8,594
14747,2201,1147,4,46,33,11,51,28,1054
6612,7558,3817,48,130,53,0,146,131,3741
7045,10655,5200,44,158,60,32,297,157,5455
19149,59633,28992,679,2153,699,439,2065,704,30641
19301,6438,3023,11,206,77,0,163,104,3415
3084,1307,687,9,24,3,5,15,15,620
17233,5242,2623,19,77,40,12,149,58,2619
8079,10103,4769,23,338,151,85,346,150,5334
28714,17044,8286,85,438,265,25,466,268,8758
12834,6286,3157,64,181,81,8,171,91,3129
8620,12052,6373,184,208,127,0,326,274,5679
46946,24,8,0,0,0,0,0,0,16
48211,6318,3303,95,308,46,6,194,132,3015
41810,321,157,0,22,0,0,0,0,164
42322,11,0,0,0,0,0,0,0,11
78526,46799,22429,485,812,142,446,1277,442,24370
87105,59129,28512,497,1674,571,440,1615,838,30617
90017,26728,14436,174,1360,154,284,885,277,12292
61552,146,60,0,0,0,0,0,0,86
62065,179,57,0,0,0,13,0,0,122
17402,37476,18503,282,1148,442,117,1072,609,18973
22546,16242,7435,36,590,229,49,565,109,8807
23693,24882,12417,102,880,270,99,957,323,12465
24017,24132,11159,290,633,219,218,746,487,12973
6235,2309,1295,13,67,26,5,56,63,1014
6269,10124,4989,631,0,0,947,0,0,5135
12583,2465,1309,40,32,31,109,36,19,1156
1854,29561,14789,675,742,220,388,719,470,14772
2540,8389,3896,0,152,112,0,136,208,4493
38922,3292,1736,0,86,39,14,79,34,1556
44310,26659,13079,222,929,358,257,837,261,13580
44621,4476,2305,53,150,84,10,234,111,2171
45458,32068,15410,132,1041,470,127,1209,418,16658
47436,1410,742,0,54,28,17,30,21,668
36251,4895,2276,61,77,7,22,74,35,2619
36723,219,50,0,0,0,0,0,0,169
27051,7678,3805,28,211,145,49,243,78,3873
42753,679,373,18,15,4,0,21,8,306
48002,3234,1644,38,72,18,8,70,46,1590
95943,908,562,0,30,8,0,12,8,346
99036,1718,854,9,47,0,0,38,37,864
83623,1451,749,6,23,27,18,42,43,702
84713,3521,1788,0,100,75,42,135,65,1733
84770,41454,19897,481,1331,536,453,1218,693,21557
85648,19771,9303,213,627,115,190,696,321,10468
76228,999,499,4,22,19,0,31,24,500
76599,2084,0,0,0,0,15,321,44,2084
66736,3730,1821,47,109,54,14,118,127,1909
57528,851,410,2,21,11,10,16,3,441
58102,29911,16506,981,768,364,589,830,252,13405
51446,561,217,2,19,17,0,27,18,344
52215,795,453,0,15,0,0,13,4,342
53083,20234,9980,90,647,228,68,528,286,10254
65452,3070,1508,0,139,56,5,102,37,1562
46057,1251,603,3,74,28,2,16,29,648
49084,41,16,0,0,0,0,0,0,25
61078,1253,613,7,23,4,4,28,45,640
29073,46555,22003,184,1541,426,545,2042,562,24552
44265,0,0,0,0,0,0,0,0,0
40177,1466,764,3,67,9,3,72,15,702
72564,400,197,3,9,15,0,0,4,203
73090,1078,615,0,53,17,5,67,7,463
73179,5299,2519,12,221,60,33,197,53,2780
74949,297,160,0,2,8,0,11,0,137
75848,122,41,0,9,2,0,4,0,81
82055,257,151,0,0,0,0,0,7,106
82638,0,0,0,0,0,0,0,0,0
95701,806,386,0,21,20,14,18,12,420
97388,818,391,0,0,50,0,0,0,427
17582,2273,1163,0,49,0,30,49,17,1110
18459,8,2,0,0,0,0,0,0,6
5674,1613,802,0,61,16,0,79,22,811
6754,1778,919,3,23,24,0,30,23,859
6890,4312,2170,49,96,37,0,98,48,2142
7208,31442,15990,273,1006,269,241,1108,245,15452
7670,14687,7200,92,149,149,144,266,275,7487
7865,2024,955,10,76,0,10,71,54,1069
11694,21354,10932,54,616,347,50,584,324,10422
12156,1151,692,16,37,0,0,42,0,459
21128,14425,6876,78,391,192,41,527,224,7549
21631,2694,1259,4,15,47,0,65,19,1435
14884,240,102,0,5,6,0,16,3,138
4787,620,328,5,6,0,0,11,16,292
75569,3350,1734,48,129,45,77,24,41,1616
77026,22380,11050,198,761,207,207,532,275,11330
83846,848,405,8,42,8,6,31,22,443
95429,124,83,0,0,0,0,9,15,41
87529,4637,2233,11,35,39,0,103,126,2404
93722,83179,41434,753,3082,513,541,2989,823,41745
19606,34804,17031,71,859,385,168,1178,550,17773
79566,376,220,0,0,24,0,0,14,156
5362,55,23,0,0,4,0,0,0,32
1474,1823,907,0,48,46,31,41,0,916
2538,3652,1874,0,149,0,0,79,125,1778
22810,811,398,0,9,0,0,8,0,413
98204,42882,21627,160,1873,245,367,1338,528,21255
23921,1627,844,86,119,84,0,21,13,783
91006,33012,15871,266,968,354,125,1003,413,17141
97070,24339,11308,267,805,145,58,868,271,13031
87510,738,373,0,103,0,0,22,0,365
97110,1133,436,4,41,7,16,74,39,697
94111,3620,1847,1,144,65,15,157,41,1773
92258,778,478,0,18,58,0,12,0,300
92363,5407,2583,12,98,97,44,137,101,2824
40111,1329,645,3,31,35,3,26,46,684
36618,17451,8126,228,422,200,197,763,307,9325
2474,28333,13379,67,1049,372,72,1263,400,14954
62613,3886,1903,5,191,35,9,189,59,1983
62897,362,201,4,23,5,0,11,12,161
4236,4362,2268,28,100,47,24,118,99,2094
61832,34918,16578,204,892,386,345,1042,469,18340
64130,19996,9181,59,505,193,100,601,159,10815
44699,811,419,0,0,27,0,0,15,392
78750,30847,15261,50,1335,381,172,1325,440,15586
45168,1667,833,22,29,64,19,34,2,834
81653,16,16,0,0,0,0,0,0,0
49690,6891,3320,32,118,98,60,164,118,3571
67730,1662,847,18,60,19,0,46,11,815
59038,652,321,0,7,14,11,16,26,331
49303,1009,527,0,30,5,6,23,26,482
77535,34291,16295,152,784,343,138,1589,516,17996
43017,40649,20222,155,1610,383,121,1800,491,20427
29726,1553,750,28,32,30,1,41,10,803
44234,4177,2081,64,83,48,70,134,37,2096
13325,1067,531,8,8,11,13,9,17,536
44710,9557,4421,0,203,147,41,296,183,5136
15301,48950,23469,329,1180,564,197,1379,884,25481
46745,2120,1041,0,26,10,5,9,32,1079
16825,230,129,0,0,0,0,0,0,101
27814,1989,896,0,13,24,19,35,101,1093
58042,1317,676,2,82,8,0,48,23,641
58559,214,106,0,15,6,0,14,5,108
3858,4886,2495,54,206,71,0,164,45,2391
5678,263,96,0,0,0,0,17,0,167
4454,26,13,0,0,3,0,0,0,13
16373,3368,1730,30,74,45,23,60,45,1638
54766,1789,912,25,32,23,24,30,42,877
60156,28886,14163,319,1186,224,167,1069,321,14723
65689,5523,2820,26,232,72,0,156,104,2703
78064,16043,7864,192,630,200,68,311,150,8179
79107,34844,17110,388,1155,174,189,1266,382,17734
56553,200,115,0,4,1,0,4,6,85
12209,9383,4416,246,263,134,29,456,99,4967
72802,21761,10773,63,674,310,107,482,273,10988
27510,15528,7500,218,673,237,165,510,163,8028
84633,1331,690,0,66,3,27,53,2,641
91706,77342,39036,528,2831,741,636,2265,858,38306
64497,480,264,0,5,5,0,16,4,216
29667,263,132,0,0,3,3,6,5,131
74766,1556,734,3,39,18,13,41,29,822
29819,1593,688,6,70,13,11,0,6,905
37043,47576,23042,225,1646,412,195,1316,575,24534
87120,62226,30456,482,2396,648,352,2149,1243,31770
78550,52216,26242,205,1352,451,156,1657,433,25974
45416,6139,2409,58,189,51,48,173,87,3730
33965,1659,747,61,0,0,78,0,0,912
34786,43458,21446,281,1523,364,57,1826,355,22012
41731,1048,504,17,3,13,29,6,5,544
47876,354,0,0,0,0,39,0,8,354
14203,1666,687,0,37,34,0,58,51,979
34224,15913,7642,147,194,340,191,228,384,8271
34602,7314,3782,7,186,283,0,214,263,3532
15771,884,422,14,11,23,19,18,17,462
14738,3247,1574,5,5,11,0,61,120,1673
30471,5085,2614,9,163,73,8,86,78,2471
17219,384,228,0,5,6,0,5,4,156
33316,9801,5456,28,330,148,59,147,166,4345
27052,9906,4343,79,261,79,49,357,165,5563
21056,146,63,0,0,0,0,0,0,83
37327,11711,5701,25,344,195,68,340,191,6010
28538,1961,1053,94,68,27,1,53,91,908
25414,18034,8698,92,613,127,68,622,183,9336
29042,5076,2632,55,124,61,54,74,51,2444
41001,17398,8606,108,545,287,106,561,306,8792
18062,25998,12596,142,664,278,102,899,305,13402
47116,603,389,0,36,45,0,28,0,214
27974,1206,533,0,102,6,10,78,6,673
19953,4528,2273,32,138,127,91,108,35,2255
59487,1298,688,0,45,10,10,37,24,610
61323,91,35,0,0,1,0,0,4,56
11510,33484,15911,251,882,307,90,938,654,17573
41250,1259,615,10,11,24,1,25,7,644
68405,3467,1772,52,91,29,14,124,39,1695
45390,3288,1692,3,163,25,28,72,38,1596
78210,36723,17801,223,1268,231,193,1118,497,18922
38478,17654,8735,51,420,135,84,516,272,8919
67066,308,152,0,1,9,0,12,1,156
36303,31005,14858,249,810,389,146,986,389,16147
40208,17037,8361,576,243,172,579,367,135,8676
63655,1543,792,3,36,16,9,40,23,751
88026,1491,744,0,89,19,0,127,4,747
82327,955,410,18,41,0,13,57,7,545
83619,7748,3723,22,206,191,13,227,190,4025
94702,17092,8256,78,617,117,29,616,167,8836
85048,35252,17434,363,1127,326,141,1291,555,17818
98620,7267,3837,29,320,162,29,242,183,3430
94115,35004,17741,65,1843,263,50,1595,288,17263
99205,43285,21004,231,1627,422,361,1457,656,22281
95546,3768,1722,12,152,45,30,94,75,2046
56646,518,290,0,20,21,4,20,8,228
6237,5447,2873,73,119,132,27,105,149,2574
43147,41000,20114,184,1184,311,171,1664,620,20886
52750,527,276,2,13,9,5,10,6,251
53827,245,120,0,4,9,3,5,3,125
62376,1204,610,0,34,27,0,19,0,594
41049,2393,1153,0,37,23,0,63,55,1240
30345,25562,12877,27,1138,156,96,919,167,12685
41557,1594,832,0,30,12,0,47,10,762
54524,565,275,2,4,13,0,4,0,290
20851,15106,7622,39,616,132,38,475,150,7484
49446,2482,1290,9,116,26,27,44,43,1192
23102,3345,1717,15,155,137,0,6,12,1628
47325,560,224,34,23,0,29,21,10,336
15532,112,55,0,0,2,0,0,0,57
13606,2716,1411,4,58,43,0,119,4,1305
24217,284,73,0,0,0,0,0,0,211
26150,6004,2878,51,243,20,0,271,70,3126
29062,131,86,0,0,0,0,0,14,45
71435,3555,1984,26,113,16,16,172,42,1571
15446,287,100,0,0,0,0,0,0,187
71923,15351,7102,232,351,113,446,420,194,8249
16407,11004,5207,28,286,101,66,403,167,5797
18436,12655,6120,0,200,165,67,222,179,6535
14865,2981,1421,26,77,35,21,63,24,1560
59444,223,124,0,2,7,0,8,6,99
60532,28178,13905,315,1001,249,150,847,367,14273
85326,60999,33180,456,2929,347,487,2066,356,27819
6902,68646,34687,340,2753,671,323,2671,841,33959
8021,44245,20732,441,1355,346,226,1631,622,23513
8106,9593,4530,69,221,131,20,263,79,5063
8751,4379,1978,123,206,47,57,179,81,2401
11973,43,29,0,0,0,0,0,0,14
3832,323,146,0,11,9,0,11,10,177
24374,720,329,0,22,0,0,37,0,391
25534,280,158,0,13,0,0,26,10,122
26031,1662,881,5,64,26,27,23,22,781
26271,386,184,0,2,4,0,18,13,202
43210,12530,6320,397,14,0,292,49,0,6210
44445,3604,1708,0,56,26,21,96,62,1896
44628,932,487,8,16,30,4,17,31,445
38554,988,574,17,37,24,0,38,25,414
38627,1199,521,18,7,10,9,8,0,678
40140,595,324,0,14,5,0,11,0,271
47528,462,235,2,37,4,0,0,6,227
47633,2575,1358,0,95,32,11,79,45,1217
30817,7642,3576,42,167,122,12,290,161,4066
30912,127,83,0,0,14,4,0,0,44
27949,7532,3650,0,213,177,0,180,170,3882
95695,40857,19628,160,1610,427,249,1204,505,21229
97127,4105,2009,0,232,0,30,288,0,2096
98632,51045,25016,394,1467,793,253,1754,802,26029
76111,22320,11725,182,700,193,259,654,197,10595
76481,255,127,0,54,0,0,23,0,128
95463,152,56,0,0,0,0,0,0,96
87052,3118,1575,6,84,32,46,56,23,1543
87106,25119,13067,516,811,208,392,882,265,12052
92359,9056,4453,16,417,91,98,440,92,4603
93033,83782,43576,660,3245,704,675,3129,737,40206
99773,288,148,0,7,0,1,9,0,140
62815,287,138,0,7,7,0,11,2,149
64052,20297,10033,103,872,280,165,552,357,10264
57787,429,239,0,16,5,0,7,0,190
58016,119,53,0,7,4,0,8,0,66
58478,110,56,0,6,0,0,5,2,54
69045,1145,579,0,60,9,0,56,6,566
69217,465,232,0,3,6,27,4,9,233
54621,1416,712,1,48,10,1,26,24,704
54669,7912,3900,60,216,126,6,227,102,4012
55404,27195,14213,115,1001,213,343,879,214,12982
67735,5232,2616,51,281,14,70,244,48,2616
68964,53,28,0,5,0,0,0,0,25
70760,6487,3027,51,111,87,103,204,194,3460
71233,260,121,0,11,0,0,9,0,139
62541,37,14,0,0,0,0,0,0,23
80805,383,204,0,4,5,3,10,5,179
72088,2677,1233,0,22,40,0,53,46,1444
72370,7744,3636,63,170,67,31,393,94,4108
72471,1131,460,16,36,11,0,14,4,671
72687,6460,3008,7,148,154,8,167,139,3452
57756,698,288,0,15,0,0,18,11,410
84330,348,180,2,21,0,0,15,2,168
93920,1403,766,0,69,0,4,42,4,637
67673,141,68,0,2,1,0,9,2,73
64858,121,61,0,0,0,0,0,0,60
65459,6854,3418,6,262,107,8,212,86,3436
66510,759,353,0,10,10,10,16,12,406
44307,6751,3052,34,146,86,18,212,46,3699
53821,8235,4361,55,285,124,50,205,117,3874
58769,190,136,10,6,3,0,0,2,54
59419,104,61,0,0,1,0,3,0,43
99682,483,315,2,38,0,0,24,8,168
99702,3006,1827,64,133,0,13,167,0,1179
15829,1260,673,2,83,6,6,83,33,587
15832,232,137,0,0,7,0,6,9,95
16833,5322,2621,34,120,82,14,120,92,2701
17985,1205,592,7,26,7,14,19,25,613
10552,19569,8329,85,419,194,90,715,241,11240
12819,323,188,0,0,10,4,10,3,135
5906,1256,645,3,24,29,0,32,16,611
7644,24498,11968,147,925,89,268,942,253,12530
67473,1710,869,0,64,5,36,13,10,841
68345,235,148,0,3,0,0,18,3,87
68402,1387,715,0,55,29,2,75,6,672
70524,144,81,2,0,0,0,0,1,63
71447,1313,670,6,39,8,4,62,16,643
61821,30582,15186,270,1484,274,393,1091,388,15396
61930,745,362,22,32,12,0,13,17,383
40740,3220,1673,27,80,0,10,135,9,1547
41615,808,361,0,88,0,43,0,0,447
41858,7170,3273,0,206,29,27,138,94,3897
45868,650,338,3,11,31,0,38,22,312
36860,1889,830,5,54,0,30,32,26,1059
38002,40245,19985,239,1241,511,207,1842,278,20260
52565,1570,739,0,29,31,9,20,22,831
53711,49660,24132,399,1636,578,202,1450,671,25528
73092,973,447,5,30,4,4,16,24,526
73530,445,267,0,7,5,5,1,6,178
78642,11817,5528,45,333,88,111,415,88,6289
74521,191,96,0,6,2,2,5,3,95
76021,35741,16578,166,1123,354,144,1241,689,19163
65286,138,54,0,0,0,0,0,0,84
65336,5572,3040,116,221,39,62,219,103,2532
66605,19721,9152,149,654,102,108,831,239,10569
68620,2715,1291,19,47,36,10,51,71,1424
69366,263,130,4,13,4,6,8,0,133
19316,209,130,0,23,0,0,22,0,79
14604,2243,1286,82,52,0,42,8,18,957
15223,6521,3356,44,254,128,7,176,96,3165
15949,546,282,5,18,0,0,0,5,264
26807,2593,1302,12,38,97,5,26,76,1291
33478,13015,6777,48,255,230,40,398,274,6238
35160,26312,13055,111,541,431,196,574,422,13257
35216,37546,17807,143,1416,298,115,1723,400,19739
36578,1186,600,13,28,16,0,43,4,586
36765,1239,609,9,26,4,0,31,2,630
38924,680,346,9,7,6,0,5,7,334
43804,3786,1851,15,141,2,60,117,20,1935
47619,1684,805,7,32,35,5,29,51,879
48093,24886,11429,51,558,276,171,649,360,13457
49931,9642,6043,628,153,58,141,149,30,3599
51653,1562,783,0,55,6,0,46,33,779
52768,1629,884,26,37,18,20,25,23,745
4009,5306,2366,1,267,141,18,312,112,2940
4056,345,201,0,27,12,10,13,18,144
7023,7602,3535,0,210,78,28,213,158,4067
10025,92805,41890,469,2365,1248,683,3000,1133,50915
25632,289,131,0,0,0,0,0,0,158
25911,94,62,0,0,0,11,0,0,32
26346,961,458,0,13,14,0,15,35,503
18435,924,477,16,19,29,0,21,12,447
76679,1376,605,15,38,15,0,50,20,771
77664,2667,1300,0,33,15,26,23,0,1367
81649,370,155,0,17,0,0,13,1,215
14728,1033,527,0,0,22,0,9,15,506
15905,19859,9424,127,472,263,148,614,465,10435
17047,2781,1405,23,84,30,6,84,58,1376
6264,88,46,0,0,6,5,0,3,42
20009,52117,26887,52,2999,204,32,2735,271,25230
21032,8276,4149,30,278,63,62,253,142,4127
77381,36507,17378,158,853,546,55,995,538,19129
80497,497,217,0,0,39,0,0,0,280
95369,990,522,0,43,12,9,19,2,468
95469,2015,951,0,41,33,0,26,15,1064
88126,53,18,0,0,0,0,0,0,35
99348,1361,704,12,26,4,6,45,32,657
99752,3370,1811,39,116,21,30,87,24,1559
78140,3936,2003,34,181,38,55,187,16,1933
48060,39537,19494,325,1398,411,260,1352,509,20043
49343,6020,2997,20,240,49,18,185,101,3023
24137,2674,1389,13,20,37,24,35,102,1285
25942,193,140,0,0,13,0,0,0,53
12124,675,349,0,0,0,0,47,22,326
26705,699,393,9,32,19,0,27,0,306
26847,6496,3234,30,119,69,69,160,57,3262
28040,7738,4013,38,163,72,9,249,121,3725
58330,308,140,0,15,7,0,4,3,168
58448,275,167,4,8,7,0,8,8,108
59485,624,343,3,5,19,0,2,13,281
59715,35317,18529,769,1076,337,563,999,355,16788
62032,732,324,12,29,2,0,21,3,408
97721,207,116,0,7,11,0,4,0,91
98946,521,263,0,8,10,0,0,14,258
67554,4013,1986,34,66,57,0,87,39,2027
68113,848,474,41,13,0,18,16,4,374
78065,10735,5801,164,323,119,54,224,182,4934
78656,2157,1066,0,71,25,86,9,17,1091
91741,26565,12861,119,687,291,156,905,433,13704
93450,806,405,0,18,10,0,24,0,401
93514,14412,7295,32,436,134,50,274,249,7117
80226,32640,16039,180,929,318,364,944,536,16601
84660,41519,21363,256,1820,142,288,1509,248,20156
65436,46,26,0,0,0,0,0,0,20
90291,27525,14223,69,1429,493,78,1363,264,13302
72084,1335,719,11,57,2,0,65,10,616
72129,1111,584,0,13,7,0,63,32,527
72467,278,278,7,0,0,0,0,0,0
43077,369,199,3,15,3,0,28,4,170
37840,10324,5159,103,421,97,30,407,136,5165
58488,206,109,0,9,7,0,0,2,97
59722,5737,3713,30,331,67,0,70,58,2024
60471,14055,6720,311,194,85,72,345,249,7335
61239,1239,605,0,31,3,28,61,8,634
56141,325,174,0,14,3,0,14,3,151
57656,849,427,3,25,8,8,13,20,422
54520,4256,2169,26,105,27,5,100,59,2087
54838,1172,642,2,39,34,0,13,26,530
49680,2000,1040,23,41,31,11,77,28,960
51002,2876,1355,17,73,32,31,96,14,1521
51347,1525,789,2,19,43,0,51,18,736
44212,44380,21638,150,1578,424,284,1632,484,22742
6387,481,183,9,18,0,14,49,25,298
7863,3830,1907,41,57,14,23,64,31,1923
26568,636,308,0,0,10,0,0,0,328
19538,22,15,0,0,0,0,0,0,7
28787,21314,10518,123,558,391,12,684,261,10796
76484,921,415,4,15,18,0,0,22,506
76624,1925,1053,0,35,25,16,68,5,872
79379,594,298,0,22,4,0,3,8,296
53911,1293,670,0,61,8,0,44,12,623
54614,2820,1433,20,76,23,15,71,21,1387
59326,222,117,0,4,0,0,5,3,105
59427,4724,2323,66,174,79,0,94,62,2401
64730,6551,3226,22,207,48,53,204,88,3325
65327,226,119,1,8,3,3,0,3,107
70116,11384,6318,49,589,160,54,370,155,5066
62851,162,90,0,15,0,0,16,0,72
63014,882,454,0,10,4,5,50,20,428
63463,719,376,3,11,14,9,8,22,343
74555,735,377,16,14,6,3,20,11,358
75021,8950,4337,23,232,113,34,260,173,4613
33319,47021,21228,252,1366,380,314,1606,527,25793
46989,4824,2189,158,81,47,145,53,46,2635
99772,597,323,5,26,5,2,24,6,274
2338,7824,3743,93,244,33,84,134,217,4081
75494,9489,5060,50,326,203,36,252,94,4429
22922,2058,1087,7,67,56,0,69,45,971
56028,1267,640,4,37,18,0,32,19,627
66103,13570,6934,74,567,137,65,540,68,6636
68380,108,59,0,0,1,1,3,0,49
8011,20,11,0,0,0,0,0,0,9
62869,2690,1356,5,70,30,24,79,37,1334
64040,6496,3219,74,177,89,20,111,77,3277
78359,2065,1092,23,93,0,17,126,19,973
58545,3573,1825,19,112,45,1,69,87,1748
60455,16479,7780,155,477,131,137,683,135,8699
85345,56790,28361,418,1245,495,290,1660,843,28429
80228,34109,16676,128,1233,305,120,1350,542,17433
81641,3752,1896,27,115,73,11,118,79,1856
66219,12212,5848,42,491,225,31,478,185,6364
94603,34593,16828,319,1340,103,226,1386,240,17765
95039,1195,586,0,78,28,0,60,30,609
95223,2860,1564,16,76,66,14,81,62,1296
98621,417,202,0,3,5,0,0,0,215
97113,14838,7580,73,457,97,71,433,176,7258
3448,738,396,5,16,5,0,10,30,342
4022,1257,695,29,12,15,0,12,31,562
739,36847,17664,177,1102,333,253,1209,342,19183
1510,13899,6995,282,524,64,89,473,265,6904
30346,4965,2821,0,296,15,0,119,31,2144
31007,1132,629,5,44,27,0,33,11,503
32320,3832,1979,0,65,50,12,76,97,1853
14478,1526,650,58,23,6,84,0,22,876
15106,19343,9186,60,676,192,36,570,323,10157
25434,2696,1422,0,137,33,5,50,16,1274
17957,352,197,0,11,7,19,5,0,155
731,12722,6259,43,317,161,86,363,157,6463
97836,1842,961,0,79,22,10,72,26,881
98834,171,92,0,21,3,0,4,3,79
74471,1635,897,46,42,6,4,50,16,738
64862,3262,1612,9,113,34,7,79,14,1650
76086,23383,11021,62,959,195,151,831,360,12362
60610,39019,17874,242,1393,325,170,1389,384,21145
78248,14369,6490,191,452,194,105,426,319,7879
79072,26893,13999,331,635,226,264,764,221,12894
81007,31860,15455,152,1102,378,171,1310,390,16405
62510,1538,787,16,59,27,5,45,19,751
36104,8342,4405,74,233,111,77,184,94,3937
48310,43456,21535,368,1287,552,223,1329,725,21921
49076,4740,2449,52,139,56,47,134,53,2291
26651,9205,4413,31,260,126,16,168,181,4792
28351,4698,2175,0,75,64,0,183,73,2523
43501,870,490,0,40,16,19,41,0,380
43614,31607,14483,100,733,285,190,1062,649,17124
19954,1301,597,4,60,52,3,55,28,704
20754,6910,3525,88,238,80,0,175,110,3385
20901,36154,17815,212,1614,431,193,1428,585,18339
23141,6651,3189,22,165,35,45,279,124,3462
3873,6194,3031,69,67,30,0,172,63,3163
15425,18995,9209,135,468,278,135,524,286,9786
76453,1275,611,6,6,15,0,20,41,664
76693,1629,766,0,34,16,0,24,0,863
60181,28801,14226,203,936,337,290,872,380,14575
61882,694,376,0,26,12,0,26,10,318
62450,12230,5915,55,410,98,33,430,151,6315
63459,3940,1995,0,143,75,25,97,86,1945
68517,629,292,0,0,0,0,15,0,337
68882,393,194,0,13,0,0,10,7,199
70113,7699,4102,65,265,107,81,260,70,3597
64725,2594,1436,10,60,14,18,95,48,1158
68144,23877,11613,94,882,262,143,911,373,12264
75764,166,79,0,4,0,4,4,8,87
15137,9901,4811,49,450,241,19,192,117,5090
33301,15062,8265,58,785,302,0,412,314,6797
23422,153,98,0,0,0,12,0,0,55
21841,1373,594,0,18,20,0,45,21,779
29801,28308,13347,230,540,343,271,673,524,14961
26619,399,214,0,20,10,0,0,9,185
52591,2930,1534,12,96,30,21,88,53,1396
53954,6625,3386,13,219,83,20,188,116,3239
38016,47757,21106,326,1737,303,135,1758,557,26651
38070,221,129,0,0,0,0,0,0,92
10128,59256,25338,129,2087,700,314,2262,785,33918
24530,1315,674,1,45,18,0,71,38,641
25932,363,183,0,0,0,0,0,0,180
75233,16092,7765,36,543,140,135,403,138,8327
85305,12760,6454,178,609,55,65,399,148,6306
66761,218,125,19,0,5,6,0,3,93
66955,79,44,0,3,0,0,1,6,35
67110,8891,4294,15,193,191,25,284,73,4597
68632,4029,1982,3,122,54,0,63,32,2047
69356,1902,893,7,20,17,19,53,46,1009
72546,243,116,0,0,0,0,9,0,127
74352,6756,3382,26,173,79,6,205,126,3374
92691,50782,25179,416,1817,414,207,1235,822,25603
2871,17140,8570,85,469,204,34,587,152,8570
4472,2115,1096,16,68,52,17,84,32,1019
4612,468,223,0,6,22,0,0,11,245
694,69,41,0,0,0,0,0,0,28
66050,2039,1031,4,40,19,43,53,44,1008
66066,2572,1354,54,78,19,0,89,71,1218
53801,850,456,3,21,15,0,15,14,394
37766,17907,8352,42,386,240,12,534,278,9555
38237,16003,7886,358,248,135,404,312,146,8117
28570,21590,10573,153,578,208,162,624,338,11017
13502,32542,16274,353,913,469,307,785,335,16268
14218,18951,9189,159,551,200,114,514,254,9762
15424,2074,977,0,48,45,8,71,35,1097
19716,1159,426,20,0,0,44,0,0,733
20720,23502,10763,297,562,266,87,906,287,12739
20747,39946,18032,445,1048,395,313,1594,561,21914
60504,38013,18669,164,1404,203,89,1497,295,19344
48340,26068,12760,97,612,152,190,971,170,13308
45160,865,431,9,45,3,11,30,18,434
45889,1634,768,0,23,16,6,52,33,866
49783,19299,10086,160,691,304,352,528,226,9213
43219,30526,14387,183,868,203,270,900,283,16139
54656,17524,8629,112,469,184,66,453,251,8895
87750,0,0,0,0,0,0,0,0,0
88136,27,20,0,0,7,0,0,0,7
90039,29589,14500,280,1511,206,92,1256,473,15089
97739,12096,6113,61,260,482,103,233,290,5983
99216,26107,12624,79,733,166,102,921,327,13483
95441,2053,1183,13,55,37,15,69,27,870
95601,144,73,0,19,5,0,5,5,71
2882,13951,6564,620,186,224,808,284,182,7387
1080,2802,1342,21,97,0,16,145,28,1460
24132,445,232,0,0,0,0,0,11,213
36720,1012,297,13,9,3,16,38,0,715
21229,47644,22220,239,1196,460,387,1857,813,25424
23885,2773,1275,0,57,12,0,47,24,1498
23915,1253,805,14,123,20,0,19,7,448
24167,285,141,0,17,0,0,0,0,144
43451,1251,670,11,47,33,0,21,8,581
39309,371,307,30,4,0,21,0,0,64
50432,246,130,2,2,4,0,0,8,116
50532,892,458,5,29,6,8,21,6,434
52146,896,508,7,12,27,2,5,24,388
54246,832,404,0,21,13,1,24,11,428
56516,273,136,0,12,6,0,2,3,137
59102,46952,21941,262,1758,419,442,1158,590,25011
59867,71,41,0,0,0,0,0,0,30
44280,4641,2367,19,63,126,65,114,123,2274
45202,14105,7652,60,560,112,47,534,213,6453
46182,1433,771,0,21,15,0,44,17,662
64655,196,102,0,0,0,11,0,8,94
48130,15924,7842,42,438,234,56,686,201,8082
55449,27946,13833,121,1084,256,60,1375,346,14113
61235,1519,702,0,50,18,15,32,15,817
62326,2337,1188,21,101,49,25,101,26,1149
74523,6022,2814,24,102,51,50,146,105,3208
74824,1445,758,0,41,8,8,29,29,687
97864,237,123,0,6,4,0,3,7,114
98205,14360,6988,92,523,126,114,554,79,7372
51537,6775,3301,36,213,56,98,175,105,3474
53969,406,191,2,3,2,0,5,10,215
71107,33642,16592,134,1151,342,161,1037,484,17050
71235,4796,2152,42,137,36,52,124,68,2644
72070,1968,897,4,99,28,23,53,35,1071
61244,23679,12179,142,889,261,109,706,303,11500
62422,1002,560,0,30,13,0,19,38,442
83654,1471,771,2,39,21,0,46,28,700
85204,69278,34447,566,2513,457,588,2271,827,34831
85355,12385,5689,32,331,169,57,668,124,6696
85741,35219,17264,292,1116,352,376,1314,520,17955
79104,6988,3567,3,161,54,32,287,15,3421
88055,39,18,0,0,0,0,0,7,21
29037,614,269,0,0,5,0,18,73,345
30576,2310,1158,0,39,33,19,81,34,1152
35049,3366,1687,38,91,50,5,127,41,1679
35578,5806,2775,23,207,42,1,103,119,3031
44702,948,556,0,19,19,0,8,12,392
46237,38455,18646,254,1416,373,186,1265,577,19809
46240,19706,9147,141,610,223,128,519,278,10559
46788,3618,1879,9,107,0,0,62,8,1739
42370,0,0,0,0,0,0,0,0,0
15331,637,278,6,22,26,0,25,21,359
682,32359,15634,354,832,313,344,883,297,16725
30428,2783,1611,0,89,39,8,3,97,1172
98055,24231,11912,63,1184,123,126,1118,341,12319
56158,437,231,6,10,7,3,7,9,206
58415,229,103,0,8,2,0,7,0,126
60433,16629,8507,140,556,116,46,530,211,8122
92061,2376,1311,6,43,4,4,36,20,1065
67860,2806,1389,5,38,18,40,77,28,1417
59452,515,260,0,5,18,2,8,21,255
61421,1300,667,10,38,11,2,23,13,633
49910,316,180,0,2,25,0,3,8,136
50428,9339,4466,18,204,142,24,160,174,4873
52327,3039,1651,0,108,68,2,147,95,1388
57103,36033,18273,239,1267,478,243,961,544,17760
58054,3055,1538,6,65,38,0,70,60,1517
62649,604,271,0,22,3,0,16,4,333
63385,43634,21652,161,1835,408,122,1949,379,21982
78240,59502,29525,497,2301,384,390,1687,558,29977
92866,15017,6653,215,424,101,607,474,265,8364
76872,896,480,6,42,23,0,22,36,416
78022,4027,1934,13,145,39,0,81,55,2093
87038,671,315,0,15,11,0,26,0,356
95207,51879,24627,474,1504,438,657,1339,596,27252
92844,23878,11422,95,668,192,95,680,371,12456
93267,6347,3118,82,240,98,27,217,83,3229
87506,13209,6616,38,285,263,64,294,271,6593
89134,24410,11163,97,252,321,51,482,478,13247
89449,3091,1656,0,94,67,22,88,48,1435
98238,0,0,0,0,0,0,0,0,0
2659,1024,519,0,13,16,23,16,35,505
2764,4238,2105,0,106,39,0,113,89,2133
56280,472,259,3,9,8,0,4,9,213
56569,1303,657,8,25,22,2,32,23,646
57469,3480,1752,26,61,44,6,126,79,1728
44620,2057,1075,0,49,12,1,68,20,982
45157,10315,5226,49,295,86,5,279,229,5089
45320,14982,7297,31,499,198,30,371,206,7685
51044,232,104,0,6,5,0,0,1,128
52242,1574,811,14,0,0,9,0,0,763
52248,1893,906,0,61,7,15,59,33,987
52649,858,411,0,11,19,0,22,17,447
30575,1533,722,0,71,27,0,44,13,811
36617,13386,6324,27,302,114,166,372,192,7062
37361,1349,657,0,30,0,14,31,28,692
79085,28,16,0,0,0,0,0,0,12
79934,26289,12319,126,1209,98,182,1076,156,13970
80106,5194,2614,3,79,102,3,160,71,2580
81039,1698,790,6,29,10,2,45,52,908
83209,1165,508,31,8,0,57,16,0,657
60912,521,280,3,7,1,6,12,11,241
60954,5846,3289,10,218,70,0,204,39,2557
61859,1226,621,7,29,15,0,21,14,605
62285,4436,2173,0,100,26,45,70,149,2263
62663,259,131,3,5,1,0,6,7,128
72761,22337,11017,392,676,133,223,683,260,11320
74131,2708,1406,0,62,90,12,29,49,1302
68869,2105,1048,37,66,6,17,71,30,1057
75487,1987,1112,15,48,6,0,81,54,875
19805,38984,18091,243,1530,312,194,1615,457,20893
15443,31,16,0,0,0,0,0,0,15
16244,284,126,0,27,0,0,5,0,158
49444,29801,16485,97,1208,278,293,749,413,13316
50320,22209,11240,177,684,171,170,800,152,10969
53950,5551,3283,33,270,78,13,135,77,2268
66016,417,175,0,20,9,0,11,0,242
68001,98,53,0,8,0,0,5,0,45
63430,680,381,8,17,3,0,26,11,299
64014,25148,12470,141,981,276,55,923,203,12678
56731,74,33,0,0,0,0,0,3,41
58433,1102,571,5,21,4,3,21,22,531
59002,222,92,4,4,0,0,3,0,130
59923,9282,4857,49,194,188,58,182,198,4425
61020,3131,1612,10,113,2,20,100,34,1519
62361,522,307,0,15,0,0,8,5,215
55321,5480,2810,50,143,50,39,119,51,2670
55765,796,396,2,19,12,2,9,13,400
45653,3782,1871,0,94,4,30,109,138,1911
55371,16968,8627,63,663,180,117,638,187,8341
54527,890,475,0,16,19,0,6,14,415
55810,8354,4304,56,264,133,22,236,109,4050
37026,2249,1125,0,72,34,27,44,42,1124
32423,1025,550,1,54,3,0,53,11,475
34102,11454,5347,23,109,242,0,106,188,6107
42326,499,299,0,6,9,0,16,0,200
48341,17778,8731,251,688,62,48,681,370,9047
51351,4398,2097,2,151,46,0,207,77,2301
13806,288,162,4,0,0,0,0,0,126
14207,23808,10694,96,505,169,257,837,336,13114
15547,465,229,4,6,6,2,13,0,236
17267,2742,1417,21,104,56,7,56,39,1325
3036,5039,2573,56,184,102,23,107,75,2466
4416,5497,2431,15,201,49,29,234,92,3066
6238,12396,6025,25,371,134,27,472,122,6371
23831,36765,17307,167,1053,438,478,1095,649,19458
24220,897,526,0,0,50,0,30,10,371
24811,584,290,0,20,0,0,0,0,294
24970,4384,2459,41,289,50,8,109,26,1925
20017,20450,9524,155,715,149,170,906,208,10926
21754,6689,3361,47,242,177,0,143,137,3328
21851,6869,3075,42,166,105,57,182,131,3794
19129,10640,4934,30,422,62,72,526,73,5706
7977,634,280,0,29,0,0,26,9,354
8361,18730,9102,57,440,198,81,844,272,9628
11226,100277,45123,859,3753,836,608,4042,1651,55154
12121,1597,782,0,21,31,0,7,19,815
12601,41539,20111,516,1385,295,657,1458,255,21428
27926,1557,632,19,53,12,0,79,32,925
28311,35641,17083,426,1000,291,228,1381,483,18558
58476,264,141,0,7,3,0,7,2,123
58064,548,263,2,30,6,0,25,9,285
58067,237,127,1,4,2,0,1,2,110
33149,13054,6208,34,379,159,94,229,146,6846
35480,1330,650,0,40,17,0,53,11,680
39192,1196,575,0,27,34,38,11,26,621
40385,2817,1557,63,96,23,31,123,0,1260
41008,6832,3558,44,292,22,30,177,43,3274
49402,1325,734,2,20,24,0,27,31,591
50052,148,74,0,3,0,0,3,0,74
50577,440,188,11,15,5,0,7,5,252
29844,155,74,6,0,0,0,10,4,81
30903,658,230,0,19,0,0,38,0,428
11768,21158,10345,92,439,168,60,482,379,10813
12022,591,286,0,0,0,10,16,10,305
21221,43110,19933,327,1075,409,167,1184,592,23177
90504,33721,16566,175,1131,306,277,1003,543,17155
95962,1278,746,0,0,35,0,0,14,532
85395,29710,13215,57,901,575,125,1434,342,16495
97627,630,336,0,25,0,0,9,13,294
98801,43291,21675,254,1360,454,351,1213,686,21616
98828,2499,1482,8,108,20,0,58,24,1017
97446,5761,2870,0,218,35,73,326,44,2891
99636,557,296,7,22,4,0,12,5,261
7921,7651,3570,21,225,41,14,329,145,4081
8730,4709,2286,44,61,66,50,176,76,2423
10987,3342,1693,9,78,72,29,80,91,1649
3255,1961,981,8,43,31,0,16,25,980
3878,11959,5707,48,346,53,97,353,233,6252
4008,2844,1423,0,142,75,0,56,50,1421
1347,175,31,0,0,0,0,0,0,144
33841,8944,4402,31,252,53,34,305,123,4542
34222,11184,5455,53,250,209,92,202,118,5729
37179,15738,8031,92,392,223,8,796,363,7707
37852,2718,1415,0,125,30,13,153,21,1303
38301,33168,15725,275,831,206,382,1051,451,17443
23909,448,212,28,0,0,15,0,0,236
30441,1701,873,0,83,23,0,53,7,828
31041,689,295,6,3,3,0,33,11,394
32054,11724,7025,97,560,79,15,345,143,4699
21231,16160,7698,81,628,77,16,897,67,8462
29944,3985,1946,33,112,61,20,111,54,2039
24347,1714,965,0,0,16,12,34,0,749
24991,805,416,0,0,6,0,14,12,389
82410,2270,1156,22,25,7,19,39,71,1114
83110,4587,2355,33,88,78,0,142,31,2232
94971,288,106,0,20,10,0,22,26,182
96825,29375,14517,66,779,492,114,862,393,14858
92107,31148,15640,205,1621,375,443,1319,487,15508
78044,456,267,0,24,0,0,8,0,189
38771,3178,1385,41,66,30,45,115,29,1793
64149,355,173,0,12,0,0,12,4,182
64151,26777,13387,257,830,381,158,899,395,13390
54642,2133,1105,10,80,17,9,43,22,1028
46044,3068,1504,0,154,27,9,112,33,1564
49805,350,213,2,0,11,0,0,3,137
1901,1759,864,29,38,14,61,131,0,895
66967,2009,1003,5,56,23,0,52,70,1006
56666,1080,557,6,29,0,6,18,0,523
56685,95,53,0,0,0,2,0,2,42
62919,1052,556,20,79,32,2,34,31,496
72395,1124,559,0,40,17,0,34,11,565
72722,3541,1829,7,120,3,10,82,23,1712
71371,2440,1404,24,81,0,15,63,6,1036
913,8406,3571,61,77,57,61,175,110,4835
1801,40350,20164,291,1373,364,143,1325,515,20186
2056,11317,6646,16,481,129,13,221,104,4671
2561,301,230,0,30,0,0,0,0,71
97068,29693,14398,193,758,490,50,1115,452,15295
97201,18145,9159,198,467,117,560,637,115,8986
97859,123,69,0,16,0,0,0,0,54
90640,63177,30747,531,2057,533,519,2114,816,32430
92147,551,512,53,9,0,0,0,0,39
87523,759,381,0,0,41,0,23,20,378
99732,13,6,0,0,0,0,0,0,7
99749,299,147,0,12,0,0,16,1,152
38920,549,330,0,0,0,0,0,0,219
43844,3519,1791,7,119,19,16,79,82,1728
44905,13719,8002,100,740,163,41,389,244,5717
32440,7762,4849,72,437,108,48,148,80,2913
33563,27875,13668,277,1049,271,275,975,241,14207
18232,3808,1855,16,118,18,45,57,42,1953
18955,1720,835,11,93,2,0,80,3,885
19405,5360,2821,73,229,55,0,329,111,2539
56537,18894,9091,140,353,288,66,536,299,9803
56542,2839,1398,8,56,43,15,57,46,1441
73764,144,55,0,1,9,0,2,3,89
53556,2605,1348,2,78,52,4,98,39,1257
49738,9599,4975,70,249,164,34,167,107,4624
35446,2081,965,26,58,7,7,59,86,1116
36576,3796,2031,14,126,26,78,99,143,1765
56221,704,333,6,30,19,27,20,5,371
56273,4772,2421,12,107,77,37,120,95,2351
56653,1275,647,12,21,36,0,32,27,628
60101,39216,19281,316,1454,204,239,1309,460,19935
60474,986,506,2,32,7,0,27,1,480
40440,2274,1139,31,104,23,0,31,63,1135
48433,25396,12379,210,648,328,121,725,549,13017
48742,1694,875,17,30,36,2,17,60,819
48912,17697,9043,221,536,109,156,605,226,8654
49050,1759,928,0,30,30,0,61,36,831
49339,2135,1021,13,29,68,27,53,39,1114
56042,671,386,3,17,14,0,6,19,285
28701,3224,1707,12,85,16,0,65,47,1517
29712,2199,1187,0,131,20,13,57,31,1012
30720,28382,13881,226,928,137,317,754,328,14501
19341,17274,8376,85,562,260,112,546,272,8898
15340,1360,656,32,49,8,0,7,49,704
32350,1184,600,0,14,38,0,0,25,584
28328,27225,13360,238,789,344,285,926,421,13865
24534,1509,743,0,5,16,0,57,7,766
26237,522,261,0,0,21,0,9,0,261
8049,5491,2815,12,164,23,0,200,78,2676
11554,37358,18586,314,1211,318,172,1239,924,18772
5675,1136,585,4,21,23,14,23,11,551
6416,13973,7009,68,427,143,28,467,181,6964
13751,105,31,0,0,0,0,0,0,74
15022,10098,5123,57,236,199,42,196,271,4975
15641,464,226,0,11,8,4,15,2,238
15655,329,178,0,24,0,0,5,11,151
16151,136,74,9,2,0,0,11,0,62
17059,7972,4030,52,152,144,27,178,123,3942
32425,13480,7361,176,581,135,27,269,260,6119
24067,2398,1121,0,22,60,0,87,0,1277
29153,14934,7206,57,502,191,87,372,199,7728
18619,275,143,2,10,0,2,10,10,132
35586,4164,1930,15,31,10,8,118,62,2234
26321,302,184,0,0,0,0,0,0,118
11948,922,583,0,105,16,0,79,0,339
3904,7860,3978,38,199,196,65,149,161,3882
6779,8248,4169,21,240,76,36,196,144,4079
7444,11117,5290,105,161,104,14,193,192,5827
7727,7479,3399,39,223,159,41,267,137,4080
8240,2293,942,211,0,0,191,0,0,1351
2655,3393,1691,0,87,19,0,59,31,1702
45688,608,320,0,32,11,2,0,13,288
38767,26,13,0,0,0,0,0,0,13
50235,389,215,0,7,7,0,4,6,174
88034,44,28,0,0,0,0,0,0,16
88435,3787,2120,9,204,68,82,78,19,1667
92078,49034,24333,572,1750,514,222,2119,598,24701
92530,56511,28269,403,2046,305,434,1682,618,28242
94105,9155,4933,0,979,52,24,345,53,4222
54412,2026,1076,10,78,23,2,43,15,950
61230,1121,531,0,20,15,12,17,12,590
77016,30184,14833,145,892,252,335,1012,282,15351
77378,16201,7743,0,478,98,43,568,296,8458
77547,10028,5068,110,266,38,59,288,99,4960
78757,24823,12065,110,1221,189,87,991,450,12758
63045,0,0,0,0,0,0,0,0,0
63620,1277,642,25,25,12,0,24,18,635
84622,1771,840,7,58,24,0,106,34,931
95641,1548,693,0,59,36,0,34,34,855
97454,1389,700,5,7,19,0,42,22,689
91362,36062,17524,156,1029,605,326,893,717,18538
92377,19556,9425,118,575,133,257,618,235,10131
93422,33806,17209,220,1781,288,228,1201,695,16597
30705,33460,16391,107,863,226,179,1073,391,17069
36610,10646,4703,53,164,213,151,260,116,5943
38950,476,201,0,5,0,0,8,0,275
39540,8895,4169,55,336,19,15,417,187,4726
39760,11,0,0,0,0,0,0,0,11
45342,36659,17978,261,985,392,169,1323,426,18681
35023,24293,12358,182,717,513,163,480,271,11935
98837,43078,20975,448,1384,492,215,1491,484,22103
83856,6391,3356,10,208,114,0,176,125,3035
85014,27395,14283,109,1167,286,172,1231,377,13112
85747,25777,12683,152,980,156,69,963,228,13094
80758,3628,1776,0,83,25,25,69,83,1852
95497,1161,459,0,12,35,0,10,45,702
97060,22609,11479,149,947,256,256,706,166,11130
1084,174,89,0,0,0,0,0,11,85
1260,481,170,0,0,0,58,0,11,311
1756,6068,2948,48,120,146,10,160,80,3120
1827,3345,1680,10,72,26,10,71,58,1665
56181,1110,503,4,26,8,2,19,13,607
45784,3402,1692,18,141,37,30,99,80,1710
46016,17996,9098,137,575,192,147,673,160,8898
47380,1612,789,0,39,13,15,77,37,823
52553,1892,980,15,67,51,0,61,75,912
41828,731,371,0,16,4,0,43,0,360
59828,5781,2694,32,141,51,31,153,70,3087
60140,17639,8593,85,583,159,0,621,55,9046
64022,153,81,0,6,0,0,4,0,72
48413,7202,3515,38,233,90,12,200,95,3687
49012,3218,1573,43,95,41,36,109,41,1645
31018,2674,2076,22,197,12,15,21,12,598
31024,20438,9915,62,519,323,14,532,259,10523
22601,28759,14062,249,998,207,205,678,397,14697
23024,8381,4142,12,161,80,34,175,219,4239
14569,5915,2823,17,263,108,45,149,38,3092
14546,4608,2318,26,94,79,7,101,80,2290
35633,20747,10242,40,496,214,90,558,328,10505
37312,34481,16258,146,902,459,196,1115,519,18223
18405,2751,1310,10,51,115,0,47,83,1441
26376,543,319,0,62,22,0,0,0,224
27503,6328,4901,11,562,108,0,68,35,1427
27929,1711,837,15,16,57,0,9,50,874
28768,7388,3502,17,165,152,38,207,121,3886
98939,104,62,0,8,0,0,0,0,42
16253,72,44,2,0,4,0,0,3,28
17851,7647,3609,18,168,76,27,205,150,4038
33525,20449,10290,146,488,193,176,494,319,10159
35135,2128,1075,11,25,31,5,73,34,1053
35443,2157,1273,64,193,13,14,63,2,884
25879,352,144,0,31,26,0,0,0,208
26554,42011,20937,387,1039,618,612,921,687,21074
7738,6310,3211,17,121,56,0,177,86,3099
10501,1394,675,0,12,6,0,26,19,719
10510,10381,5138,13,291,68,112,305,163,5243
11754,18086,8388,140,522,199,61,552,359,9698
12078,23381,11801,244,694,285,201,465,363,11580
12741,175,72,0,2,0,0,6,0,103
1256,719,404,13,8,13,7,2,8,315
1507,13482,6044,64,407,124,230,405,208,7438
4063,482,167,0,8,7,0,0,0,315
4924,2364,1203,4,75,42,16,109,36,1161
70343,5292,2735,26,213,0,24,91,65,2557
70506,41480,20063,615,1601,291,516,1080,325,21417
71862,511,271,0,11,11,0,1,0,240
73065,8404,4167,44,312,77,0,300,85,4237
73938,756,376,0,20,3,0,16,7,380
49637,3817,1904,0,122,44,23,121,34,1913
90620,46842,22554,299,1580,465,288,1505,486,24288
91502,11598,5777,130,281,15,54,357,145,5821
89832,1351,665,6,52,4,14,60,6,686
95639,321,152,0,25,0,16,17,0,169
68004,946,446,0,16,8,0,21,13,500
45735,1562,832,9,30,22,0,50,59,730
47170,14673,7195,173,505,181,82,343,203,7478
47336,3142,1592,16,123,36,22,107,63,1550
65646,1704,890,7,45,37,10,22,24,814
74366,1548,729,8,33,16,4,52,25,819
74454,3294,1709,22,128,68,0,132,34,1585
75574,1704,799,4,9,20,5,34,39,905
75969,3965,1910,33,36,78,46,72,74,2055
80550,28403,13832,41,1230,344,53,1156,306,14571
82601,28830,15257,238,1322,366,305,735,310,13573
59451,196,72,0,19,2,0,17,0,124
61328,25,8,0,0,0,0,9,0,17
62289,351,175,0,5,1,3,11,1,176
57075,1093,612,25,15,68,0,11,23,481
57279,1155,626,24,27,30,0,15,17,529
58363,136,87,0,2,0,0,0,4,49
78382,21578,10359,48,365,387,65,673,342,11219
63536,1086,518,7,20,16,0,57,8,568
64093,28045,14322,753,703,309,712,678,287,13723
73571,124,76,0,0,0,0,15,0,48
70651,233,193,0,20,0,0,18,0,40
23169,1086,519,0,14,11,0,10,0,567
24482,5254,2757,44,220,15,40,161,72,2497
25213,6213,3201,19,209,47,11,178,47,3012
25669,1052,553,0,51,28,15,7,30,499
25915,221,119,0,3,1,3,26,0,102
14526,20340,9444,56,728,191,47,564,307,10896
15110,5544,2435,63,48,54,112,249,56,3109
30757,2128,1010,0,125,0,32,75,67,1118
31093,28140,13423,165,1399,268,135,987,308,14717
21915,2732,1317,2,94,14,46,106,88,1415
27045,9374,4502,39,272,63,30,272,127,4872
17964,782,413,2,20,14,5,23,10,369
29435,4379,1988,0,98,25,0,153,27,2391
12914,902,519,7,11,6,0,5,4,383
51570,972,478,3,39,5,2,35,15,494
52753,5648,2807,19,122,160,0,97,79,2841
53502,2478,1259,0,103,28,16,84,16,1219
38105,6209,2793,95,187,47,17,229,75,3416
38120,14634,6918,40,421,254,25,387,271,7716
7976,653,310,0,8,9,15,8,12,343
11751,14559,7212,121,314,247,89,405,180,7347
12472,1472,794,9,48,16,1,38,9,678
15550,1766,877,5,39,29,13,40,18,889
18635,3792,1867,16,63,70,22,101,63,1925
3741,4033,1851,24,135,108,158,90,139,2182
76112,41743,20456,216,1620,411,231,1615,541,21287
76834,5328,2634,65,101,60,69,119,82,2694
77082,55527,26427,373,2257,435,461,2117,867,29100
66749,7453,3660,13,226,86,22,208,115,3793
67119,1405,621,18,38,22,12,51,15,784
74041,2852,1431,11,97,35,11,128,27,1421
74851,10783,4988,62,369,165,64,481,150,5795
74962,4490,2354,5,73,49,10,101,50,2136
43040,34169,15900,273,973,303,212,1643,347,18269
43734,1738,825,0,16,0,18,27,12,913
43746,1215,606,0,33,36,0,73,0,609
63653,1310,691,13,45,4,12,30,9,619
63748,962,462,0,14,15,2,34,23,500
27030,35843,17098,229,956,482,160,914,388,18745
54436,2348,1233,7,51,23,18,37,23,1115
55314,1111,540,0,14,13,0,39,15,571
19319,747,491,73,0,0,5,0,0,256
49650,3251,1691,36,142,58,69,117,44,1560
50540,932,478,0,24,12,0,22,12,454
51467,680,354,0,17,6,3,24,8,326
80510,323,170,0,6,18,0,0,14,153
83536,4402,2223,23,66,76,5,106,63,2179
84532,10043,4929,80,317,103,29,321,162,5114
94550,50500,24435,160,1580,415,223,1479,719,26065
87046,162,90,0,0,0,0,33,0,72
89060,9042,4873,54,226,176,0,85,201,4169
14108,6082,2968,111,161,28,10,179,48,3114
21028,3021,1575,0,53,33,45,50,27,1446
21228,48133,23428,391,1395,418,123,1466,688,24705
23187,239,88,13,0,0,21,0,0,151
6051,30220,14296,200,872,243,217,1130,442,15924
6607,8801,4102,57,277,26,37,551,114,4699
7646,16578,8231,102,442,209,101,588,287,8347
10518,1231,544,0,0,18,0,16,0,687
10901,23538,11232,131,657,348,93,642,288,12306
19510,8470,4268,53,404,0,118,238,161,4202
2556,2681,1127,0,71,22,14,57,71,1554
31303,2621,1091,0,121,10,112,104,29,1530
44849,2522,1221,5,96,36,7,69,69,1301
45870,246,112,0,0,0,0,6,0,134
46794,1732,880,48,54,18,0,76,26,852
27024,3148,1470,11,36,61,0,92,46,1678
28152,25348,12029,203,741,182,413,820,424,13319
29477,6966,3326,7,163,50,27,167,176,3640
29620,13006,6475,47,374,207,73,331,81,6531
49106,4913,2371,18,184,71,0,177,48,2542
98826,7248,3458,48,149,155,43,108,122,3790
99567,9181,4801,21,356,68,72,266,92,4380
84058,38610,19773,967,1145,210,697,1150,283,18837
85234,49894,24179,294,1835,484,305,2122,614,25715
85304,27746,12622,175,709,315,164,826,266,15124
77078,15411,7321,39,500,146,102,343,250,8090
77835,2317,1228,0,40,56,0,45,147,1089
66541,188,99,0,11,1,0,3,4,89
68372,3413,1667,0,119,34,0,158,34,1746
68728,199,109,0,2,5,0,1,3,90
57722,210,102,0,11,15,0,12,8,108
58057,93,43,0,2,9,0,3,7,50
51019,926,432,2,11,5,5,49,6,494
64054,3463,1688,14,93,76,41,104,56,1775
65239,1375,708,3,49,17,16,63,25,667
65263,1865,962,10,46,19,7,51,13,903
45106,12382,6172,46,395,131,175,393,123,6210
45854,459,217,0,18,2,0,19,7,242
46819,9580,4486,73,177,188,52,203,76,5094
71060,2389,1107,4,22,35,47,41,50,1282
56007,21165,10177,70,541,265,122,514,289,10988
48457,8140,4181,54,334,154,7,171,130,3959
48770,1893,1002,25,54,34,5,47,39,891
60637,47454,20877,478,956,342,432,1676,714,26577
61478,319,163,0,0,7,0,15,0,156
30461,14366,7452,155,538,68,10,680,145,6914
41352,670,354,8,43,50,0,12,29,316
43351,10013,4763,10,286,139,41,242,256,5250
36555,791,406,0,8,26,0,12,9,385
21822,2013,1070,0,52,17,0,81,20,943
23455,49703,25869,707,1485,325,277,1372,778,23834
31730,8419,3920,0,190,75,95,213,70,4499
32162,54530,25317,0,60,1342,0,39,856,29213
24467,2405,1094,0,128,0,0,110,50,1311
72566,596,345,0,13,13,0,18,1,251
80128,36293,18232,163,1241,510,148,1273,732,18061
80310,7291,4043,373,0,0,236,0,0,3248
83873,1454,773,18,42,6,6,87,62,681
85615,9442,4484,28,225,290,87,195,114,4958
11556,0,0,0,0,0,0,0,0,0
11794,2952,1571,178,4,0,236,11,0,1381
18707,16075,8007,91,394,172,10,442,110,8068
20862,327,159,0,0,0,0,0,6,168
25186,1100,506,8,19,39,0,0,13,594
25652,1337,688,0,80,28,24,27,35,649
4686,129,66,0,2,0,0,2,4,63
5143,4390,2239,9,145,82,24,119,77,2151
2559,4059,2018,46,115,64,0,65,72,2041
77868,17028,9875,177,709,180,23,569,155,7153
81232,27,17,0,0,0,0,0,0,10
83261,640,304,0,19,15,0,26,9,336
83454,560,289,0,0,0,5,10,7,271
78355,7156,3727,114,243,75,30,215,87,3429
78369,393,207,0,11,9,0,0,0,186
79083,1827,860,14,29,27,0,40,21,967
79108,16083,10720,22,1147,184,72,351,122,5363
28773,3056,1386,29,41,91,9,69,72,1670
34114,16727,8375,122,297,299,88,308,248,8352
37313,1451,702,11,8,25,5,40,12,749
37826,5661,2814,28,93,87,1,64,107,2847
46791,1104,560,43,9,11,7,13,2,544
2904,30522,13813,212,786,232,146,1132,562,16709
725,80555,37340,505,2488,809,511,3017,1165,43215
24014,17401,8099,21,584,191,332,355,156,9302
16859,548,301,0,27,3,0,12,8,247
18071,10013,5046,55,329,106,15,190,142,4967
32118,17349,8826,56,279,250,129,282,263,8523
49747,1896,958,3,38,30,13,57,46,938
51540,388,184,1,4,1,2,1,4,204
54154,5698,2842,22,147,41,39,149,67,2856
54961,13649,6901,30,535,133,77,466,164,6748
11359,0,0,0,0,0,0,0,0,0
55904,27028,13694,145,920,271,312,691,328,13334
56297,940,518,4,49,10,0,45,11,422
92869,36913,18299,306,1207,344,181,1039,508,18614
95020,63852,31452,404,1940,514,272,2176,835,32400
43123,65442,31741,126,2307,520,257,2158,858,33701
96768,18155,9313,68,548,228,50,522,336,8842
40383,23718,11567,232,670,326,117,841,495,12151
89444,2650,1384,21,18,56,5,41,62,1266
32563,25550,12380,53,702,320,62,808,367,13170
37656,3901,2032,33,76,72,0,43,35,1869
60633,12871,6786,141,474,108,96,383,122,6085
63962,272,163,0,0,0,0,0,0,109
27919,985,503,0,50,0,0,16,23,482
78830,887,456,0,5,11,40,8,11,431
28090,8473,4459,38,199,89,2,198,217,4014
68136,17808,8877,40,684,124,55,770,190,8931
29592,800,351,0,67,0,0,55,24,449
29646,28182,13424,449,987,144,137,981,270,14758
77613,963,525,0,16,12,0,35,4,438
12884,539,313,0,15,13,0,10,10,226
13323,11097,5215,125,307,114,142,188,147,5882
54475,1664,934,6,76,11,23,29,18,730
49312,264,130,0,4,12,0,4,11,134
20814,28930,13654,133,931,342,76,1115,362,15276
25928,414,172,0,23,0,0,0,23,242
50597,1195,600,9,19,10,3,12,3,595
15435,631,333,61,34,0,0,19,11,298
15953,162,77,0,27,0,0,14,0,85
55443,31758,15046,128,1398,359,173,1111,482,16712
96710,246,109,0,0,0,0,0,27,137
45065,4765,2399,48,90,200,0,0,139,2366
97623,2596,1393,20,41,67,11,56,48,1203
32064,6888,3524,0,162,14,0,153,23,3364
21050,18586,9317,68,469,155,62,427,198,9269
33856,330,158,0,0,0,0,0,18,172
33935,21968,11522,49,806,250,148,572,155,10446
99782,508,288,1,12,9,4,19,8,220
16622,169,87,0,5,0,0,0,0,82
63465,355,169,0,13,0,0,12,8,186
19038,30940,14635,211,799,377,212,932,435,16305
64481,938,474,0,36,24,0,26,25,464
27982,54,41,0,0,0,0,0,0,13
79010,996,596,0,6,0,0,4,7,400
80005,29117,14209,132,1027,315,122,1072,522,14908
29142,5187,2423,48,96,97,38,144,122,2764
71111,43551,21195,274,1504,345,147,1683,490,22356
11425,0,0,0,0,0,0,0,0,0
84529,230,91,0,31,33,0,0,19,139
60201,42296,20122,759,1027,350,896,1098,405,22174
20204,0,0,0,0,0,0,0,0,0
49112,9967,4975,23,325,111,99,340,120,4992
49864,70,30,0,0,0,0,0,0,40
14512,4446,2158,22,122,87,22,98,57,2288
50613,44154,20759,767,1413,470,1542,1214,409,23395
98070,10036,4553,91,350,108,41,156,234,5483
1844,50019,24275,360,1459,627,356,2061,727,25744
1905,25465,13286,252,930,146,328,1003,252,12179
1810,35609,17176,300,1127,256,290,1107,401,18433
64437,641,297,0,4,9,0,8,14,344
64451,385,192,6,8,2,3,8,11,193
79545,1872,1043,0,31,22,0,33,10,829
80650,1558,811,9,73,6,3,44,1,747
81055,1443,658,0,47,17,0,27,19,785
71275,2226,1015,3,79,34,0,84,50,1211
83425,531,260,15,7,2,0,0,3,271
68064,3401,1647,0,106,49,0,88,68,1754
68406,456,240,3,20,4,0,2,10,216
64480,167,96,0,0,3,0,3,1,71
65039,2709,1425,14,42,80,0,61,51,1284
66052,2557,1322,0,73,20,2,75,54,1235
66094,318,159,0,12,0,5,4,2,159
75165,43498,21138,409,1284,401,504,1382,457,22360
76559,5849,2979,0,297,29,32,207,67,2870
51578,52,27,0,0,1,0,0,5,25
55117,45486,22323,285,1278,481,308,1782,455,23163
40048,136,0,0,0,0,0,0,0,136
43946,2136,952,15,11,7,0,63,9,1184
45616,1461,738,28,38,23,0,7,0,723
47126,4821,2697,41,168,41,30,120,58,2124
49285,5787,2861,9,120,81,22,154,45,2926
62413,330,178,4,4,14,0,16,7,152
58321,111,56,0,0,1,0,0,2,55
50247,2568,1318,0,41,3,14,110,38,1250
4107,9102,4273,0,263,175,20,202,170,4829
5875,466,186,0,5,11,0,9,5,280
7018,28756,13299,164,925,184,223,1160,359,15457
1611,2241,1165,13,102,14,19,92,19,1076
14222,14037,6828,268,329,176,135,312,132,7209
14548,3764,1932,12,99,54,4,104,47,1832
15021,7279,3515,15,217,106,22,199,140,3764
15920,719,352,0,23,11,9,13,7,367
23185,48036,22766,692,1131,444,653,943,613,25270
23947,4127,1868,8,121,45,12,157,120,2259
24055,13420,6452,157,296,177,47,346,127,6968
24059,872,538,0,0,0,15,27,30,334
8033,16010,7877,86,466,207,103,435,114,8133
10507,7068,3151,16,354,64,0,486,140,3917
12455,1749,730,0,3,25,0,10,29,1019
62956,911,424,1,5,15,0,5,13,487
64849,174,87,0,2,5,0,7,0,87
72076,38595,18223,236,1135,505,240,1383,542,20372
73931,416,238,2,22,4,4,18,6,178
75497,3368,1765,13,77,95,9,81,58,1603
76247,14260,6852,18,518,123,33,563,111,7408
67333,2495,1267,21,45,35,0,112,31,1228
85544,2487,1269,0,55,82,0,39,35,1218
87507,48947,24282,479,1693,583,273,1646,581,24665
78836,162,50,21,0,0,0,0,0,112
79325,2361,1076,15,77,30,41,66,36,1285
71433,4208,2102,67,218,35,59,206,51,2106
91364,27340,13495,81,914,269,98,1083,448,13845
98256,328,175,3,20,5,0,8,5,153
98444,33965,15584,362,1259,348,205,1049,420,18381
93606,949,398,3,7,17,0,26,0,551
43107,3399,1716,77,90,30,6,60,28,1683
48038,44139,20694,246,1256,547,300,1570,723,23445
50060,2625,1247,0,81,20,0,59,57,1378
35810,29503,13695,278,693,383,326,867,422,15808
36046,1413,621,0,25,43,0,52,0,792
39170,10513,4860,9,119,100,81,458,206,5653
14070,6847,4130,58,370,113,49,98,110,2717
16933,6783,3255,99,157,81,82,168,114,3528
8828,2283,1105,16,68,13,6,91,37,1178
20692,1273,715,15,0,0,0,0,14,558
33852,21202,10629,81,485,304,62,389,448,10573
34760,874,395,7,18,0,22,24,17,479
34761,45639,22720,417,1645,360,267,1640,307,22919
34957,23078,11447,56,519,406,63,430,323,11631
43341,948,485,19,3,0,25,71,24,463
43439,53,44,0,0,0,0,0,0,9
17745,18753,9226,302,481,198,417,413,254,9527
19601,33397,16520,132,1021,282,384,1139,403,16877
28076,376,144,0,37,0,0,0,0,232
46373,15480,7451,120,393,193,63,578,308,8029
31065,1193,585,1,24,0,0,24,29,608
31784,764,355,4,19,8,2,48,26,409
60426,28924,13497,343,751,239,177,1148,405,15427
60543,40027,20317,183,1241,196,118,1685,421,19710
61369,1656,785,0,35,19,12,18,25,871
61411,444,274,0,0,22,0,13,0,170
61749,461,229,4,10,8,8,3,16,232
69161,95,49,0,0,5,0,0,2,46
70083,2564,1175,60,76,55,0,63,8,1389
72034,50137,24523,1061,1664,328,1015,1689,442,25614
76626,1192,505,3,15,5,11,51,24,687
79343,1669,860,8,43,12,26,45,11,809
65215,252,37,0,0,0,22,0,0,215
66713,5602,2718,26,124,80,30,164,99,2884
67878,2346,1200,38,50,31,10,83,29,1146
72223,23574,11838,89,899,207,44,751,390,11736
72916,8127,4108,2,372,134,40,326,107,4019
83114,1050,508,2,30,4,0,14,10,542
83612,1972,1023,0,43,33,25,47,18,949
87056,1077,547,0,19,15,0,27,0,530
99345,146,68,0,9,0,0,4,1,78
95616,52088,24509,1811,916,309,2572,814,444,27579
96731,2984,1444,44,110,37,2,153,11,1540
4491,146,69,0,2,6,3,2,9,77
6339,8307,4274,9,263,72,48,262,105,4033
53901,14703,7742,93,517,152,63,404,215,6961
54106,5286,2772,49,158,64,22,176,51,2514
54632,1085,563,10,18,19,0,15,18,522
42078,1605,760,0,27,20,1,43,30,845
47612,737,399,2,32,16,7,16,0,338
2876,291,123,0,0,0,0,0,0,168
3462,1345,695,0,41,34,0,44,17,650
5847,754,361,0,4,6,0,23,21,393
7114,12749,7832,76,845,14,117,188,29,4917
14818,2129,1075,2,31,27,35,37,52,1054
15233,4246,3000,42,384,64,9,59,20,1246
60178,22413,10927,101,665,184,146,538,309,11486
60638,58797,29033,358,2225,351,165,2409,610,29764
85650,15747,7414,0,339,392,26,514,427,8333
86044,3362,1602,21,36,9,33,81,48,1760
75934,204,97,0,27,0,0,17,0,107
83445,7500,3984,62,278,71,22,268,67,3516
97813,1453,720,3,36,21,0,61,8,733
73401,35952,17337,258,909,432,175,1128,512,18615
74066,33041,16383,218,1112,346,213,1075,465,16658
95117,29592,14928,244,1454,288,185,1114,243,14664
64676,143,73,0,3,7,0,2,0,70
66061,63884,31847,482,2515,447,336,2414,611,32037
69154,1151,571,0,42,8,2,54,10,580
31015,21549,10177,293,589,225,166,675,301,11372
8510,5753,2854,130,72,50,78,70,59,2899
11365,44983,21359,170,1220,306,341,1533,730,23624
12542,5537,2762,50,140,154,10,124,109,2775
13693,402,205,0,27,4,0,5,4,197
62908,496,252,21,2,25,0,6,18,244
70131,33672,15574,124,1306,367,230,1062,459,18098
71455,140,76,0,7,0,0,7,0,64
50314,11528,5495,110,379,68,84,322,117,6033
50322,31177,15451,212,1037,270,145,858,430,15726
55008,15651,7638,62,401,112,39,507,222,8013
56161,359,180,0,18,4,0,16,3,179
50125,20354,9563,259,580,217,249,569,297,10791
51062,432,259,0,2,1,0,17,1,173
70122,37298,16739,263,1173,364,227,1610,607,20559
31548,21146,10525,21,638,160,290,599,214,10621
36740,1347,581,0,18,2,11,5,7,766
37301,1194,560,0,60,25,0,30,12,634
44221,29154,14232,163,1036,201,168,1074,354,14922
46112,37047,18895,109,1528,197,129,1575,605,18152
46239,29584,14631,140,1198,210,229,1441,437,14953
46260,33215,15558,250,711,266,229,1067,371,17657
34753,5818,3314,0,231,10,0,226,23,2504
41010,3681,1842,55,114,27,42,172,40,1839
43502,6609,3274,36,290,83,63,259,84,3335
24433,104,46,0,0,0,0,0,0,58
24228,6294,3161,36,117,80,24,187,83,3133
75227,58995,29074,456,1674,351,412,1958,466,29921
48883,6913,3451,43,157,55,36,219,84,3462
4450,1214,568,4,36,0,12,38,29,646
15935,3487,1956,29,204,54,0,186,35,1531
16403,6676,2926,18,144,67,41,279,95,3750
17241,11910,5971,83,300,184,60,303,161,5939
12118,15218,7474,82,410,265,10,528,207,7744
13668,3291,1649,20,94,23,5,58,44,1642
1199,0,0,0,0,0,0,0,0,0
80440,2681,1564,0,64,42,0,60,22,1117
92240,34447,17228,193,1110,392,310,1617,359,17219
85715,17137,8285,242,350,271,179,289,309,8852
88254,29,29,0,0,0,0,0,0,0
17779,311,176,0,0,13,0,0,39,135
19512,17307,8584,43,342,178,66,466,551,8723
21662,455,224,0,0,0,0,9,10,231
95762,42494,20868,157,1064,475,165,1352,545,21626
97067,1956,1106,46,0,74,0,74,48,850
75832,121,84,0,75,0,0,23,0,37
17217,219,132,0,0,0,0,26,5,87
76508,8,8,0,0,0,0,0,0,0
29449,8265,3838,18,174,161,17,185,156,4427
65250,615,354,5,19,25,6,24,0,261
29564,765,323,0,29,4,3,29,10,442
66963,112,52,0,2,0,0,2,1,60
63964,559,224,0,38,0,0,4,0,335
47230,1526,841,0,72,25,0,61,73,685
40502,26797,13178,259,823,294,491,807,266,13619
42167,7992,3987,40,295,99,61,206,133,4005
53149,19708,9836,68,657,235,29,574,272,9872
54235,16690,8268,125,605,402,0,293,266,8422
55001,3019,1503,0,81,59,9,67,80,1516
55123,25612,12636,94,856,334,55,861,353,12976
39269,0,0,0,0,0,0,0,0,0
57048,1182,543,0,17,5,0,40,5,639
44866,1994,1054,5,19,44,0,17,15,940
44881,0,0,0,0,0,0,0,0,0
34691,20473,10141,81,716,297,64,807,252,10332
35634,9793,4935,0,281,111,17,211,164,4858
48837,19669,9661,74,654,213,91,770,394,10008
42102,94,39,0,0,0,0,0,0,55
43613,32653,16037,282,779,469,221,1181,376,16616
33849,1191,640,0,46,0,18,36,0,551
35062,7631,3616,137,172,97,80,189,172,4015
36278,4755,2483,32,146,85,10,77,87,2272
4925,89,41,0,0,0,0,2,2,48
1519,6741,3359,24,236,69,0,154,163,3382
93440,1648,793,0,0,0,0,5,2,855
89428,131,73,0,0,0,0,0,0,58
95987,6119,3080,28,207,64,32,201,73,3039
96142,807,434,0,20,11,0,23,64,373
97375,1592,724,4,20,2,0,67,15,868
83855,2164,1011,0,44,10,0,24,35,1153
76135,23230,11768,91,717,181,89,701,346,11462
77845,63078,31296,1456,1867,368,1007,2018,597,31782
12939,211,138,16,2,1,0,10,0,73
13332,2939,1348,5,112,43,3,140,35,1591
13861,343,148,0,0,0,0,0,0,195
15129,10433,4947,22,260,216,29,257,143,5486
10535,427,86,0,0,0,0,0,0,341
5056,418,209,0,6,5,0,8,0,209
6105,19373,9381,168,483,179,314,484,211,9992
7828,15369,7896,110,590,215,63,734,163,7473
17236,8518,4346,23,266,101,72,203,181,4172
17344,3624,1749,20,203,6,9,72,16,1875
26385,3957,1965,11,130,14,7,118,68,1992
48856,865,466,11,12,2,0,13,10,399
18231,439,218,0,11,8,0,14,3,221
22801,40657,20187,1480,1229,306,1339,998,431,20470
23959,1364,735,7,88,29,2,45,27,629
24084,10803,5581,53,490,256,30,334,212,5222
4734,711,360,0,19,0,3,2,16,351
20653,23546,11284,209,1175,134,277,949,168,12262
638,16701,8034,156,377,173,106,439,339,8667
782,18229,9084,178,475,92,165,583,226,9145
25119,171,85,0,0,0,0,0,0,86
84040,23687,11598,201,850,309,136,858,342,12089
84534,2702,1401,29,77,4,24,64,43,1301
84736,242,137,0,4,0,0,10,0,105
78012,321,171,5,5,4,0,2,6,150
65326,2093,1039,0,42,16,0,41,14,1054
66860,1292,652,11,33,41,6,49,17,640
59602,26635,13328,57,854,261,115,831,436,13307
16063,6785,3087,2,227,52,36,108,129,3698
18913,68,40,0,0,0,0,0,0,28
25901,11259,5411,105,295,154,11,340,169,5848
3031,11393,5553,35,203,135,89,283,196,5840
3850,275,110,0,0,32,0,0,12,165
7450,25283,12029,112,506,259,33,802,269,13254
13826,15,0,0,0,0,0,0,0,15
14020,22642,11202,131,569,275,149,557,327,11440
15211,10574,5271,14,290,57,115,340,116,5303
23161,158,85,0,0,11,0,0,0,73
25070,1503,698,0,11,7,0,40,19,805
20677,2603,1342,35,36,29,11,40,23,1261
22620,2536,1301,0,26,22,102,104,32,1235
29429,3085,1424,18,69,28,0,119,33,1661
13144,1986,1015,16,28,6,11,105,3,971
13167,3215,1720,0,101,61,33,19,45,1495
79005,1639,898,8,66,27,0,21,11,741
51465,855,441,0,28,10,0,16,19,414
51631,257,127,0,15,1,0,4,10,130
53115,16087,8042,50,528,184,65,382,211,8045
54755,7043,3517,35,177,103,24,189,128,3526
58402,250,173,0,4,6,0,0,0,77
58756,172,94,0,1,5,0,1,0,78
59043,2995,1495,15,78,10,28,83,25,1500
59254,2157,1037,46,41,30,2,46,44,1120
59631,250,119,0,8,2,0,8,7,131
65255,4005,1766,16,71,27,23,177,54,2239
65259,3278,1749,4,129,19,86,140,28,1529
68033,338,196,0,9,9,0,7,9,142
68972,105,52,0,0,0,0,0,1,53
57314,787,403,2,17,21,0,27,17,384
72641,2935,1448,0,132,52,0,71,71,1487
73044,23525,11877,195,636,273,188,800,371,11648
73052,6673,3134,25,200,110,24,233,122,3539
74368,90,42,0,3,0,0,4,0,48
74943,162,85,0,8,0,2,0,7,77
30451,47,24,0,0,0,0,6,0,23
30554,7687,3925,34,221,61,112,332,103,3762
32784,12313,6092,0,114,171,15,351,182,6221
32805,20695,10184,139,583,256,40,699,239,10511
46774,17456,8590,137,400,146,127,572,248,8866
47353,5553,2751,36,256,60,35,236,79,2802
50841,2549,1278,5,58,55,0,109,38,1271
54949,3370,1763,19,95,32,10,125,54,1607
42356,92,0,0,0,0,20,0,0,92
45334,2117,1078,0,61,34,3,59,29,1039
40445,751,321,0,21,7,15,23,0,430
33916,23438,11414,149,642,185,90,676,232,12024
36477,3898,1899,48,89,37,8,79,41,1999
37377,15691,7672,33,529,129,19,547,212,8019
16029,791,384,2,14,0,11,21,14,407
17886,1467,938,0,43,0,115,0,0,529
7643,10827,5233,66,377,98,127,403,225,5594
29849,518,196,0,28,0,1,44,0,322
24426,13585,6657,58,364,236,35,385,172,6928
20053,0,0,0,0,0,0,0,0,0
20136,30635,15579,194,1056,208,119,1217,258,15056
21757,3192,1680,48,82,43,4,93,23,1512
25446,1205,584,0,0,0,54,0,0,621
97211,34962,17443,116,1871,252,90,1859,314,17519
92886,50545,24484,209,1475,623,382,1757,890,26061
98255,236,136,0,5,0,0,5,2,100
98617,1480,729,44,0,21,0,0,28,751
99008,1131,549,49,58,0,18,82,10,582
86544,1175,634,24,36,5,13,11,2,541
2832,4320,2021,23,138,55,27,233,14,2299
4051,1071,539,9,10,4,10,20,9,532
918,16063,7199,111,463,164,132,482,182,8864
61312,511,261,0,25,1,0,16,9,250
62360,1918,1042,3,57,10,0,28,27,876
62539,1297,626,9,46,28,15,22,30,671
72837,7445,3825,97,196,55,64,325,83,3620
57317,652,345,2,27,9,0,14,2,307
58529,616,295,0,16,14,3,11,10,321
58733,341,151,0,13,7,0,13,9,190
60042,8420,4446,66,372,76,73,316,131,3974
67071,205,104,0,0,6,0,22,0,101
68665,853,425,8,19,14,4,11,16,428
64601,11940,5239,81,244,116,44,614,238,6701
64745,202,99,0,0,0,0,0,0,103
66710,520,256,3,17,3,1,27,10,264
75243,67848,33395,241,2892,444,393,2313,670,34453
73120,35771,16541,272,1123,322,222,1495,466,19230
74429,15208,7537,77,615,113,108,587,198,7671
61944,12259,5980,20,434,128,3,293,90,6279
84087,15481,7838,136,758,159,158,521,196,7643
84336,184,85,0,10,4,0,8,3,99
78132,28620,14211,207,525,380,153,901,344,14409
78234,5430,2856,91,242,32,117,177,0,2574
95449,1656,915,14,22,12,16,44,18,741
95457,3330,1681,14,98,27,0,51,53,1649
89422,111,71,0,0,0,0,0,0,40
92504,59556,29495,766,1839,272,581,1841,773,30061
77577,1582,817,0,79,33,14,15,22,765
99665,75,52,1,3,0,0,0,2,23
99680,566,315,5,3,2,4,15,0,251
30033,32968,15597,408,997,301,697,1182,530,17371
34288,12304,6048,0,230,128,0,430,101,6256
37012,2337,1144,24,86,24,18,35,47,1193
39364,2646,1266,26,28,56,62,37,63,1380
40701,30305,15364,120,966,287,114,840,452,14941
44681,7987,3858,39,166,84,60,189,86,4129
46123,35617,17473,337,1049,452,222,1361,420,18144
46526,32513,15833,354,913,279,281,831,395,16680
95634,3445,2030,13,181,89,0,96,35,1415
95713,9764,4875,8,240,151,83,176,246,4889
96022,16442,7682,185,556,299,70,334,238,8760
97357,174,78,0,10,15,0,0,11,96
91106,25375,12611,141,1145,162,164,813,392,12764
88116,450,227,0,5,1,0,11,10,223
90041,29516,14317,421,1140,357,208,901,423,15199
54846,460,238,0,17,10,0,27,5,222
56546,258,122,0,6,7,0,6,3,136
56726,1760,888,13,58,8,0,66,7,872
57061,74,38,0,3,0,0,1,2,36
57353,800,387,17,24,4,1,14,4,413
57358,35,23,0,0,2,0,0,0,12
43764,8750,4228,128,285,52,25,348,111,4522
43915,1172,640,2,40,10,10,21,17,532
50530,1183,591,7,55,17,3,13,40,592
53027,22955,11626,115,688,308,84,626,231,11329
53555,8505,4469,12,191,177,10,158,143,4036
53826,1226,625,19,41,31,5,43,37,601
48445,1277,622,2,35,7,0,45,33,655
31023,14276,7102,89,406,79,97,269,146,7174
36871,1478,689,16,66,44,0,50,30,789
37345,2522,1250,12,90,4,12,30,56,1272
38482,1695,860,15,15,52,0,42,38,835
46165,1477,791,3,35,17,4,49,50,686
46407,11345,5235,90,274,156,55,424,195,6110
80241,33431,16871,307,1293,186,100,1342,268,16560
81424,1000,535,0,52,16,0,8,23,465
73030,4362,2221,11,174,22,1,129,31,2141
73432,1141,540,0,45,13,0,42,17,601
67135,3260,1682,15,66,52,7,83,34,1578
70086,2267,1083,4,54,10,18,40,86,1184
74740,2289,1157,21,59,46,4,74,19,1132
90248,11512,5664,76,331,118,62,393,126,5848
20004,1975,1030,21,197,55,0,97,9,945
21677,353,169,0,0,0,0,0,4,184
4032,8387,3936,15,236,86,57,225,141,4451
10069,5085,2354,25,326,29,40,313,98,2731
38868,5409,2700,8,143,45,0,129,111,2709
39111,9679,5115,40,245,91,39,247,127,4564
33549,18015,9254,127,452,305,19,516,357,8761
40031,25064,13974,472,1162,117,225,756,258,11090
49670,2109,1036,17,23,64,10,32,33,1073
50681,405,201,1,9,10,3,6,9,204
51037,423,202,37,19,3,0,12,1,221
52340,3083,1502,37,87,18,30,164,39,1581
67565,562,260,0,22,9,13,16,21,302
69151,804,409,16,18,13,5,14,12,395
62821,7175,3564,10,261,67,60,126,110,3611
58549,256,123,0,0,0,0,1,0,133
59448,743,387,7,24,12,5,24,14,356
48127,35690,17129,268,924,483,328,992,484,18561
54748,1323,628,0,6,5,7,10,56,695
56031,11846,6104,125,239,104,52,423,207,5742
73073,473,240,0,0,9,4,19,4,233
74931,1165,604,11,44,7,10,20,22,561
54873,2813,1395,1,47,61,24,39,54,1418
54968,2813,1390,16,50,34,13,78,57,1423
56034,446,245,0,15,4,3,14,4,201
36607,6270,3108,28,300,100,109,233,42,3162
30183,6279,3035,67,102,67,124,67,44,3244
31712,1084,530,0,26,13,0,53,1,554
33598,18226,9721,58,670,257,76,656,301,8505
44126,16372,8001,127,554,226,21,491,144,8371
52595,424,217,0,17,3,0,17,3,207
54856,1691,897,8,29,54,7,35,23,794
41603,1499,763,0,0,28,0,14,36,736
56043,468,254,4,5,9,0,11,10,214
36604,9567,4500,60,189,134,25,223,182,5067
29506,20823,9542,216,394,184,335,401,399,11281
45419,15097,7076,40,426,88,33,487,145,8021
47025,22710,10901,221,627,325,135,793,345,11809
5744,636,248,0,12,0,8,14,0,388
48197,68102,33665,897,2131,566,902,2401,740,34437
7626,8730,4237,0,175,57,0,378,163,4493
59477,477,320,0,0,10,0,13,5,157
12401,35339,16877,238,953,464,199,1108,561,18462
27522,11861,5986,43,171,162,129,194,221,5875
46567,8608,4402,5,264,144,18,248,121,4206
60611,32426,15207,86,1203,470,97,1376,556,17219
40162,6570,3392,0,190,13,45,176,62,3178
32561,9305,4888,38,296,94,0,481,178,4417
33436,44249,21003,217,1349,576,357,1366,507,23246
46122,16469,8123,35,557,180,111,415,160,8346
48653,10145,4952,27,181,166,35,197,241,5193
52751,1057,526,28,27,29,0,14,8,531
11901,27486,14138,124,1199,341,124,612,349,13348
27925,3991,2285,32,139,39,57,74,72,1706
22030,59466,29802,618,2118,419,857,2044,621,29664
11787,34099,16741,211,779,216,204,907,425,17358
36773,433,235,0,6,0,0,41,0,198
37047,2131,1079,8,72,17,0,95,44,1052
37160,33903,16497,222,1012,330,241,1265,291,17406
24277,6854,4045,57,393,48,14,132,124,2809
41044,897,430,12,31,8,0,57,0,467
41232,785,343,0,8,5,43,32,22,442
41621,142,83,0,0,0,0,0,0,59
43002,3744,1889,0,118,13,0,146,12,1855
934,79,45,0,0,0,0,0,0,34
19477,127,59,0,0,0,0,0,0,68
45377,15280,7571,71,326,181,42,473,206,7709
33308,27951,13919,23,637,640,27,547,501,14032
3870,5319,2680,18,144,156,0,151,79,2639
4623,910,456,5,52,6,9,40,23,454
7822,723,376,0,8,0,0,30,0,347
15078,465,215,0,18,0,0,0,0,250
15368,352,137,0,6,0,0,12,0,215
15429,332,175,0,0,0,13,0,0,157
17015,20900,10453,72,832,368,26,738,328,10447
30349,75514,35489,393,2642,616,368,2905,630,40025
32212,2499,1662,268,32,0,108,33,6,837
32340,11294,6269,80,459,75,64,333,172,5025
23413,1029,464,0,10,8,0,41,10,565
23480,314,183,0,2,0,0,7,0,131
23603,3966,2263,195,75,6,27,84,38,1703
23919,2420,1232,19,63,66,18,52,68,1188
11427,24037,11886,193,833,251,109,662,538,12151
20601,26401,12896,103,698,186,81,1062,271,13505
20650,14096,7317,54,323,181,47,321,247,6779
21048,10465,5212,30,232,98,8,231,148,5253
21653,108,48,0,0,15,10,5,0,60
17821,18356,8846,78,548,179,92,680,346,9510
28590,24613,11994,88,1030,309,68,906,354,12619
29137,1849,976,0,41,21,5,110,17,873
62526,32303,14666,147,815,384,245,862,496,17637
64738,949,503,2,33,31,0,14,16,446
65715,31,8,0,0,0,0,0,0,23
72626,1332,668,13,29,44,15,32,8,664
73705,330,254,28,0,0,10,0,0,76
76104,18327,8351,119,580,119,82,464,214,9976
76364,152,82,0,9,1,1,14,0,70
78059,5910,2787,37,116,144,6,76,65,3123
68979,1892,937,5,43,19,5,74,38,955
79415,17243,8921,311,443,12,373,391,138,8322
99141,5081,2623,12,91,87,0,132,108,2458
95669,2348,1163,0,42,41,13,57,66,1185
69152,807,399,0,9,22,0,9,15,408
70036,1052,639,0,15,19,0,0,35,413
76820,136,60,0,0,11,0,0,0,76
57375,657,356,0,24,20,0,6,9,301
62545,1169,590,2,29,28,0,63,0,579
63060,2079,1052,10,95,19,0,32,43,1027
75486,2099,1075,15,63,30,0,49,23,1024
83704,40385,19646,242,1589,419,402,1556,517,20739
98222,71,35,0,0,0,0,0,0,36
99633,464,261,4,19,4,1,11,9,203
99661,1389,727,0,48,9,0,59,18,662
99925,927,526,9,21,6,4,18,13,401
95531,23470,12672,48,1146,359,75,654,290,10798
96106,209,108,0,6,8,0,0,0,101
52576,560,339,0,31,7,0,12,11,221
53930,1359,699,5,45,18,8,33,13,660
55418,30211,15056,73,1390,377,58,1298,505,15155
41040,7222,3658,65,131,95,30,296,62,3564
43464,1377,531,12,33,0,11,114,63,846
38053,26545,12829,81,796,426,187,629,394,13716
21722,5667,2819,50,215,70,0,65,96,2848
22039,17947,8761,83,508,251,93,398,337,9186
22202,24913,12900,113,1461,89,100,1178,201,12013
54872,2733,1392,40,55,42,42,100,42,1341
55410,20358,9831,30,908,138,26,768,257,10527
55935,846,440,3,10,6,2,33,4,406
56358,3326,1720,17,96,55,13,94,41,1606
58426,242,123,0,8,0,0,13,4,119
73086,8687,4311,27,222,92,54,242,273,4376
49730,2214,1161,24,46,43,2,72,58,1053
31605,22289,10271,107,535,85,322,685,153,12018
33708,16098,8077,56,271,289,6,276,288,8021
38543,609,265,0,0,0,0,37,3,344
46410,38047,17642,299,1261,282,327,1269,421,20405
34103,12802,6044,56,145,228,41,150,315,6758
42122,5337,2493,9,155,110,13,281,138,2844
42765,6429,3161,30,254,67,87,129,67,3268
28650,11106,5908,112,486,126,75,303,193,5198
52653,3343,1686,46,68,49,7,160,53,1657
54027,998,504,3,36,14,0,34,12,494
73662,6447,3807,56,154,2,0,252,60,2640
73766,1302,636,0,43,0,15,37,35,666
4210,23064,11039,73,919,298,120,735,374,12025
4558,121,53,0,0,0,0,0,7,68
16313,1718,882,18,40,15,42,35,46,836
16505,16545,8034,62,436,284,23,380,325,8511
17112,35694,17688,145,1293,588,130,1133,651,18006
74344,15322,7646,44,267,220,78,281,277,7676
74535,101,45,0,6,0,0,5,0,56
76638,3064,1536,12,60,46,0,54,88,1528
81646,222,113,0,0,0,0,20,0,109
83232,622,302,0,18,7,0,29,4,320
77467,13,0,0,0,0,0,0,0,13
79096,2196,1123,0,52,19,18,94,4,1073
99614,613,312,6,8,4,0,20,4,301
99650,576,295,8,17,0,2,18,2,281
99764,439,247,0,5,10,0,0,2,192
95254,1151,630,0,0,0,67,0,57,521
95620,21854,11127,63,687,208,226,806,228,10727
95646,76,71,0,0,6,0,0,0,5
97026,4528,2476,94,148,40,0,106,79,2052
97212,26699,12647,92,1233,297,111,1185,346,14052
66054,2914,1425,2,63,117,0,133,77,1489
66062,80489,39765,469,3126,752,544,2947,792,40724
66403,808,398,5,11,5,7,6,14,410
67002,14730,7148,89,368,138,77,580,165,7582
29945,5232,2181,160,23,74,12,159,79,3051
10306,53142,24906,265,1158,545,308,1507,901,28236
10578,868,378,13,0,0,19,40,0,490
39737,167,50,0,0,0,0,0,0,117
40150,4596,2385,69,84,72,31,96,61,2211
70818,9466,4511,0,334,78,71,365,138,4955
71356,905,411,0,15,0,39,39,25,494
71675,1862,924,0,46,59,1,17,31,938
50861,272,149,0,4,4,0,12,12,123
21920,515,270,0,0,0,0,0,0,245
3049,7880,4175,0,16,87,30,89,209,3705
3215,183,107,0,5,9,0,10,4,76
6069,2411,1073,0,43,30,18,50,75,1338
6359,5341,2782,20,217,61,64,134,68,2559
14861,1310,619,16,39,8,7,48,46,691
14529,138,68,31,0,0,0,0,0,70
17774,1399,722,6,34,8,7,48,17,677
85704,32351,15428,211,906,322,253,758,619,16923
90004,61586,30602,462,2720,361,349,2286,818,30984
90019,66245,32342,724,2950,471,337,2648,887,33903
90058,2758,1284,27,99,0,34,84,2,1474
98108,23980,12107,164,830,246,76,1054,312,11873
95560,1466,856,2,16,0,0,117,55,610
95944,29,20,0,0,0,0,0,0,9
96084,458,190,4,0,3,0,10,8,268
53538,18593,8864,69,557,175,67,501,336,9729
67430,688,333,5,23,7,4,5,8,355
63084,19212,9688,61,446,242,42,706,209,9524
64432,136,33,0,8,0,0,6,0,103
19709,40802,19559,240,935,491,156,1584,572,21243
2180,22144,10815,139,831,305,43,779,279,11329
2564,247,152,2,0,4,0,13,0,95
3585,2666,1326,6,55,55,31,61,54,1340
15544,128,76,0,0,0,0,15,25,52
15948,696,337,25,0,0,18,15,0,359
16154,2459,1256,16,108,14,0,112,53,1203
7981,8989,4274,114,169,99,43,208,150,4715
23060,38211,18546,225,1349,455,208,1352,498,19665
29697,13430,6650,76,477,122,40,484,209,6780
8741,2640,1255,19,58,25,0,65,42,1385
10474,12127,6430,164,369,43,43,373,91,5697
45846,4297,2203,29,110,16,19,122,20,2094
46183,15,0,0,0,0,0,0,0,15
49048,25120,12407,264,649,211,228,805,357,12713
41425,1075,517,0,5,10,6,50,23,558
42027,1860,973,0,95,56,0,41,47,887
36727,6,6,0,0,0,0,0,0,0
38846,2592,1331,18,39,45,9,24,71,1261
57634,183,89,0,0,10,0,5,0,94
35016,16112,7775,136,346,338,149,430,305,8337
50533,3872,1972,53,103,46,66,117,17,1900
50627,3175,1648,30,71,55,0,63,64,1527
39464,2613,1353,0,25,86,0,109,40,1260
49056,3509,1854,16,93,71,53,103,46,1655
46060,40387,19726,365,1403,289,191,1583,492,20661
57068,1444,761,2,36,17,5,47,29,683
57237,705,341,0,10,66,0,7,22,364
5250,3605,1741,4,120,70,11,121,71,1864
2644,4340,2161,25,97,16,20,143,80,2179
93505,13606,7979,106,611,211,31,286,128,5627
89003,881,492,31,26,23,0,0,0,389
89131,48710,24230,404,1662,467,156,1688,621,24480
97489,961,554,21,6,35,0,14,13,407
85606,1040,533,9,31,24,0,20,14,507
76825,6798,3582,107,140,65,29,226,61,3216
77039,28385,14514,398,1036,160,381,1028,154,13871
77338,42787,21415,199,1463,412,313,1757,464,21372
77571,37360,18441,189,1149,320,187,1510,534,18919
80511,151,91,30,0,0,0,0,0,60
89421,578,328,3,11,9,3,9,4,250
4227,130,79,0,17,0,0,0,0,51
5079,681,329,15,13,12,0,32,12,352
15851,6688,3358,44,185,45,9,155,78,3330
16374,1793,949,3,42,24,0,71,31,844
17324,4206,2141,0,93,104,33,135,87,2065
1376,5123,2268,10,84,80,57,155,91,2855
47874,3102,1692,30,88,77,2,61,77,1410
6790,34653,17397,201,1053,446,154,1112,477,17256
12918,2208,1109,22,56,87,0,68,7,1099
29556,12089,5212,96,165,159,42,401,153,6877
92335,99284,49552,1031,3384,481,896,3229,718,49732
87042,3577,1746,0,53,0,0,30,34,1831
95442,3136,1619,24,73,90,0,69,46,1517
86305,18204,9127,166,396,423,0,285,319,9077
98443,5662,2841,18,172,84,8,180,112,2821
99352,31551,15152,108,834,410,129,1191,296,16399
8066,8563,4041,24,398,18,8,248,144,4522
8225,8344,3771,60,321,90,56,382,205,4573
10460,59505,27647,313,1695,402,407,1928,474,31858
10470,15432,7069,72,513,113,99,672,115,8363
4019,23,5,0,0,0,0,0,0,18
5083,288,139,0,15,4,3,16,0,149
6085,7548,3590,13,212,85,66,316,85,3958
26833,2141,995,23,121,31,0,77,24,1146
33945,0,0,0,0,0,0,0,0,0
35974,1514,728,0,40,12,3,49,66,786
37185,8428,4017,0,296,109,0,424,88,4411
22972,377,127,0,0,0,25,0,0,250
32124,5823,3860,51,397,65,71,192,34,1963
29543,582,269,0,0,6,12,27,0,313
24599,1131,599,0,0,0,0,0,28,532
24927,153,85,0,17,12,0,0,0,68
79765,14782,7198,48,629,203,82,582,148,7584
81427,1039,497,0,15,17,0,19,22,542
73727,203,75,0,0,0,0,0,13,128
94929,219,95,0,24,0,14,8,0,124
96707,47958,23437,321,1600,360,339,1768,689,24521
99017,148,69,0,2,0,0,0,1,79
99157,666,309,0,30,15,0,15,24,357
84319,8235,4268,59,363,30,54,267,103,3967
86018,860,432,0,13,26,0,38,39,428
76379,610,284,0,23,6,5,21,2,326
77470,465,247,0,0,2,12,0,13,218
60605,27519,13138,152,1367,121,314,913,328,14381
62966,15260,7253,69,502,157,55,478,326,8007
64057,14436,6852,78,425,164,93,358,157,7584
55388,5858,2807,15,263,65,18,270,95,3051
56652,604,321,4,10,2,0,7,9,283
57032,8066,4061,8,317,6,42,379,21,4005
57064,6393,3270,16,276,18,38,210,26,3123
47940,1742,846,25,70,16,8,44,12,896
48886,1912,1091,17,92,0,0,28,19,821
49709,3644,1900,8,57,108,1,90,86,1744
68524,6077,3149,0,227,50,33,259,46,2928
60431,23219,11746,157,670,226,118,776,257,11473
59068,3564,1736,0,67,73,9,112,95,1828
63147,9932,4797,93,162,113,92,305,155,5135
63934,195,83,0,0,0,0,0,0,112
64423,825,436,0,9,10,9,16,15,389
72753,9368,4573,27,221,162,19,314,59,4795
71019,8177,3808,15,211,71,33,304,110,4369
79517,203,119,0,9,10,0,5,9,84
95728,229,153,0,0,0,0,0,0,76
95830,902,509,23,2,2,0,0,18,393
88311,1259,724,0,47,43,0,26,30,535
38107,16120,7111,170,459,91,144,587,375,9009
39116,2075,1014,32,48,22,5,79,24,1061
43739,2179,1143,8,128,11,0,86,67,1036
45843,4117,2100,12,204,72,30,145,46,2017
47360,1333,634,0,84,30,6,43,20,699
35149,413,215,0,18,0,0,0,0,198
35801,23724,12286,130,836,288,108,627,412,11438
33469,15195,7540,92,227,224,20,313,374,7655
62674,1398,691,8,48,14,7,48,24,707
18326,4240,1948,0,42,19,98,117,90,2292
18445,2775,1481,21,56,4,29,40,55,1294
18842,271,136,0,12,3,0,12,16,135
71033,3482,1822,0,140,13,65,161,81,1660
71847,596,355,3,2,17,0,0,14,241
56681,274,136,2,4,9,0,0,7,138
52231,199,99,0,11,5,7,9,2,100
53002,2383,1161,16,87,9,42,52,38,1222
44214,2267,1265,23,124,62,1,14,10,1002
46001,9948,4899,70,242,92,99,268,298,5049
46148,5526,2875,58,159,91,47,210,54,2651
46703,18292,9278,300,332,246,74,439,196,9014
49349,7826,4131,41,231,116,39,180,137,3695
49615,3806,1890,23,68,50,8,84,71,1916
53042,6745,3273,29,169,55,21,157,94,3472
37604,35754,17551,406,975,434,399,868,626,18203
57259,432,229,4,7,4,2,13,2,203
59101,41440,21200,333,1314,456,189,1486,564,20240
38578,158,56,0,0,0,0,0,0,102
55101,7234,3817,32,431,106,33,303,71,3417
29225,1308,210,7,0,0,68,0,0,1098
30107,14606,7741,46,305,212,0,560,209,6865
31624,1468,702,0,21,3,0,60,22,766
18220,304,162,8,15,16,0,7,11,142
18433,6624,3224,40,298,78,62,304,141,3400
20708,27089,13447,93,1126,180,204,994,274,13642
12817,2119,1134,12,0,50,0,32,61,985
13338,1121,571,0,17,31,0,7,30,550
13491,3617,1835,17,120,46,4,134,45,1782
15007,337,164,15,0,14,0,0,13,173
16508,16046,7627,61,551,151,71,391,249,8419
27524,13916,6764,40,471,120,47,356,161,7152
10312,61741,29882,224,1851,746,341,1821,777,31859
12306,26599,12931,226,943,315,68,738,434,13668
6280,2723,1236,0,19,21,30,7,97,1487
6897,18542,9314,118,479,289,84,507,317,9228
54469,1645,780,13,25,29,0,56,33,865
45636,120,80,0,0,8,0,0,0,40
15628,728,399,3,38,9,5,26,0,329
16127,15669,7894,238,330,195,417,332,211,7775
31062,499,452,0,6,24,0,0,0,47
31085,1292,654,0,34,13,9,36,12,638
32399,0,0,0,0,0,0,0,0,0
33130,27818,13892,227,1298,282,46,1403,199,13926
19133,27419,13391,244,679,51,202,1160,387,14028
34112,27543,13520,65,741,502,73,604,347,14023
11972,1171,660,0,23,0,6,6,15,511
3455,2295,1162,38,42,5,3,67,41,1133
987,57181,26509,659,1606,470,380,2209,555,30672
47531,701,405,0,0,22,11,20,0,296
47995,1732,850,24,39,21,16,40,20,882
40464,1428,766,0,10,31,0,64,70,662
43802,1008,550,34,29,7,0,36,14,458
44264,3073,1497,3,103,43,14,141,30,1576
45682,2090,1152,0,81,27,9,58,26,938
45876,705,368,0,24,3,0,13,4,337
46013,16988,8122,125,276,205,67,473,252,8866
38049,4093,1975,20,99,22,7,154,74,2118
38581,3895,2017,61,58,71,43,165,33,1878
49721,14245,6973,100,436,252,50,336,288,7272
87357,818,396,8,33,8,4,13,3,422
94061,39624,19400,383,1697,224,96,1425,655,20224
52739,556,306,7,16,15,0,34,0,250
55129,25248,12342,43,805,149,28,1089,313,12906
60423,30938,15173,172,851,302,183,715,440,15765
62087,2172,1102,15,37,0,3,51,20,1070
68178,1526,640,8,0,0,12,0,0,886
74856,818,395,2,16,12,7,26,27,423
76140,30661,14687,152,1223,150,78,1064,312,15974
76240,27419,13677,189,650,278,188,604,411,13742
77067,34575,17083,269,930,158,315,1263,282,17492
77080,45832,23138,113,1987,172,271,1519,452,22694
79316,11333,5944,78,444,50,67,303,101,5389
56571,1827,962,5,51,70,0,60,39,865
72413,478,251,1,37,0,0,9,12,227
74006,27191,12844,83,731,362,149,742,357,14347
87512,63,26,0,0,26,0,0,0,37
97622,499,263,0,0,14,0,9,34,236
97641,1286,674,0,40,86,0,33,43,612
98629,8689,4349,56,259,143,73,260,143,4340
98649,1085,526,15,62,18,0,23,26,559
99747,178,107,3,0,0,2,0,0,71
96704,7871,3932,0,200,153,23,158,163,3939
90066,59394,30186,467,2776,593,232,2453,690,29208
92833,52922,26245,248,1735,331,222,1901,595,26677
29714,2902,1348,33,58,29,10,164,87,1554
29905,3083,2532,276,7,0,16,4,0,551
39668,906,317,0,0,65,0,29,0,589
44656,2836,1415,0,82,24,0,96,155,1421
44841,619,335,2,11,0,12,26,4,284
33607,23813,10947,97,931,201,112,1096,361,12866
98248,24475,11563,120,641,403,148,953,196,12912
98596,7558,3700,29,199,150,20,233,100,3858
99647,20,12,0,0,0,0,0,2,8
80535,2613,1293,10,77,40,0,97,50,1320
82836,908,521,0,40,19,0,18,13,387
927,13351,6314,133,576,215,147,337,265,7037
38452,1330,703,0,25,9,16,37,29,627
40107,2385,1132,0,17,42,21,68,63,1253
57201,25277,12592,80,875,313,118,771,300,12685
59007,270,106,0,5,0,0,8,1,164
59019,4544,2140,8,190,56,15,135,72,2404
54652,1005,524,4,28,14,5,39,8,481
54859,1698,867,0,10,32,0,20,39,831
50064,165,93,4,1,0,7,1,1,72
42103,20610,10461,47,656,156,21,847,264,10149
42171,7230,3554,55,159,98,15,237,22,3676
42728,17032,8363,199,435,166,124,348,343,8669
62449,3118,1495,4,50,37,29,75,53,1623
31313,40916,20028,372,1254,307,435,1204,392,20888
31711,967,455,0,25,11,2,58,28,512
20037,14559,7150,983,463,112,669,372,98,7409
20776,3149,1485,32,50,71,83,6,84,1664
22730,175,81,0,0,17,0,0,0,94
16821,303,148,0,0,0,12,0,0,155
13620,2245,1045,18,51,8,0,60,20,1200
35978,4789,2453,0,234,79,0,68,101,2336
37218,15198,6901,66,452,201,112,535,341,8297
17508,530,230,0,16,0,0,28,0,300
19504,5126,2593,6,109,51,28,81,100,2533
28745,461,174,0,14,0,0,0,0,287
93420,30136,14333,245,722,642,93,1014,429,15803
15454,144,80,0,0,0,0,0,0,64
17056,23,12,0,0,0,0,0,0,11
36269,1535,677,0,33,9,0,50,10,858
28374,17190,8310,0,383,411,25,450,254,8880
31567,842,474,0,12,7,0,12,10,368
31747,156,77,0,3,2,0,5,0,79
8530,7458,4119,108,171,149,20,192,142,3339
11596,10561,5139,102,233,96,47,328,165,5422
12210,9706,4622,0,242,78,112,222,146,5084
13348,1419,764,12,28,14,5,48,18,655
1852,34939,17060,135,1377,419,205,1331,332,17879
3838,1184,652,0,0,118,0,62,13,532
70094,30445,14577,137,1070,347,98,1016,536,15868
72434,2065,1060,52,43,11,0,63,29,1005
73503,10882,6770,412,285,0,150,230,0,4112
73754,1060,527,3,39,31,2,49,12,533
48411,145,70,0,0,0,0,0,0,75
49052,939,417,13,27,4,2,30,20,522
50006,1651,837,0,20,12,9,42,12,814
50074,422,240,0,6,16,0,0,7,182
51038,1684,906,36,74,23,9,14,50,778
78663,846,448,9,40,0,0,71,32,398
88314,56,0,0,0,0,0,0,0,56
74578,6138,3006,112,132,66,45,177,97,3132
75855,2968,1473,0,81,128,32,72,35,1495
76649,635,268,0,8,8,6,9,13,367
68005,23094,11552,251,714,289,121,689,332,11542
40069,8564,4080,81,235,100,39,229,67,4484
67470,455,223,0,31,0,0,0,1,232
75415,190,89,0,0,0,0,0,0,101
76070,853,434,0,0,66,0,51,0,419
80726,490,275,0,28,0,0,13,0,215
85021,42002,20770,305,1837,395,296,1614,424,21232
59522,1775,872,0,59,40,13,59,64,903
62277,1363,733,19,58,10,0,22,23,630
62349,626,298,0,34,1,5,26,5,328
56264,2187,1121,9,67,23,2,65,30,1066
25022,364,151,0,0,0,0,0,0,213
25314,13763,6843,69,421,221,74,435,184,6920
14837,5779,2677,45,158,71,61,117,114,3102
21013,4608,2374,42,109,61,26,92,121,2234
22713,1567,721,0,32,21,35,15,21,846
22820,219,128,0,9,0,0,10,0,91
7621,27372,13053,280,911,306,230,1013,324,14319
10994,7326,3520,24,176,114,26,158,165,3806
11968,10667,5059,75,227,175,36,240,266,5608
23421,3884,2215,9,167,13,130,98,11,1669
4285,369,190,0,0,15,0,1,7,179
4457,5787,3035,7,157,63,5,86,94,2752
1379,830,432,2,35,10,5,9,22,398
24266,9179,4216,119,353,220,65,215,266,4963
75968,1846,945,21,60,10,0,72,79,901
84031,229,141,18,2,0,9,6,0,88
84043,62382,31333,333,2977,145,283,2661,354,31049
77081,52078,27759,245,2945,243,154,2128,282,24319
59416,273,172,0,23,20,0,17,4,101
16602,29113,13942,97,936,278,147,945,462,15171
18237,3386,1670,29,121,19,16,107,29,1716
18444,13615,6710,47,464,165,43,432,266,6905
24918,2158,1222,0,76,50,0,54,15,936
6098,12374,6507,29,305,271,0,253,246,5867
8084,6950,3317,19,215,96,39,243,76,3633
11765,723,360,0,15,20,0,12,20,363
28350,128,81,0,3,0,0,4,0,47
24112,29522,13907,201,846,357,164,795,553,15615
14062,3248,1672,6,81,31,11,98,31,1576
4280,6744,3268,15,157,68,0,201,57,3476
34221,44294,21792,156,1184,586,542,1178,718,22502
34242,7706,3789,0,72,152,30,83,147,3917
35034,6030,4121,25,360,26,56,198,32,1909
25264,328,194,0,0,10,17,0,0,134
41606,986,397,0,8,0,38,26,10,589
43713,7066,3286,24,161,100,79,306,145,3780
39119,5073,2530,0,56,93,10,167,112,2543
46570,1039,475,7,34,0,8,31,15,564
29412,40275,19366,126,1636,316,126,1455,534,20909
30708,234,111,0,16,0,0,0,0,123
33034,23281,12004,188,904,148,82,679,433,11277
33460,32688,17152,170,1716,251,228,1061,412,15536
97016,6122,2826,11,115,59,8,203,63,3296
83636,131,36,0,0,0,22,0,0,95
77706,29792,14720,278,1196,445,205,879,325,15072
88336,461,273,0,24,0,0,13,13,188
89010,487,212,0,6,6,11,40,22,275
63882,356,156,5,15,1,1,13,3,200
65244,379,173,0,3,1,0,17,6,206
56316,1466,729,8,34,23,2,58,22,737
56684,320,177,7,9,7,0,5,1,143
59001,1384,660,4,16,29,17,15,32,724
66212,32518,15200,38,1201,297,143,1207,418,17318
67460,14973,7708,149,299,162,38,355,187,7265
68328,492,255,0,5,0,0,19,3,237
59465,40,19,0,0,0,0,0,4,21
54837,3744,1984,19,84,103,7,94,61,1760
68008,12001,5595,82,352,89,30,429,165,6406
68756,1922,911,15,49,20,10,58,41,1011
71943,4548,2122,0,61,55,21,235,111,2426
79527,191,93,0,3,0,0,5,0,98
61427,2192,1073,25,32,33,16,74,40,1119
72832,1167,616,8,38,13,4,57,22,551
84074,50853,25132,440,1981,402,377,2283,677,25721
85310,19649,9646,143,438,201,32,425,285,10003
86052,255,169,0,0,44,0,43,0,86
80480,1251,609,0,14,8,0,3,25,642
64769,632,324,2,29,2,0,41,5,308
75442,9681,4922,96,334,79,0,306,122,4759
76053,30939,15427,160,1226,146,168,945,406,15512
97487,8878,4246,33,300,126,0,300,128,4632
97869,833,409,8,38,11,14,5,5,424
99027,6412,3085,50,138,89,77,171,55,3327
99328,3709,1775,21,121,111,7,93,81,1934
87731,244,131,0,0,33,0,0,33,113
96738,6728,3290,4,217,119,12,167,181,3438
2841,1632,1405,40,217,0,13,40,0,227
4634,1808,941,0,24,27,13,60,34,867
6444,158,74,0,0,0,0,0,0,84
33180,31883,15259,107,1078,302,137,1296,570,16624
14858,1382,731,4,34,5,0,36,37,651
15221,30309,13199,166,658,325,236,1134,679,17110
17074,7092,3558,37,175,105,36,213,105,3534
17322,5910,2931,35,139,30,40,120,168,2979
23315,1346,673,0,61,54,16,0,24,673
24013,8473,3894,42,206,138,60,252,145,4579
24330,3114,1528,0,156,46,8,88,48,1586
21085,16177,7936,30,498,201,210,467,279,8241
19736,69,0,0,0,0,0,0,0,69
21130,296,176,0,12,0,0,67,0,120
78416,15635,7310,176,435,225,62,337,427,8325
64493,558,269,0,18,0,0,12,22,289
67548,1262,615,0,21,18,0,18,28,647
74601,19051,9543,150,695,123,172,675,252,9508
75758,8119,4218,92,186,155,43,224,139,3901
77011,17803,9756,89,716,78,124,562,249,8047
70663,27226,13553,401,887,302,94,722,386,13673
71765,1748,808,0,22,31,0,9,27,940
56364,5622,2854,43,176,68,26,167,69,2768
94040,35845,18914,160,1481,220,90,1392,381,16931
94538,68111,34224,258,2824,491,342,2435,757,33887
99778,225,140,9,8,2,0,13,2,85
95642,6826,3160,12,207,54,5,198,90,3666
96781,1229,549,0,13,25,0,24,49,680
68440,86,55,0,0,0,0,0,0,31
70115,34181,16806,113,1568,355,107,1404,573,17375
44108,21939,10217,220,370,253,118,593,434,11722
44405,7969,4026,35,152,66,40,173,102,3943
52321,426,179,2,27,2,4,2,1,247
53598,2675,1282,0,80,50,18,131,0,1393
15477,865,412,0,18,23,7,16,12,453
16214,9987,4794,192,289,88,260,248,212,5193
16312,3,0,0,0,0,0,0,0,3
16354,10902,5388,116,360,118,133,291,148,5514
10596,1310,738,12,66,8,20,40,11,572
11930,893,451,0,25,24,0,15,52,442
12173,2100,1138,0,74,28,7,50,45,962
6024,402,178,0,0,32,0,25,33,224
59219,298,135,9,2,2,0,9,4,163
59725,7999,3989,183,221,96,59,253,158,4010
62958,2146,1128,22,73,13,0,53,25,1018
62960,10959,5087,71,377,104,8,354,244,5872
68452,64,37,0,0,4,0,3,0,27
71449,9024,4366,51,167,129,10,332,149,4658
66966,739,406,35,13,11,7,23,8,333
67758,1144,572,22,26,29,0,12,14,572
81129,73,34,0,0,0,0,0,0,39
82219,8,0,0,0,0,0,0,0,8
83323,1611,898,8,39,8,0,53,47,713
30449,163,85,0,8,2,0,16,2,78
25304,8144,3755,91,213,166,60,124,145,4389
20745,28472,13261,67,1128,198,186,1244,259,15211
22850,1113,499,0,32,11,0,15,8,614
29455,22024,10272,55,860,294,104,834,433,11752
12852,428,213,4,3,2,3,6,3,215
28273,39483,19078,220,1503,382,207,1584,282,20405
28429,7525,3857,127,323,117,0,217,174,3668
51551,1744,908,14,42,33,11,58,33,836
53011,2185,1131,3,63,25,3,88,21,1054
37214,30151,14306,111,1397,258,124,1216,312,15845
37331,7430,3562,27,166,114,13,291,96,3868
14527,12951,6345,76,305,124,106,322,179,6606
2807,827,378,0,0,0,0,19,8,449
94566,45910,23014,178,908,313,55,1466,625,22896
87710,1492,773,0,72,57,7,19,46,719
88001,36800,18664,1173,1034,304,702,1227,304,18136
92242,1306,651,8,18,18,0,20,41,655
99549,78,50,3,5,0,0,0,1,28
67364,347,172,0,14,5,4,10,2,175
63531,348,161,1,10,1,0,17,0,187
63747,472,223,6,29,5,0,25,4,249
65040,1365,673,0,32,19,0,35,10,692
81647,7333,3516,0,309,42,0,362,155,3817
85383,50308,24351,142,1704,537,248,1787,690,25957
76182,31031,15016,162,966,432,144,959,579,16015
76690,1063,588,26,31,0,6,29,3,475
61043,76,45,0,0,0,0,0,0,31
78264,11174,5653,38,269,79,51,330,174,5521
78954,1083,510,0,0,12,0,19,59,573
80754,177,102,0,5,0,0,3,0,75
70090,7197,3557,29,275,53,19,152,92,3640
71345,182,101,0,0,0,0,22,0,81
36022,12141,6126,108,421,105,169,332,127,6015
48040,9739,4549,72,232,145,51,243,164,5190
48177,178,97,0,10,0,0,10,0,81
49045,5279,2669,13,160,98,26,146,55,2610
3034,4033,2056,19,81,54,0,55,163,1977
4047,1899,957,0,50,23,0,18,55,942
4962,190,118,0,0,0,0,0,0,72
5261,2522,1288,52,64,25,14,36,33,1234
7052,47210,22569,254,1550,458,297,1287,921,24641
15784,71,34,0,0,4,0,3,0,37
16372,443,215,0,10,0,0,25,6,228
16670,54,34,0,0,0,0,0,0,20
17103,12080,5442,47,145,75,89,356,137,6638
10567,20563,10147,131,335,242,38,379,306,10416
11980,5604,3222,24,403,54,0,186,60,2382
12973,86,44,0,0,0,0,0,0,42
1224,210,84,0,0,0,0,0,0,126
1824,25955,12803,81,887,262,95,774,452,13152
19703,14652,6982,23,521,119,45,611,213,7670
99746,404,195,0,17,6,0,8,6,209
77551,21861,11243,155,1015,155,116,617,237,10618
77584,87986,43141,415,3713,656,450,4538,882,44845
80104,30718,15174,191,864,404,123,1087,305,15544
85742,27899,13498,265,992,390,329,1086,472,14401
67054,1250,624,4,31,17,4,20,23,626
71327,5792,3538,62,341,49,1,129,0,2254
72108,72,46,0,0,0,0,0,0,26
74054,800,416,7,24,6,0,22,1,384
3079,29133,14366,174,830,385,89,856,379,14767
4029,1598,876,0,74,34,0,29,29,722
4609,5425,2763,58,153,188,44,158,111,2662
10708,21935,9870,120,785,166,276,690,308,12065
59741,4617,2287,0,152,63,24,175,108,2330
53063,1604,820,0,54,22,11,43,26,784
28530,6457,3180,28,232,102,74,226,134,3277
29643,2088,1133,20,56,46,0,56,38,955
30096,67959,32060,290,2516,497,410,2425,896,35899
13665,703,404,5,28,3,0,20,19,299
14772,4108,2040,26,73,48,27,101,58,2068
45359,1938,961,29,57,10,4,48,21,977
98033,39075,19288,145,1545,354,153,1732,508,19787
98645,1355,715,0,23,6,23,42,5,640
55373,5820,2813,7,222,67,20,315,43,3007
55807,9543,4667,4,366,115,34,346,148,4876
63636,641,298,0,21,6,17,29,24,343
63665,270,133,7,10,6,4,8,10,137
48473,22060,10569,67,737,280,132,663,367,11491
46048,2191,1013,0,129,29,0,137,6,1178
49460,8658,4591,79,206,110,6,237,66,4067
50135,1522,775,4,19,10,23,35,39,747
43617,7268,3628,29,132,114,89,277,123,3640
34452,11400,5553,53,270,258,112,238,170,5847
98243,652,343,0,32,19,0,10,14,309
98611,9365,4543,9,275,128,43,193,145,4822
99730,49,24,0,5,0,0,0,0,25
94705,13365,6520,122,503,129,68,396,211,6845
91950,62639,31449,790,1965,538,475,1951,718,31190
92586,20032,8872,182,306,255,148,438,471,11160
3284,843,449,14,18,37,0,6,11,394
4040,3191,1636,0,97,78,0,92,27,1555
6243,131,83,0,0,0,0,0,0,48
7423,4101,1870,0,98,28,38,86,57,2231
31098,3649,2006,59,182,6,28,124,7,1643
31211,15488,7263,209,512,152,82,536,229,8225
32136,7933,3812,12,100,184,67,97,185,4121
47871,246,119,0,8,1,5,13,2,127
48081,20626,10090,148,484,308,56,570,356,10536
48233,0,0,0,0,0,0,0,0,0
49333,11432,5739,41,419,178,34,390,164,5693
38857,3933,1946,0,219,22,7,170,62,1987
26585,444,260,0,0,37,0,6,35,184
28072,1292,666,0,35,18,6,12,12,626
17835,373,172,0,16,0,0,18,0,201
28652,0,0,0,0,0,0,0,0,0
29378,175,74,0,0,0,0,0,17,101
12837,1059,578,0,34,2,0,26,14,481
12453,291,135,0,19,7,0,0,0,156
13021,38114,18656,192,1117,478,207,946,529,19458
4538,1942,861,11,12,10,0,45,60,1081
75751,16855,7971,92,611,187,141,401,154,8884
76641,1688,861,28,15,28,17,32,23,827
77801,15115,7791,712,444,31,490,516,99,7324
44652,32,16,0,0,0,0,0,0,16
62882,2387,1209,1,51,25,19,78,40,1178
71006,13061,6327,97,336,60,10,502,272,6734
27531,779,658,99,0,0,0,0,0,121
28634,5230,2509,34,129,82,28,89,57,2721
55445,12142,5953,42,425,91,42,528,274,6189
55741,3558,1775,18,86,58,0,61,56,1783
46161,2958,1426,4,67,23,15,84,30,1532
18818,1202,621,5,33,42,10,23,18,581
20721,29811,13992,368,551,442,179,714,594,15819
49625,1164,568,8,45,28,9,35,28,596
51243,826,440,0,29,9,0,9,10,386
54202,1311,670,2,43,25,8,32,34,641
54234,1568,772,0,21,22,20,34,41,796
80603,13504,7089,103,561,108,0,564,242,6415
85323,42812,20684,380,1679,309,192,2061,415,22128
85349,30795,16051,507,617,309,120,767,387,14744
95454,2198,1015,3,69,53,3,72,89,1183
78731,27175,12909,110,758,208,84,867,460,14266
88072,1935,1114,0,0,17,49,80,0,821
61467,1170,605,6,52,23,5,36,28,565
61540,2770,1360,44,82,34,10,98,78,1410
15337,627,341,3,36,8,4,29,10,286
16616,122,70,0,3,3,0,4,6,52
21153,316,143,0,0,0,0,0,0,173
22952,2053,1001,0,28,27,20,74,0,1052
23703,25941,12445,111,767,350,120,980,299,13496
10305,42298,20145,357,1585,503,257,1666,622,22153
18929,9624,4646,27,225,57,53,288,355,4978
19522,14209,6964,123,294,221,65,237,273,7245
19534,1810,961,13,50,44,0,34,38,849
40855,780,393,0,20,16,5,19,19,387
44503,1130,758,8,62,9,9,0,32,372
35061,1212,652,5,21,0,0,43,29,560
36262,1427,868,29,19,14,15,30,14,559
28027,63423,30415,271,1991,492,292,2406,652,33008
95551,1374,654,10,35,27,2,38,48,720
98275,21264,10395,41,812,208,117,556,556,10869
85254,46333,22510,205,1443,670,145,1485,720,23823
86053,2287,1151,16,40,7,39,61,20,1136
75180,23711,12083,331,789,166,165,726,238,11628
68340,888,441,9,22,13,6,30,6,447
68631,445,214,0,7,2,0,6,0,231
68950,386,203,10,6,8,0,6,1,183
57213,738,414,11,6,16,0,36,11,324
51053,1015,528,1,30,18,10,17,27,487
52043,2158,1045,5,71,33,0,56,27,1113
64090,110,56,0,9,0,2,3,4,54
65473,15882,10999,995,377,0,144,301,16,4883
45171,5771,2902,55,126,43,33,139,85,2869
70002,20748,9736,79,621,133,77,702,263,11012
54421,3551,1794,27,90,35,16,80,52,1757
54563,759,381,0,20,0,0,15,12,378
54850,202,99,0,6,13,0,2,8,103
48897,1448,696,6,31,17,3,46,8,752
61851,295,147,3,9,0,0,23,3,148
41267,939,466,10,13,4,13,4,36,473
34119,31632,15286,64,495,416,46,693,331,16346
36017,2936,2000,27,230,36,6,73,8,936
37186,9353,4565,43,247,51,81,273,167,4788
28119,2453,1333,0,101,73,0,88,83,1120
31735,715,334,18,7,0,6,17,68,381
24598,1668,884,11,28,64,13,42,70,784
32456,8437,4441,20,305,141,23,155,184,3996
33156,34167,17428,270,1034,332,266,747,488,16739
72411,2465,1223,10,93,32,13,87,11,1242
74364,1847,886,2,45,31,2,44,29,961
74631,7482,3574,19,278,110,67,206,91,3908
83552,762,345,4,6,8,0,5,68,417
86314,38932,18614,144,931,533,84,1023,532,20318
97345,580,285,0,38,5,0,42,0,295
16838,1833,926,9,34,13,1,42,19,907
6360,36632,17671,253,1113,339,205,1212,579,18961
6514,27175,12720,427,726,204,378,996,369,14455
7106,33583,15326,401,1107,211,369,1228,374,18257
7825,9489,4773,32,160,142,58,242,142,4716
12565,1165,527,5,52,18,43,9,0,638
23457,4263,2225,36,147,65,12,59,104,2038
13656,3108,1614,33,67,30,26,97,33,1494
14806,2015,1065,4,47,18,0,101,32,950
74831,722,367,3,21,19,15,21,9,355
77386,54802,26251,423,2663,462,191,2496,446,28551
77486,7563,3675,49,121,163,84,219,196,3888
79350,422,219,0,15,8,0,7,0,203
79908,5907,3733,402,116,0,16,88,0,2174
97459,13427,6800,11,448,271,63,339,177,6627
87375,3171,1512,22,78,40,14,85,48,1659
91701,40034,20040,372,1021,484,302,1297,637,19994
98952,2502,1300,50,38,16,13,43,20,1202
34688,6497,3098,32,146,145,16,123,188,3399
44856,263,145,0,0,1,2,5,1,118
46319,17781,8948,15,755,202,150,505,274,8833
42376,5998,3153,21,177,53,36,247,67,2845
3864,1801,939,4,35,10,0,35,38,862
4422,1409,809,0,33,13,5,22,36,600
6423,5342,2765,11,102,133,9,106,63,2577
23440,524,255,12,0,7,0,13,2,269
18403,7179,3321,27,189,36,26,150,112,3858
19317,9910,4797,0,179,158,60,320,131,5113
13678,276,180,0,0,0,0,0,0,96
15849,1281,642,0,27,15,6,28,9,639
11356,23362,11624,143,776,278,21,694,231,11738
86435,15,8,3,0,0,0,0,0,7
87530,1110,575,0,0,0,0,0,0,535
20052,751,403,83,19,0,47,0,0,348
20181,9445,4683,121,243,95,54,212,150,4762
60557,157,81,0,0,0,0,0,0,76
64455,314,140,0,11,0,0,6,3,174
78229,31771,16492,306,1388,171,234,1166,347,15279
68937,1554,734,2,37,38,22,41,35,820
72751,7218,3656,0,249,64,0,194,113,3562
73049,5858,3002,6,268,82,27,237,108,2856
83826,0,0,0,0,0,0,0,0,0
84712,109,63,0,2,0,0,0,0,46
85215,16929,8219,16,382,232,28,365,266,8710
59003,1343,629,16,36,24,0,41,4,714
59747,177,96,0,6,4,0,7,6,81
56733,356,198,0,16,8,0,9,4,158
57248,971,540,3,23,22,2,12,22,431
58058,90,45,0,0,0,2,0,0,45
50154,424,203,0,20,8,7,13,5,221
50471,573,250,9,10,13,2,11,12,323
41712,376,157,0,0,0,0,0,0,219
42285,334,145,0,0,0,0,0,7,189
33904,31859,15525,46,652,614,123,478,589,16334
36340,5721,2541,52,59,33,70,190,72,3180
47147,1131,562,25,104,0,0,33,0,569
38329,3643,1905,30,138,56,3,154,77,1738
61321,248,102,13,4,8,0,7,2,146
62442,2814,1385,4,82,30,18,68,31,1429
62668,1251,585,4,20,6,0,40,30,666
70085,4611,2412,33,163,38,42,147,50,2199
73736,445,235,0,5,4,0,18,4,210
74728,11342,5503,75,338,80,68,382,135,5839
75224,37280,18250,476,1139,203,467,1174,498,19030
75454,9583,4036,60,308,26,51,449,40,5547
75558,1770,791,0,116,31,0,30,53,979
75691,3587,1912,0,143,61,23,96,26,1675
59015,413,198,0,15,5,0,16,7,215
18824,1527,785,11,41,36,0,35,44,742
18917,2123,1091,0,59,26,11,64,18,1032
13856,6009,3106,23,69,71,19,189,70,2903
15024,8672,4247,63,230,186,5,256,131,4425
28080,7941,3997,62,244,130,19,343,61,3944
30276,15245,7645,157,629,260,36,457,188,7600
33713,32350,16265,281,1099,441,73,1000,467,16085
37821,22121,10574,142,526,599,114,524,229,11547
37917,24286,11607,354,665,221,219,876,299,12679
47243,6053,3178,181,264,66,100,232,79,2875
53143,23466,11397,107,937,153,281,1001,171,12069
53810,356,179,2,10,5,9,10,6,177
48420,21607,10615,140,685,318,143,646,418,10992
53024,17013,8319,84,433,144,123,735,277,8694
13469,926,472,0,6,0,0,6,0,454
14111,3337,1704,9,90,19,26,56,43,1633
17069,128,71,0,5,4,0,5,3,57
22931,324,173,0,1,7,0,0,0,151
23872,2757,1173,2,26,26,166,46,34,1584
3261,4343,2091,9,160,88,0,156,67,2252
3574,2568,1224,0,34,25,0,99,81,1344
4849,3693,1807,28,91,38,0,129,70,1886
5340,602,311,0,17,15,0,9,33,291
7603,8362,3949,23,340,53,100,299,155,4413
8755,25835,12247,158,671,246,112,572,363,13588
10304,41064,20233,431,840,394,274,1441,727,20831
11414,29219,13929,178,851,233,206,1098,298,15290
26134,1038,516,19,33,12,0,14,5,522
29338,26,13,0,0,0,0,0,0,13
26508,33523,16723,313,1170,331,171,902,457,16800
75058,2564,1288,25,46,39,3,52,45,1276
76673,1697,858,0,29,5,0,20,5,839
84405,32271,15270,313,1166,258,244,1143,319,17001
84738,8517,4038,26,226,138,27,222,192,4479
13619,10640,5153,86,277,64,17,220,63,5487
13902,6149,3222,298,12,0,329,0,0,2927
14802,4251,2324,279,11,8,283,13,15,1927
15347,641,231,0,0,0,0,0,13,410
23937,2154,1027,19,65,18,0,88,9,1127
75846,2909,1495,28,190,54,0,84,38,1414
80481,537,293,0,13,0,0,23,13,244
95545,101,67,3,3,3,0,3,0,34
96819,53886,27759,489,1769,554,248,1681,630,26127
97329,226,111,0,0,0,0,0,0,115
48701,1470,747,6,58,20,15,59,16,723
49306,10594,5782,29,370,158,60,384,54,4812
10549,16465,8895,211,437,141,15,181,164,7570
25071,11477,5813,127,279,102,14,342,196,5664
28771,8095,3946,13,149,155,72,184,165,4149
41003,2327,1218,7,77,28,11,45,55,1109
67748,2227,1078,17,78,24,8,72,42,1149
69345,441,232,0,15,2,0,26,2,209
60960,1092,574,17,13,14,2,11,25,518
99540,284,205,29,12,0,0,0,15,79
99654,62135,32691,469,2462,535,322,2099,905,29444
95388,14242,7583,44,361,120,10,392,97,6659
68655,203,123,0,0,7,0,21,0,80
69149,760,382,0,10,16,15,19,17,378
76548,30329,15275,279,1282,211,71,1011,294,15054
78228,62126,30051,612,1763,526,494,2126,742,32075
90660,63380,30971,456,1999,548,382,2343,819,32409
91344,53266,26652,331,1279,644,406,1536,634,26614
75421,492,272,0,0,7,1,4,37,220
84664,9350,4803,40,261,101,37,333,46,4547
64804,35602,16993,174,1040,370,193,1110,307,18609
67036,61,25,0,0,4,0,1,10,36
86444,986,506,12,20,30,0,0,9,480
73033,484,228,5,9,4,5,13,11,256
73703,30331,14851,74,1096,236,98,769,346,15480
47512,4015,1852,10,152,52,33,204,80,2163
48039,7604,3806,63,153,80,75,196,160,3798
39090,12809,5914,24,402,71,27,417,175,6895
59462,172,91,0,4,3,0,0,0,81
61541,91,40,0,0,0,0,5,8,51
62002,31059,14535,69,869,275,152,990,477,16524
64145,5249,2301,33,162,42,20,194,88,2948
55338,1155,609,10,41,9,3,58,13,546
55423,36186,18224,102,1684,334,136,1234,435,17962
56021,1058,545,7,33,7,0,23,15,513
56715,325,163,0,18,2,3,15,6,162
57322,413,244,14,11,9,0,2,0,169
57536,359,210,4,6,8,0,4,10,149
50566,450,228,0,18,14,0,9,2,222
23307,570,261,0,13,0,0,40,33,309
30530,6330,3085,32,117,72,0,218,77,3245
32038,10103,4979,74,278,108,63,280,163,5124
35552,887,457,30,38,7,0,24,0,430
36320,3708,1819,25,114,28,16,108,32,1889
36852,2317,1168,41,34,14,2,96,41,1149
38381,1477,895,129,55,21,27,87,3,582
19096,13603,6178,53,401,190,18,353,180,7425
20842,1712,807,6,29,14,13,6,43,905
40983,455,258,19,8,0,0,0,32,197
32922,15741,7343,161,303,216,66,595,179,8398
33030,35701,19465,267,1594,282,237,1083,257,16236
26543,291,159,0,0,0,0,0,0,132
39337,1949,948,0,106,19,35,72,0,1001
40316,306,158,0,31,12,0,31,27,148
50164,540,265,0,40,0,0,28,3,275
50246,613,308,0,22,12,8,19,8,305
52657,71,30,2,6,1,0,0,0,41
53563,11206,5759,20,447,94,64,359,157,5447
46377,287,136,0,14,28,0,14,0,151
67835,2891,1380,9,117,53,6,155,49,1511
62817,459,192,1,29,4,0,1,0,267
63670,11240,5627,67,334,192,68,281,229,5613
48647,4418,2331,7,42,90,28,120,84,2087
48853,648,360,20,4,2,9,16,17,288
48871,2070,990,2,38,27,0,38,37,1080
55120,4355,2072,17,122,112,35,82,129,2283
72315,21875,10514,319,500,201,253,417,271,11361
72454,4937,2419,41,154,53,17,133,43,2518
72601,30460,14992,254,1074,345,106,892,441,15468
98134,804,631,7,26,8,0,30,0,173
98673,579,289,4,8,9,11,5,10,290
33185,30959,14918,293,658,184,109,981,314,16041
33403,12558,6069,124,493,63,98,448,139,6489
14864,1253,737,67,26,14,0,15,18,516
15324,540,241,3,22,8,0,17,11,299
5350,684,323,0,38,14,4,26,8,361
912,5455,2493,58,173,113,56,177,91,2962
34232,34639,16671,204,881,301,128,1075,494,17968
35006,2927,1532,0,107,40,9,98,83,1395
36030,645,284,0,0,5,20,44,14,361
36551,9029,4929,70,389,46,39,406,88,4100
36792,1103,535,0,0,0,0,0,19,568
97503,12338,6163,57,461,160,97,397,105,6175
97920,96,74,0,0,8,2,4,0,22
99039,72,35,2,5,1,0,1,0,37
99103,526,255,0,10,8,0,6,12,271
99510,949,836,0,105,23,0,0,0,113
56165,424,217,0,16,1,0,10,6,207
57071,3079,1566,15,67,40,25,132,37,1513
79520,2290,1022,9,25,27,2,58,9,1268
94706,21040,10301,111,701,208,112,933,232,10739
88051,114,46,0,0,14,0,0,12,68
92411,26563,12601,93,817,91,391,882,298,13962
66105,2479,1418,29,129,16,12,86,14,1061
66777,512,278,0,16,24,0,19,10,234
68421,1200,595,4,3,5,34,8,6,605
68769,1671,802,0,64,50,12,27,27,869
61474,292,138,0,10,1,0,0,3,154
62052,12292,5809,59,319,53,74,415,96,6483
52227,2997,1502,34,105,14,0,112,11,1495
54120,241,125,0,3,5,0,0,8,116
54896,1406,725,0,20,32,1,10,27,681
55041,7800,3828,16,167,133,6,229,125,3972
56186,357,203,0,13,7,0,11,2,154
57661,94,47,0,0,4,0,0,0,47
72826,46,20,0,0,0,0,0,4,26
49812,846,455,5,28,13,2,31,11,391
51056,385,189,0,1,3,0,46,25,196
62931,1445,725,0,7,19,0,54,25,720
55983,1662,847,0,60,11,8,67,21,815
73529,5440,2700,59,216,78,26,203,41,2740
76538,860,394,0,11,6,0,9,19,466
44471,10742,5061,79,293,128,33,268,121,5681
76941,1360,760,23,20,3,14,40,23,600
46350,42654,20945,228,1088,488,127,1272,611,21709
54417,27,13,0,0,0,0,1,0,14
36266,5276,2565,18,223,37,11,243,12,2711
55724,772,429,8,15,16,5,13,18,343
43518,2524,1337,2,80,34,7,37,18,1187
48661,10446,5139,15,280,160,24,246,129,5307
44256,62916,31645,239,1970,697,404,1874,916,31271
28438,1619,745,7,33,17,0,30,43,874
45213,12574,6624,62,409,148,41,419,193,5950
50149,903,481,6,18,7,8,20,12,422
46117,690,387,0,0,13,0,0,0,303
15731,423,195,0,0,0,0,0,41,228
47946,2113,1079,15,48,52,4,54,25,1034
7057,11580,5541,21,582,152,63,464,179,6039
59456,413,274,0,0,0,16,0,0,139
19125,24674,12739,129,1107,209,41,1165,210,11935
61284,2110,1010,0,0,25,0,107,30,1100
57717,8000,3875,0,252,107,63,323,191,4125
12975,264,120,0,10,6,0,0,8,144
959,47459,21517,502,1413,404,572,1699,600,25942
46147,3128,1603,0,74,77,0,59,50,1525
50424,1454,737,0,32,45,5,32,25,717
61325,970,472,4,31,9,8,46,13,498
16685,122,49,3,0,3,0,0,0,73
32331,4269,2088,26,91,57,81,43,50,2181
32905,23395,12056,205,588,386,220,417,334,11339
33323,21195,9686,170,1068,200,224,1134,295,11509
8029,4435,2217,20,145,88,69,51,75,2218
45775,1159,538,0,38,22,0,4,22,621
8053,45193,21970,250,1204,473,232,1220,640,23223
48167,22113,10746,124,681,216,152,648,385,11367
21620,13155,5969,121,441,129,198,260,145,7186
13076,2314,1261,10,25,46,42,82,82,1053
53809,4251,2189,42,125,49,36,92,30,2062
12150,895,500,19,28,46,0,0,8,395
27360,45603,22162,305,1431,313,124,1690,470,23441
19126,15863,7548,147,297,217,158,629,161,8315
31775,3339,1503,5,123,21,9,146,49,1836
49072,3061,1613,10,110,39,9,38,24,1448
34785,34933,19494,79,1517,1149,38,593,753,15439
74001,306,155,0,4,4,0,9,2,151
74039,3769,1878,41,112,57,17,131,49,1891
74369,2047,954,22,43,37,0,63,25,1093
98354,7088,3493,61,240,75,44,312,62,3595
98812,5297,2837,71,164,63,28,124,61,2460
99152,135,69,0,0,7,0,0,10,66
98532,24140,12247,98,679,343,119,745,263,11893
59089,420,219,2,6,6,0,11,9,201
60173,12162,6068,22,812,121,91,627,109,6094
66431,576,312,10,0,23,0,2,26,264
67045,3263,1633,31,74,20,14,141,34,1630
69122,729,341,4,29,7,0,31,8,388
62234,32426,15507,228,1044,392,116,1377,366,16919
51564,433,201,1,0,9,2,2,5,232
52031,5111,2598,36,197,58,17,163,82,2513
52361,4616,2123,68,83,20,0,119,94,2493
55027,3068,1589,20,139,27,4,143,22,1479
56335,268,124,0,11,1,0,1,5,144
58572,287,150,7,8,9,5,4,8,137
62884,2716,1368,43,16,44,28,82,55,1348
98003,49860,24465,385,1606,469,295,1375,638,25395
78415,40439,19874,254,1382,369,186,1322,385,20565
76653,1253,720,0,109,13,0,3,2,533
58230,620,348,5,4,7,6,7,7,272
60098,32526,16008,256,1155,376,120,956,538,16518
72930,327,137,0,0,17,0,34,0,190
73059,2916,1519,20,80,26,0,102,42,1397
73540,586,344,0,47,0,0,13,15,242
74026,860,414,0,26,5,10,28,9,446
74867,736,350,9,14,7,1,18,18,386
75061,54862,27882,447,1965,308,442,2149,368,26980
52003,13555,6456,18,305,210,106,411,184,7099
52315,1215,593,9,31,7,7,24,12,622
62976,361,141,0,0,0,0,26,20,220
54661,3582,1800,14,132,76,14,100,55,1782
60626,49730,24582,519,2135,330,553,2161,508,25148
62054,781,474,2,11,4,0,10,1,307
86040,10821,5406,102,412,82,123,401,54,5415
78744,48969,24829,326,2009,326,431,2086,217,24140
79241,2200,1102,11,125,7,0,50,26,1098
95476,36792,18370,191,1251,448,65,1075,886,18422
95824,30296,15102,365,1025,305,138,1131,365,15194
97145,381,209,10,0,7,0,0,0,172
98050,552,349,0,26,0,0,29,0,203
98625,6685,3574,23,134,99,13,186,67,3111
95220,7538,3706,59,250,68,28,130,69,3832
95340,36373,18152,423,1093,393,323,858,520,18221
99840,1061,555,2,55,26,0,41,9,506
29407,34315,15908,140,1557,268,204,1422,480,18407
36029,1160,717,0,202,21,0,24,37,443
36078,13178,6162,5,256,89,166,366,178,7016
40903,485,256,0,22,6,5,20,0,229
45804,15665,7737,114,315,146,89,420,182,7928
46140,39638,18840,262,1256,429,206,1382,606,20798
95407,42483,21505,221,1980,391,123,1497,404,20978
97024,10383,5125,98,327,130,14,478,165,5258
93728,16382,8253,181,429,117,151,496,121,8129
2210,3196,1882,33,325,38,0,153,47,1314
2643,0,0,0,0,0,0,0,0,0
54727,4998,2556,20,170,62,32,142,70,2442
56327,800,443,8,31,15,2,23,14,357
32901,24772,12144,231,740,287,195,420,396,12628
33898,17107,8381,63,315,273,49,379,339,8726
51357,543,272,0,26,2,2,18,8,271
51455,2347,1145,8,31,37,7,46,25,1202
51545,324,157,0,2,2,0,4,2,167
52336,2350,1201,12,59,45,12,43,9,1149
53223,28596,12541,107,601,366,122,680,366,16055
48137,5192,2777,0,133,122,26,93,81,2415
48633,160,66,0,0,13,0,0,5,94
31632,12958,6568,92,570,124,262,582,101,6390
31643,9062,4291,9,334,105,0,139,121,4771
36732,8231,3675,21,140,75,65,275,98,4556
39074,15041,7216,160,562,108,182,581,215,7825
47244,737,402,8,25,2,0,12,12,335
78371,271,150,7,0,0,0,0,11,121
79252,3004,1451,0,73,51,17,66,18,1553
79849,12780,6317,217,223,87,105,275,123,6463
80442,2323,1287,6,87,16,0,128,20,1036
60643,49870,22638,290,1430,470,174,1334,753,27232
61863,806,390,4,25,7,6,14,7,416
68924,1169,525,0,35,3,7,56,23,644
75054,10635,5202,234,591,24,0,575,57,5433
87714,1162,597,7,26,7,2,16,43,565
88342,91,33,0,0,0,0,0,0,58
21405,352,162,0,0,13,0,0,0,190
3911,52,27,0,0,0,0,0,0,25
13219,14781,6991,96,367,122,65,417,308,7790
14827,185,83,0,0,17,0,0,0,102
15214,13217,6503,65,389,125,50,378,200,6714
16123,2140,1068,103,40,10,2,8,65,1072
16232,4205,2038,34,102,28,23,106,58,2167
17352,1252,650,15,52,12,5,53,18,602
40921,211,116,0,0,0,0,0,7,95
28347,2329,1480,32,210,5,0,40,19,849
32776,12416,5811,0,617,155,0,420,246,6605
33716,18043,8719,80,686,46,39,562,265,9324
53066,34918,17610,125,1047,494,132,1162,467,17308
53213,27573,13475,85,1039,184,87,822,280,14098
66008,214,86,0,0,0,0,8,0,128
67740,1555,776,0,38,12,4,53,13,779
68512,13660,6845,99,517,79,63,499,133,6815
68855,402,192,0,15,2,0,22,5,210
63633,649,354,3,20,8,0,25,4,295
56237,496,238,0,6,4,2,15,11,258
56281,644,310,9,17,6,0,24,13,334
57342,587,309,0,36,0,0,8,7,278
57630,29,16,0,0,0,0,0,0,13
58431,118,53,0,0,14,0,2,8,65
48627,103,61,12,0,0,0,0,0,42
48763,5015,2529,43,95,82,26,115,65,2486
71339,170,114,0,0,0,0,0,0,56
72106,5643,2938,93,163,8,59,166,77,2705
74342,3089,1523,26,20,56,41,62,0,1566
75125,6333,3183,0,190,53,56,152,53,3150
45325,2266,1045,9,45,6,0,85,45,1221
54450,427,202,0,23,4,4,6,9,225
54952,26707,13131,168,977,491,145,867,356,13576
56010,1268,642,8,72,8,3,49,16,626
56046,91,51,0,1,0,0,2,0,40
36856,7415,3658,0,339,28,0,322,23,3757
31904,33908,16050,204,1227,340,143,1144,611,17858
43942,2767,1168,6,75,30,135,72,19,1599
36207,19746,9219,115,699,312,100,730,367,10527
36255,871,492,29,58,8,0,41,20,379
36425,1127,575,13,10,15,0,25,0,552
42054,964,444,0,36,0,0,86,0,520
47598,3191,1610,22,116,41,3,102,63,1581
48618,5143,2569,52,128,98,24,114,80,2574
48760,1407,725,4,34,8,12,29,37,682
49128,3370,1712,35,58,44,25,81,74,1658
28556,1019,580,42,72,22,0,17,16,439
51231,369,216,0,19,10,2,15,10,153
15946,6746,3398,35,243,79,24,203,123,3348
16002,15087,7490,38,220,283,57,211,184,7597
17037,1025,514,2,25,5,7,19,2,511
5358,180,102,0,3,10,0,3,5,78
7016,23882,11662,101,706,297,53,866,345,12220
7105,52033,27627,398,2585,417,167,2024,660,24406
24601,25,14,0,0,0,0,0,0,11
20716,22083,10027,159,626,148,106,825,323,12056
12454,363,177,8,34,3,0,7,0,186
27824,2001,961,0,133,40,0,30,24,1040
59044,11880,5889,86,279,76,74,315,179,5991
59834,2718,1206,0,131,15,0,133,22,1512
32925,1506,883,11,48,10,7,76,5,623
35184,4356,2062,12,86,26,9,155,75,2294
40402,2511,1201,0,59,113,0,100,14,1310
41046,1263,698,4,48,6,1,58,9,565
43138,18107,8582,67,679,199,62,526,275,9525
46385,39360,19346,152,1376,396,97,1254,541,20014
49461,9300,4579,40,190,123,31,257,118,4721
50480,873,414,21,27,10,30,18,12,459
51301,12401,5976,53,317,107,18,433,170,6425
38913,391,188,0,0,7,0,20,0,203
51230,331,196,4,7,1,0,6,5,135
53403,26182,13195,233,1018,224,196,799,401,12987
55921,4682,2322,12,122,79,32,128,62,2360
42044,3198,1473,0,63,52,12,0,40,1725
33312,53552,28451,425,1360,481,293,1876,472,25101
47432,4617,2255,0,86,50,21,99,61,2362
47715,26340,11989,309,733,178,158,775,281,14351
15945,99,62,0,0,0,0,0,0,37
18242,131,69,0,0,0,5,2,14,62
5450,5136,2584,41,194,51,0,201,105,2552
6019,10211,4940,23,307,188,23,285,114,5271
6259,4465,2378,50,142,36,24,74,52,2087
7024,37008,17400,173,1416,493,79,1514,652,19608
7075,8511,4054,18,309,95,46,361,195,4457
7756,3133,1184,0,55,78,0,126,95,1949
8088,23864,11847,170,626,354,93,497,398,12017
28468,5093,2539,0,46,114,34,31,195,2554
29475,2016,885,0,29,13,12,76,22,1131
10591,23077,10868,87,854,199,252,790,368,12209
12791,485,253,0,5,0,0,22,0,232
22735,2930,1434,0,72,61,20,47,20,1496
22846,2698,1201,0,29,12,1,133,0,1497
20109,40717,20185,218,1488,197,302,1653,209,20532
25411,13087,6543,25,296,178,104,584,84,6544
99004,20411,10119,613,431,147,550,532,220,10292
87144,42619,21016,187,1195,183,168,1613,450,21603
88231,3412,1737,23,94,18,69,82,63,1675
62831,412,205,0,2,5,0,2,1,207
78801,22647,11029,272,594,296,276,514,322,11618
70139,0,0,0,0,0,0,0,0,0
83644,11486,5473,79,334,108,80,406,116,6013
84002,325,146,0,7,0,0,11,0,179
84646,1847,803,32,42,24,18,77,23,1044
84648,6111,3124,4,246,76,97,232,23,2987
73520,164,77,0,2,3,0,7,0,87
74028,1708,851,2,56,42,5,59,8,857
95319,1529,913,0,27,22,20,9,9,616
52323,944,472,6,27,12,3,25,21,472
53802,29,17,0,0,2,0,0,0,12
36722,298,163,0,0,0,0,4,8,135
37015,17323,8940,31,583,213,89,573,159,8383
37144,3195,1579,7,36,31,49,38,22,1616
38745,92,52,0,0,13,0,5,0,40
45152,11656,5670,47,372,167,42,338,101,5986
47452,5115,2567,123,132,77,26,126,88,2548
48706,39419,18961,101,1167,440,266,1051,588,20458
48874,79,34,0,6,0,0,8,0,45
59527,1087,519,6,20,4,21,16,8,568
50229,895,471,0,30,13,11,53,5,424
33854,236,118,0,0,0,0,0,0,118
35054,3777,2079,0,49,62,94,122,69,1698
35224,5168,2549,31,91,44,17,180,116,2619
3755,10885,5326,252,147,68,286,154,106,5559
23225,42960,20262,87,1837,279,83,1562,853,22698
7843,11451,5635,97,545,149,96,361,199,5816
8721,20873,10501,110,731,278,92,691,271,10372
10003,54682,27503,485,2885,205,695,1766,615,27179
11509,2153,1113,0,21,41,47,6,17,1040
21205,14580,6949,132,429,60,45,374,262,7631
12428,7022,3542,0,213,55,0,254,81,3480
28909,1031,380,18,0,25,0,0,60,651
82050,223,121,0,2,1,0,7,3,102
84718,294,139,3,10,0,15,22,3,155
62922,2532,1324,22,22,58,12,38,49,1208
63621,1128,514,2,12,21,2,64,26,614
66870,134,58,0,2,2,0,9,0,76
68944,1370,679,22,15,15,17,29,10,691
85015,39866,20136,282,1135,244,210,1465,521,19730
85259,23124,10711,174,389,302,164,724,355,12413
99631,357,170,0,0,16,0,0,0,187
47841,2259,1097,13,40,10,31,24,24,1162
48472,1761,883,0,50,22,21,42,24,878
49060,1709,835,22,65,18,0,109,24,874
46702,1999,1051,0,26,29,5,56,51,948
49713,2050,1078,10,96,32,9,38,49,972
50545,233,97,0,7,6,0,13,5,136
35179,8929,4077,29,297,137,81,397,194,4852
15133,6384,2965,56,195,106,32,231,91,3419
15217,27758,13598,205,862,321,186,959,299,14160
30292,5772,2590,55,138,100,0,209,86,3182
19352,10910,5432,173,220,91,217,281,143,5478
34474,16659,7718,147,521,94,110,648,59,8941
1890,22677,11098,112,582,269,56,757,222,11579
17747,3439,1675,14,86,29,9,111,29,1764
18463,294,140,0,3,15,0,0,0,154
27508,1326,880,38,55,2,0,34,18,446
44203,40442,19854,215,1063,513,204,1003,631,20588
44266,33894,17050,191,981,352,311,953,534,16844
45130,4028,2063,0,160,94,33,35,29,1965
45618,13,11,0,0,3,0,0,0,2
46111,185,102,0,6,3,0,9,6,83
46225,6354,3257,70,384,83,31,160,86,3097
32347,7795,3785,70,165,118,54,239,188,4010
33160,41113,19818,108,1220,506,230,1170,407,21295
61434,3012,1607,50,82,33,19,85,30,1405
69358,1841,930,10,50,32,13,38,8,911
70513,234,127,0,0,0,0,0,0,107
64742,2159,1120,4,83,24,10,70,15,1039
66502,45697,23531,2443,1314,177,1815,1290,304,22166
57523,947,479,0,25,16,0,26,27,468
57793,2318,1204,7,74,143,7,32,22,1114
81226,8959,6256,32,697,124,6,186,104,2703
74883,2453,1233,14,99,32,4,101,26,1220
85607,15411,7242,99,488,56,182,445,181,8169
86021,6023,2704,24,147,0,27,161,17,3319
87011,47,20,0,0,0,0,0,0,27
92336,96575,47574,689,3971,603,893,3793,743,49001
93304,49976,24880,474,1719,383,320,1412,633,25096
4978,746,379,0,16,9,0,20,30,367
6896,9187,4483,21,82,153,71,167,172,4704
40807,368,168,4,19,15,0,11,0,200
41035,11602,5476,203,286,103,91,225,146,6126
38046,54,22,0,5,0,0,4,4,32
38606,16287,7439,76,408,93,116,465,75,8848
15521,1873,927,19,34,48,21,56,27,946
52322,2752,1378,3,52,11,2,51,37,1374
29611,30274,14457,102,914,330,164,1002,336,15817
27985,296,160,6,3,2,0,0,7,136
24422,5992,2883,21,167,87,47,148,43,3109
13440,41243,21220,159,1305,447,230,1270,809,20023
29662,15696,7286,157,446,151,26,645,156,8410
21766,528,239,0,0,0,0,30,18,289
93650,3477,1832,12,124,93,0,107,27,1645
94080,67597,33132,299,2472,977,238,2614,1037,34465
87305,3416,1754,10,138,18,15,141,64,1662
95325,77,31,0,0,0,0,0,0,46
95910,65,26,0,0,0,0,0,0,39
98257,4022,1875,11,74,65,5,109,86,2147
3588,1580,826,11,26,29,4,21,17,754
6078,12540,7171,118,501,139,28,238,123,5369
27546,21313,11313,189,897,231,280,638,337,10000
33126,52987,25348,302,1614,306,291,1815,424,27639
37307,4798,2472,75,125,88,7,219,22,2326
37711,4765,2490,41,35,6,3,148,85,2275
38337,1336,637,5,71,14,2,51,9,699
23878,1016,533,10,37,21,12,28,0,483
29303,25089,12052,278,913,153,479,721,258,13037
29368,96,46,0,0,0,0,50,0,50
78247,53315,25953,358,1985,551,207,2073,772,27362
78948,760,379,0,0,4,14,0,3,381
88264,27,16,0,0,0,0,0,0,11
90028,30734,16917,254,1559,209,218,1008,265,13817
98286,185,100,0,2,3,0,0,7,85
92134,280,209,26,17,0,13,1,0,71
92618,43316,22617,135,2163,240,202,2383,409,20699
93561,34839,19709,217,1540,483,133,821,432,15130
38966,1004,270,0,22,0,19,47,13,734
39455,9100,4603,111,295,148,16,282,160,4497
43319,926,483,0,79,11,0,0,0,443
61532,645,322,0,31,0,0,16,2,323
61875,818,320,0,23,0,0,34,46,498
64112,8352,4016,61,250,126,143,292,174,4336
47234,1622,851,0,81,12,0,63,60,771
47247,183,80,0,17,3,0,18,1,103
47804,11595,5752,128,329,93,63,457,204,5843
49710,489,288,0,28,13,0,3,4,201
67070,1095,531,2,11,19,7,18,33,564
59430,354,178,0,9,6,0,10,6,176
60456,4308,1961,11,197,23,59,137,41,2347
61752,4389,2193,29,123,80,16,175,67,2196
62362,297,142,2,11,7,2,6,12,155
62423,485,212,0,17,0,0,56,13,273
70127,25278,11397,143,597,192,211,797,299,13881
96113,1957,1504,32,332,3,31,26,15,453
97480,317,168,0,0,7,0,0,3,149
97481,819,478,0,0,0,0,0,32,341
92058,45894,24868,866,1237,293,825,1522,395,21026
88301,1185,557,8,22,34,2,9,5,628
93651,1915,1052,20,32,33,0,40,51,863
93901,27805,13601,177,1078,265,162,1048,410,14204
95364,0,0,0,0,0,0,0,0,0
45014,43848,21368,265,1441,514,408,1446,708,22480
46144,148,109,10,11,18,0,0,0,39
46792,3801,1895,7,94,38,10,143,68,1906
33101,0,0,0,0,0,0,0,0,0
63386,392,222,12,15,7,0,26,2,170
64079,14485,7294,18,456,155,108,531,266,7191
56658,0,0,0,0,0,0,0,0,0
53925,7745,3787,25,218,176,0,233,137,3958
52170,549,282,6,23,14,0,18,21,267
53092,20917,10274,106,457,349,148,494,370,10643
35073,2396,1092,18,39,11,15,67,24,1304
35085,9116,4598,58,462,73,107,308,60,4518
37615,21819,10429,41,926,223,208,662,260,11390
38139,15774,7723,56,348,266,62,396,271,8051
56339,1094,615,0,32,15,0,38,19,479
56686,901,485,0,39,25,0,23,9,416
59524,677,347,2,20,7,8,14,13,330
48415,9353,4665,45,306,112,51,266,121,4688
55332,1652,884,4,29,19,0,29,25,768
54832,384,195,0,17,2,0,4,2,189
55082,35867,18171,100,1132,520,125,804,497,17696
29346,293,113,0,4,0,39,23,0,180
30215,36441,17773,192,807,342,141,1132,434,18668
31327,187,107,0,0,0,0,0,0,80
19114,31736,15649,110,1269,275,91,1156,512,16087
19150,22492,9240,114,520,387,114,789,557,13252
14202,3474,1980,18,124,54,27,51,17,1494
15342,5089,2390,67,128,150,26,202,106,2699
15942,2120,1093,15,54,37,6,47,46,1027
17240,3985,1994,22,87,40,21,133,75,1991
26560,243,92,0,0,0,0,40,0,151
2465,11964,5671,37,321,76,106,347,140,6293
8560,3623,1701,45,93,72,16,89,86,1922
8836,3766,1690,0,76,28,8,84,74,2076
10926,3467,1788,19,82,29,0,197,9,1679
11693,12919,6308,69,343,61,87,490,144,6611
54921,1167,619,9,28,13,0,33,29,548
55103,13947,6985,109,496,113,65,407,213,6962
16136,690,319,0,37,0,3,31,9,371
16870,7302,3744,11,183,100,11,181,138,3558
17340,10884,5305,38,248,69,69,254,194,5579
33765,14270,7042,23,571,101,56,456,153,7228
31033,1815,930,0,24,28,0,18,58,885
20317,406,334,0,0,0,0,0,0,72
20566,0,0,0,0,0,0,0,0,0
23321,35489,16746,266,892,244,223,1151,362,18743
24485,240,110,0,0,7,0,11,7,130
34445,0,0,0,0,0,0,0,0,0
12204,7628,3913,17,430,181,0,396,137,3715
24738,267,136,0,0,0,0,0,0,131
30442,7617,3342,134,205,81,114,107,166,4275
33859,10364,4698,66,114,179,119,235,190,5666
91506,18575,8497,78,651,242,68,761,354,10078
91977,63393,31255,386,1954,585,460,2186,668,32138
95635,807,397,16,0,0,0,0,29,410
58701,32844,16986,334,913,339,220,782,338,15858
95684,3384,1740,51,95,86,37,76,110,1644
60656,27579,13992,59,1246,247,62,1184,331,13587
96719,1702,857,9,72,8,8,42,0,845
88023,2504,1367,12,37,26,0,55,41,1137
20119,4235,2413,16,81,72,11,129,102,1822
56453,905,451,5,14,6,1,30,6,454
63435,4442,2209,65,66,26,10,134,69,2233
85387,10651,5201,22,132,201,21,186,140,5450
99566,98,40,0,11,0,0,0,0,58
96059,599,309,0,19,0,0,40,17,290
72064,2260,1153,22,49,20,9,86,29,1107
81419,3852,1738,2,19,97,7,159,65,2114
59647,324,171,0,9,0,0,0,44,153
93268,17964,9120,237,541,83,77,388,160,8844
55785,204,112,0,7,3,0,3,3,92
29130,5755,2848,42,35,137,33,126,106,2907
56023,560,287,0,26,2,0,5,3,273
29511,4986,2430,58,164,93,50,184,18,2556
57376,970,471,0,13,10,0,29,7,499
45351,212,124,0,1,2,2,6,0,88
46798,1490,735,21,68,3,0,86,18,755
50020,1300,596,9,2,13,0,18,25,704
32233,24473,13079,259,893,297,159,870,378,11394
33134,41861,19801,292,1599,593,66,1860,622,22060
40858,346,134,0,0,17,0,0,0,212
95327,7711,5118,93,505,80,70,57,69,2593
32829,19888,8994,78,1063,102,76,1146,252,10894
35229,1219,382,87,0,0,52,0,0,837
43565,502,247,0,13,6,7,7,8,255
43750,115,65,0,0,0,0,8,0,50
44818,2394,1175,2,44,39,31,53,75,1219
46799,232,105,0,31,0,0,11,0,127
47339,499,287,29,15,0,0,22,9,212
36513,1024,240,0,0,0,0,0,0,784
52325,868,489,0,13,13,0,20,2,379
63336,1268,628,30,50,23,0,14,14,640
63966,2327,1257,50,72,69,40,55,61,1070
73939,1709,913,53,18,9,35,44,11,796
74058,3946,1889,38,102,53,5,113,44,2057
80004,37042,18424,166,1410,458,213,1089,556,18618
75565,173,87,0,0,0,1,2,3,86
77089,53866,26567,429,1917,363,596,2098,525,27299
77460,77,38,0,0,0,0,0,10,39
58466,327,178,0,9,4,0,9,7,149
67454,558,256,2,7,6,0,17,13,302
68514,126,56,0,0,13,0,0,0,70
17505,1837,921,9,43,17,0,44,41,916
17517,16501,8400,135,566,159,74,524,122,8101
25902,73,22,0,0,0,0,0,0,51
30297,28077,13757,143,868,133,210,842,352,14320
32427,926,453,20,42,8,7,13,8,473
32702,2793,1199,21,27,6,13,89,49,1594
33066,16786,7299,100,383,123,117,303,262,9487
34739,334,183,0,0,0,0,0,0,151
44111,42821,20608,205,1674,431,245,1643,549,22213
44720,38080,18236,243,1088,522,97,1294,601,19844
45622,138,47,0,0,8,0,0,20,91
46164,4420,2165,14,232,73,70,115,55,2255
54230,4698,2486,20,125,97,18,121,58,2212
54935,42107,20585,263,1472,396,363,1257,495,21522
48754,958,500,6,21,22,3,16,16,458
49129,628,375,0,17,7,0,16,9,253
14505,4925,2367,52,100,23,10,115,74,2558
58420,342,178,0,17,4,0,16,1,164
15143,21129,10212,14,536,207,37,538,343,10917
16332,43,31,0,0,3,0,0,0,12
21791,5328,2671,60,102,66,23,77,63,2657
52165,654,366,4,16,4,2,22,13,288
53144,27266,13789,310,824,199,237,985,355,13477
6281,6635,3281,39,161,131,0,227,139,3354
58562,411,220,0,5,20,0,12,16,191
28774,1008,550,0,0,18,0,14,0,458
77063,38961,20247,185,1729,241,382,1590,303,18714
3442,1407,763,18,50,21,3,32,43,644
36042,1774,985,13,63,46,0,42,15,789
36206,11541,5715,59,260,140,33,350,146,5826
73844,258,122,0,3,5,0,8,0,136
77456,1588,851,0,58,33,0,9,14,737
25854,980,463,15,0,10,12,9,14,517
25133,982,456,0,70,14,0,67,14,526
30092,35419,17385,279,1079,234,199,1557,435,18034
95379,3586,1748,2,6,44,24,188,99,1838
39355,6700,3047,22,174,82,47,161,104,3653
95610,45995,22254,206,1657,415,174,1650,583,23741
74643,440,244,3,7,0,2,5,8,196
48025,14867,7188,25,373,222,44,416,235,7679
53095,27587,13756,174,959,318,199,818,339,13831
78370,4846,2366,14,131,79,7,116,71,2480
79007,14447,7296,69,415,226,143,396,147,7151
60177,23109,11520,82,899,124,177,925,220,11589
11563,21965,10656,94,665,272,82,586,342,11309
60464,9715,4495,49,204,106,0,284,111,5220
61602,877,683,27,36,15,1,25,4,194
76132,27058,12415,100,842,99,203,968,336,14643
72060,597,383,1,9,0,0,10,0,214
77457,396,216,0,18,25,0,0,28,180
92025,53772,27005,471,1851,340,321,1688,454,26767
7753,37597,17859,387,1045,486,74,1024,567,19738
38036,520,178,0,22,7,12,11,5,342
15845,3020,1574,33,66,59,22,29,39,1446
57381,509,232,0,1,6,0,10,11,277
24563,5527,2669,15,158,97,14,153,64,2858
25162,423,201,0,13,7,0,9,7,222
43830,5775,3001,15,175,23,17,194,112,2774
46301,581,287,0,3,26,0,5,6,294
60130,14041,6247,78,660,136,75,408,235,7794
62473,1443,728,13,62,32,0,28,15,715
28305,5705,2718,44,94,105,33,145,53,2987
32533,27632,13833,65,762,428,75,700,300,13799
28627,970,583,12,78,9,0,25,42,387
19939,7221,3397,44,66,71,60,139,58,3824
76446,7686,3954,126,226,104,9,289,82,3732
24134,4993,2426,0,228,51,10,209,67,2567
52144,1334,714,0,50,10,0,42,22,620
12842,811,341,35,9,28,1,9,0,470
61847,1239,627,0,48,14,0,33,2,612
63070,8120,3856,40,481,4,80,406,68,4264
34996,11119,5564,7,239,204,19,202,190,5555
73020,23966,11993,96,754,250,134,677,326,11973
75241,30682,13851,263,556,216,151,1181,498,16831
35575,1043,492,1,12,4,0,21,4,551
30324,26818,13443,164,1251,91,43,845,229,13375
36353,1720,793,10,25,12,25,31,31,927
32301,30712,13894,730,877,169,797,974,228,16818
29924,4299,2249,32,226,39,0,225,137,2050
97701,68204,33092,257,2303,848,335,2201,841,35112
98164,155,75,0,0,0,0,0,0,80
16695,1104,547,2,28,8,3,34,21,557
17020,9449,4712,72,229,138,59,383,127,4737
18067,18160,9086,92,731,219,8,695,441,9074
33712,25674,12182,288,606,280,295,903,415,13492
35989,3519,1813,8,144,5,32,129,51,1706
24874,3311,1567,34,62,83,32,96,75,1744
7928,18956,9187,29,442,182,24,532,165,9769
10271,0,0,0,0,0,0,0,0,0
12085,434,215,0,20,5,0,17,15,219
12440,1999,1029,23,94,56,0,39,40,970
13092,2479,1254,68,51,31,18,83,27,1225
2745,24622,12217,203,719,312,164,502,256,12405
73762,2142,1049,0,97,12,0,89,48,1093
49651,7888,4024,17,174,117,57,237,98,3864
91932,26701,13340,218,1138,333,179,729,373,13361
92612,32362,16069,1170,970,307,871,907,304,16293
89706,19760,9678,87,882,281,112,495,322,10082
95227,842,426,0,14,9,11,15,9,416
96771,7934,3870,3,227,93,43,332,158,4064
97005,26442,12739,159,1106,163,48,945,190,13703
75933,1469,704,0,0,20,0,0,14,765
77326,46,30,0,0,0,0,0,0,16
77876,85,22,0,0,0,0,0,0,63
78072,468,290,3,3,0,4,24,3,178
84662,1321,586,0,35,14,4,59,47,735
38765,66,46,0,13,0,0,0,0,20
39359,372,200,0,18,14,6,6,0,172
66203,19290,9395,112,617,162,175,592,186,9895
66507,1272,705,5,23,2,4,51,15,567
74469,2557,1247,13,37,17,38,76,8,1310
76866,727,351,1,9,11,0,42,10,376
61011,2326,1240,3,51,113,3,39,17,1086
58649,302,135,18,23,5,0,25,2,167
79504,3204,1415,1,18,23,45,54,51,1789
63675,194,96,9,0,0,0,0,0,98
63758,165,94,3,10,0,0,12,0,71
72103,12846,5960,24,417,89,87,448,311,6886
72524,354,226,0,0,0,0,0,12,128
73104,2287,1127,11,99,15,15,52,32,1160
71043,402,212,0,17,1,0,7,3,190
30538,3120,1579,0,18,28,57,68,19,1541
32714,37223,17492,182,1660,307,130,1603,395,19731
32803,19583,10071,21,1089,146,41,866,188,9512
22427,5156,3424,111,138,89,72,129,37,1732
26716,762,417,32,8,54,7,9,8,345
17820,5471,2642,13,174,68,13,158,104,2829
28806,42650,20853,254,1815,318,112,2216,520,21797
11776,24666,11733,82,877,127,76,694,312,12933
13406,710,397,0,32,3,5,19,8,313
53546,30708,14841,138,946,263,112,1240,398,15867
37220,5763,2917,12,231,77,0,206,105,2846
8515,6396,3504,48,221,22,69,239,20,2892
11236,100331,43752,785,2775,990,737,3286,1889,56579
11726,20558,9975,164,542,136,55,703,295,10583
17111,32603,16034,138,1116,453,144,892,469,16569
17954,4474,1945,25,154,0,0,212,80,2529
2148,61354,29408,541,2783,390,335,2131,576,31946
3464,1054,493,9,29,23,0,44,20,561
4626,484,277,1,17,15,4,11,13,207
4863,1081,501,0,17,12,0,23,17,580
77061,25607,12505,404,645,122,105,741,337,13102
77458,87,36,0,0,9,0,0,0,51
77459,69546,34113,284,2249,675,499,2815,1075,35433
66840,748,407,0,9,22,0,21,1,341
68407,671,337,0,33,8,0,38,15,334
41645,1349,679,0,0,35,0,20,0,670
62519,61,29,0,0,0,0,0,0,32
62555,423,206,2,11,3,2,19,2,217
62642,1479,779,20,61,4,2,50,24,700
65627,359,179,27,0,10,0,0,16,180
55736,1413,711,6,34,32,0,17,24,702
45672,1527,736,0,106,29,0,44,0,791
46582,13546,6808,97,467,108,19,368,123,6738
46961,121,50,0,36,0,0,24,0,71
19508,15340,7978,40,472,166,23,413,240,7362
20540,0,0,0,0,0,0,0,0,0
21657,853,377,0,16,32,0,26,15,476
53195,121,66,0,0,0,0,0,3,55
85605,516,243,0,3,15,3,3,5,273
86431,459,270,0,18,0,0,0,5,189
87940,977,497,0,37,0,48,11,0,480
88134,57,17,0,17,0,0,0,0,40
61526,810,315,0,0,13,0,0,25,495
15721,215,116,2,16,2,0,0,8,99
16667,1533,756,15,49,40,13,48,9,777
62962,9,5,0,0,0,0,0,0,4
63123,51130,24675,382,1487,586,428,1553,743,26455
84037,38058,19371,467,1205,254,181,1418,426,18687
84128,26855,13113,129,1098,101,49,1235,265,13742
49837,9549,4849,11,224,84,44,224,222,4700
49955,445,236,0,32,5,0,25,8,209
68422,470,249,0,8,10,0,5,3,221
70662,276,126,0,11,16,0,0,0,150
65566,830,418,0,15,2,0,13,11,412
45504,17639,8596,147,371,140,236,381,208,9043
45671,274,146,0,23,0,0,3,0,128
51563,684,360,11,33,6,2,18,25,324
15635,106,72,0,0,0,0,0,0,34
16652,18181,10664,137,834,173,199,290,228,7517
16860,226,97,0,27,10,0,29,0,129
17302,2564,1404,21,103,46,30,49,35,1160
17306,351,164,6,16,2,4,6,7,187
17827,685,351,0,5,14,5,16,1,334
17983,1482,764,7,55,29,0,80,26,718
19116,34912,16361,92,847,330,149,1065,760,18551
19373,4931,3165,48,374,35,56,200,42,1766
12804,26272,12919,179,539,448,219,491,305,13353
1338,127,58,0,0,0,0,0,0,69
2379,7165,3585,31,223,86,40,221,156,3580
14067,5328,2334,0,168,41,41,191,60,2994
14775,2530,1366,9,68,38,17,28,56,1164
4103,30970,15295,135,1105,228,170,1055,386,15675
4556,1082,520,4,23,32,0,21,35,562
87415,1370,631,0,19,23,0,9,4,739
88318,264,131,2,0,0,0,7,17,133
89447,7519,3636,49,96,67,25,136,144,3883
92308,41807,20082,146,967,424,315,1079,696,21725
99301,78767,40260,607,3166,392,723,2843,692,38507
72630,253,99,0,2,15,0,7,0,154
74460,170,79,3,0,2,0,2,8,91
75571,2971,1398,0,42,10,0,80,69,1573
75682,507,235,10,20,0,0,21,7,272
65732,994,446,8,6,6,0,25,2,548
66864,406,194,2,7,20,0,4,6,212
68138,12401,6250,150,547,107,145,552,136,6151
81433,516,267,0,15,22,0,11,16,249
84027,471,247,0,0,9,0,31,20,224
62216,2742,1360,7,129,26,17,122,54,1382
78244,32474,15274,234,1137,185,382,1096,246,17200
70759,1659,798,8,23,0,0,20,18,861
71276,112,62,0,10,0,0,8,0,50
41219,1944,947,13,48,23,0,50,13,997
41855,846,465,0,14,32,0,0,7,381
43342,2861,1379,0,67,11,3,83,47,1482
20016,34783,15597,340,998,284,454,1138,379,19186
3883,117,56,0,0,15,0,0,0,61
4256,2935,1545,16,73,96,0,131,78,1390
4573,471,220,0,23,2,3,15,0,251
7066,15603,7711,100,446,143,62,466,167,7892
14769,1013,484,0,42,7,27,28,0,529
77971,1013,500,0,54,0,0,106,0,513
79530,484,255,0,9,9,2,4,1,229
60953,2449,1239,23,43,68,3,77,42,1210
61550,17787,8457,51,595,313,57,579,253,9330
62085,192,76,5,5,0,0,2,1,116
71064,3459,1758,19,155,72,3,66,7,1701
65248,4376,2173,109,84,52,89,83,41,2203
65662,1318,742,80,3,8,16,68,21,576
84760,506,248,1,9,3,8,7,4,258
85018,38833,19789,167,1625,312,207,1550,587,19044
85028,19389,8880,25,500,198,60,715,319,10509
86325,5449,2572,38,42,34,22,60,114,2877
87034,2034,914,23,65,21,6,99,62,1120
74546,712,321,5,10,2,5,16,10,391
75709,5004,2162,0,155,70,62,131,105,2842
72476,6607,3080,88,163,103,26,114,26,3527
13734,2028,898,0,70,26,11,21,41,1130
14012,2379,1204,0,31,46,7,120,32,1175
17021,931,489,6,36,23,2,29,20,442
17201,25835,12315,160,863,283,154,665,323,13520
30535,7431,3755,37,284,160,37,184,62,3676
32205,29499,14238,6,803,240,131,1117,359,15261
21078,18097,8766,150,612,194,93,564,251,9331
17810,5812,4702,25,776,20,19,39,33,1110
18255,4583,2186,14,93,78,16,80,57,2397
28525,2919,1494,19,104,35,0,165,72,1425
13305,249,162,0,13,0,0,14,0,87
54128,1632,859,11,36,16,10,33,22,773
54216,6323,3081,25,107,69,76,213,78,3242
8039,131,74,0,25,0,0,0,5,57
10954,23354,11323,78,747,186,79,592,231,12031
12989,1024,515,0,26,19,0,20,34,509
2322,4482,2273,0,104,8,13,205,27,2209
19311,9057,4536,45,309,38,44,258,86,4521
74953,12052,5795,57,345,155,56,346,138,6257
77069,18622,8980,78,265,341,62,347,393,9642
77982,971,515,0,5,41,0,12,10,456
83013,422,198,4,3,0,0,7,41,224
66868,834,362,7,23,11,0,39,20,472
78558,1000,507,53,0,0,0,0,0,493
72532,1058,482,2,13,1,0,9,11,576
73554,3326,1694,33,138,17,21,44,20,1632
5065,967,499,0,32,26,0,39,54,468
6801,19551,9694,116,832,133,171,597,322,9857
11203,75451,33245,478,1967,653,433,2503,1168,42206
1887,23658,11620,54,495,158,166,616,450,12038
65340,15853,7810,229,577,156,75,449,157,8043
66503,15702,8068,53,419,288,49,509,231,7634
36695,51088,24398,464,1598,627,727,1877,835,26690
28467,10551,4705,27,117,329,39,313,166,5846
20613,13855,6873,31,414,94,15,281,118,6982
20906,70174,32799,334,2533,560,355,2547,833,37375
23608,42234,19852,271,1414,300,227,1330,424,22382
41169,5309,2537,46,173,58,46,241,85,2772
41238,598,286,0,28,7,0,25,9,312
41635,2800,1432,0,60,0,20,60,39,1368
99110,1868,751,0,24,13,0,71,7,1117
54648,1669,857,18,87,25,3,50,22,812
56384,417,199,0,17,1,0,15,9,218
48054,7192,3636,31,200,81,26,229,80,3556
49276,852,465,4,40,27,8,8,6,387
44504,4799,2198,42,157,109,77,178,58,2601
45308,4139,2087,38,153,70,5,113,45,2052
49719,1213,664,0,17,74,0,43,21,549
50521,289,167,0,0,0,0,0,0,122
51012,6386,3190,14,180,63,86,145,185,3196
87499,516,243,6,16,0,0,46,30,273
98851,4295,2097,0,111,76,21,69,145,2198
99224,21241,10385,86,670,196,204,838,276,10856
91768,35389,17170,435,1009,141,558,1127,208,18219
92321,1166,613,8,51,18,0,76,0,553
96020,2242,1164,1,40,81,0,85,54,1078
4488,1563,727,0,36,27,28,58,33,836
5658,1518,694,0,41,23,0,20,33,824
603,48814,23939,330,1539,500,244,1590,638,24875
31090,959,432,0,55,5,0,10,7,527
48047,40434,19736,216,1141,390,178,1209,464,20698
26254,226,111,0,8,10,0,24,7,115
21793,10163,4834,40,400,111,11,367,92,5329
28718,363,172,0,6,15,0,7,8,191
30643,16009,7628,89,361,260,124,551,187,8381
18337,14553,7250,18,444,203,82,518,273,7303
18661,5406,2813,23,159,77,22,191,89,2593
24019,26897,12913,219,957,207,92,930,557,13984
41527,884,528,0,39,0,0,11,0,356
32839,52371,25764,551,2065,433,666,1931,548,26607
33013,32980,16013,145,853,268,285,761,456,16967
33039,356,173,0,0,0,0,0,0,183
33480,10027,4462,10,159,279,20,144,298,5565
28532,22205,11323,299,683,285,255,615,254,10882
38672,13535,6676,38,466,108,0,439,144,6859
52228,3303,1719,0,165,22,0,81,22,1584
53233,14976,7871,674,548,52,1021,97,48,7105
53569,1312,664,6,56,4,10,42,23,648
60429,15387,7218,118,431,100,57,344,289,8169
55767,4517,2908,14,241,92,7,50,35,1609
55972,5296,2626,30,148,23,8,115,60,2670
72523,1186,585,18,0,15,42,11,0,601
16863,700,296,0,10,15,0,28,25,404
16947,4934,2319,35,173,47,18,103,81,2615
21913,884,429,3,33,0,0,31,6,455
22213,3684,1881,35,160,35,7,145,41,1803
12007,0,0,0,0,0,0,0,0,0
19138,32399,14614,302,840,215,239,1050,371,17785
720,21276,10635,225,501,209,349,599,343,10641
38464,22285,10833,87,675,222,78,667,322,11452
38834,28081,13497,172,1034,283,77,1008,291,14584
38951,1298,578,1,48,17,0,49,33,720
39047,38787,18820,382,1582,304,265,1805,515,19967
32009,3821,1935,10,84,22,117,114,53,1886
47648,4242,2108,50,58,38,34,120,47,2134
35962,9516,4868,122,255,72,54,369,65,4648
36471,1057,568,0,44,29,20,18,6,489
24581,44,0,0,0,0,0,0,0,44
25570,6023,2806,104,137,27,80,162,48,3217
43140,24514,14647,186,1215,245,75,458,378,9867
48375,22827,11415,234,708,180,127,1026,331,11412
48891,2750,1324,4,53,37,0,77,68,1426
98935,3422,1790,0,121,68,37,112,46,1632
83840,281,141,0,3,0,0,14,19,140
77655,330,173,2,9,1,3,4,2,157
78503,22034,10861,128,550,309,91,657,121,11173
66622,100,97,0,0,0,0,0,0,3
68638,1838,847,6,45,39,6,56,19,991
56128,2057,1063,10,47,44,0,53,19,994
59351,208,130,0,0,22,0,9,3,78
60481,11540,5857,64,260,131,58,377,167,5683
49626,361,156,0,0,3,0,4,7,205
62910,2365,1123,9,8,10,0,20,40,1242
45316,108,55,4,13,0,0,11,1,53
46974,1882,970,10,94,36,1,67,48,912
71654,4292,2094,0,88,68,15,133,27,2198
54770,2041,1080,22,62,24,24,55,19,961
56014,688,349,1,14,11,2,13,19,339
29935,3928,2039,40,145,90,34,82,80,1889
43033,298,135,2,4,2,0,7,16,163
43435,1345,689,0,25,16,0,17,4,656
44507,5409,2673,12,200,29,12,148,111,2736
35035,1179,723,0,20,0,0,33,15,456
35057,13542,6959,71,378,170,73,582,186,6583
38473,1178,549,12,17,8,7,44,8,629
22971,1505,852,4,0,0,39,29,34,653
27909,39515,19167,369,1141,442,271,1045,498,20348
33772,22517,10320,82,567,358,78,529,391,12197
33782,23052,10734,84,475,354,80,666,374,12318
72156,395,262,12,93,0,0,9,0,133
75009,11941,5984,52,614,143,17,372,176,5957
75244,13701,6439,104,607,108,63,648,191,7262
82938,237,144,0,0,0,0,0,0,93
15625,26,12,0,0,0,0,0,0,14
7979,440,170,0,6,0,20,5,24,270
8244,10521,4834,51,272,123,39,203,241,5687
11206,88349,42822,569,3382,614,642,2901,784,45527
11436,20077,9918,179,663,118,118,817,283,10159
19934,14309,6906,122,483,224,111,331,195,7403
20667,701,357,0,0,0,0,23,15,344
21557,1530,843,31,13,0,27,11,17,687
24861,135,86,0,0,7,0,5,0,49
15051,412,198,0,12,0,13,21,0,214
5048,2912,1529,50,72,76,0,142,93,1383
1005,4991,2468,79,74,124,0,27,108,2523
80102,5648,2953,6,106,76,50,155,93,2695
80728,1156,612,5,47,11,6,47,21,544
83352,3356,1758,5,91,51,0,123,60,1598
78597,2839,1566,0,144,59,0,21,84,1273
96065,359,201,0,4,6,0,13,5,158
87401,47483,23451,242,1683,395,453,1577,573,24032
94709,11740,5828,287,304,113,327,371,135,5912
92782,22704,11188,108,827,114,55,789,396,11516
98922,6522,3598,21,198,171,0,277,136,2924
34287,27532,12933,124,656,372,104,436,273,14599
18407,13287,6156,55,363,134,47,342,212,7131
35097,2004,993,9,35,14,0,33,40,1011
36092,19843,8995,108,522,250,163,741,271,10848
5153,606,280,15,10,39,0,0,6,326
40808,87,47,0,0,0,0,0,5,40
24272,738,432,0,31,48,0,32,6,306
38374,2000,909,0,6,16,19,37,57,1091
16502,15620,7700,159,402,165,189,342,150,7920
50837,341,164,0,8,7,0,24,10,177
13815,12985,6189,68,337,228,83,327,184,6796
14904,15480,7440,138,473,121,107,482,189,8040
52755,1823,967,8,40,18,0,132,35,856
93444,20775,10608,268,608,428,150,688,353,10167
58335,1975,1022,7,65,3,8,80,5,953
95640,10977,7193,111,671,144,61,211,78,3784
59858,1326,702,0,30,33,0,20,24,624
60448,26710,13600,99,957,306,129,788,442,13110
67103,233,133,0,5,0,0,20,2,100
62888,1984,971,3,97,12,19,62,29,1013
21612,360,174,0,6,8,0,5,21,186
63960,2917,1469,5,125,20,0,70,31,1448
84656,312,154,5,7,9,4,9,7,158
68108,15336,8232,86,530,119,142,494,139,7104
95461,2440,1213,18,6,85,0,51,114,1227
72134,210,103,1,19,4,0,4,3,107
76661,8060,3510,11,195,45,37,427,98,4550
90073,916,823,12,82,28,0,16,0,93
54546,1213,641,3,16,29,4,26,30,572
28682,1301,575,0,44,38,0,31,35,726
55943,3010,1530,4,74,39,10,80,50,1480
57261,415,213,0,19,3,0,14,5,202
45120,2750,1472,28,9,21,0,41,83,1278
49036,23612,12459,100,806,269,157,657,284,11153
38559,1096,511,0,24,37,0,25,21,585
32426,914,412,13,17,7,0,26,9,502
40847,372,211,0,21,35,0,0,16,161
34984,15663,8360,145,632,341,149,806,372,7303
42003,28667,13505,149,825,231,187,894,311,15162
97492,743,367,0,15,27,0,5,29,376
33182,17379,9838,169,755,225,88,598,189,7541
83832,1495,739,14,52,25,18,56,8,756
42406,3064,1541,0,74,3,37,120,71,1523
49622,2510,1239,4,88,49,0,54,45,1271
16326,385,216,0,9,7,0,12,0,169
14735,2931,1527,13,70,38,13,70,37,1404
60950,11803,6079,70,353,135,21,363,152,5724
15366,182,65,0,12,0,0,0,10,117
85911,2222,962,22,71,18,16,61,13,1260
23236,25424,11911,88,647,359,80,863,413,13513
24020,613,66,0,0,0,139,6,0,547
22312,33786,17010,184,1462,283,240,1297,514,16776
54801,6672,3332,4,163,161,14,179,138,3340
25051,285,138,0,35,0,0,0,22,147
72350,1080,515,7,26,23,13,23,16,565
29817,4420,1943,20,71,124,63,153,31,2477
81101,15477,7763,96,541,137,227,237,124,7714
28077,464,202,7,9,7,9,13,0,262
33137,23965,12228,81,1363,67,142,1160,332,11737
85621,22274,10684,103,553,184,59,679,340,11590
37688,914,519,5,4,27,0,12,34,395
15459,1630,808,19,68,26,7,35,16,822
78119,7672,5138,78,334,49,0,195,118,2534
20904,57035,26306,233,1758,489,298,2026,667,30729
99655,796,394,6,29,5,3,15,8,402
22539,2294,1170,46,55,50,13,13,14,1124
73505,48713,23182,486,1574,410,651,1730,674,25531
77306,13245,6451,84,196,133,337,390,170,6794
41723,1186,575,0,8,0,0,30,0,611
80526,46346,23106,835,1442,327,1048,1608,536,23240
82934,50,22,0,0,0,0,0,5,28
84309,420,208,0,16,1,1,15,7,212
53530,4407,2239,16,138,43,17,110,81,2168
95573,1554,859,0,105,13,0,41,0,695
72181,8,0,0,0,0,0,0,0,8
95951,2788,1509,35,109,27,33,41,6,1279
50433,329,195,0,32,0,0,30,2,134
91208,16049,7713,45,407,86,44,540,169,8336
54214,220,104,0,4,0,2,5,2,116
79922,8236,4298,58,290,127,99,289,170,3938
65203,57788,27742,584,1767,494,643,1682,836,30046
18472,7443,5271,57,564,82,16,104,80,2172
28466,9294,4263,0,194,85,123,231,127,5031
20772,44948,21632,307,1736,513,206,1366,571,23316
30101,58041,29085,540,1828,430,292,2063,634,28956
2770,5245,2820,13,103,67,45,149,131,2425
96104,603,312,0,7,35,0,0,7,291
57335,283,143,2,8,4,0,4,0,140
70806,29260,13753,279,1123,350,78,905,286,15507
76248,39376,19132,226,1003,361,155,1273,547,20244
77051,17052,7722,167,559,144,77,428,375,9330
83533,241,118,0,4,0,0,12,0,123
91331,105799,52871,1059,3909,936,1001,3712,1170,52928
92570,60944,31492,676,2083,515,578,1519,545,29452
98530,689,317,9,30,13,0,25,0,372
36075,2159,1005,6,45,41,14,40,62,1154
99921,1986,1088,3,69,44,4,64,53,898
27845,2876,1675,12,73,73,0,76,30,1201
97325,6948,3210,69,310,95,118,186,95,3738
27856,16488,8224,89,358,125,154,369,192,8264
65043,10509,5064,83,308,176,116,255,179,5445
66527,264,144,6,8,6,0,4,2,120
49912,913,512,0,14,26,0,10,13,401
30421,3322,1476,0,50,67,0,184,26,1846
54157,5670,2844,30,162,11,3,156,140,2826
50261,2621,1370,24,103,28,0,106,20,1251
70123,26967,13097,156,743,278,82,1024,399,13870
48015,8303,3936,109,490,98,71,443,155,4367
12575,2028,1209,60,88,0,0,83,43,819
22724,2399,1087,0,0,50,0,55,44,1312
23513,31056,15347,347,1209,316,216,1058,299,15709
4475,610,320,3,8,15,0,14,8,290
15313,385,188,0,11,4,2,14,9,197
637,22975,10815,164,534,154,93,686,214,12160
2462,1420,569,0,18,21,0,34,14,851
17868,1129,571,10,18,10,4,17,25,558
19095,7014,3197,28,191,63,70,200,132,3817
80517,10012,4717,37,227,229,43,179,234,5295
80622,170,113,0,19,0,0,0,0,57
81241,114,53,0,1,0,0,0,0,61
83849,2086,1060,0,65,30,0,29,8,1026
84513,1575,784,0,75,30,0,29,20,791
92509,81214,41379,759,2615,619,701,2613,749,39835
92624,6402,3196,0,170,182,28,85,137,3206
87501,15871,7078,0,496,278,35,432,416,8793
97759,7165,3553,2,101,152,17,178,103,3612
98284,26961,13470,312,964,321,105,658,291,13491
99324,9733,4965,141,321,147,111,303,200,4768
95136,47599,22951,264,1593,240,131,1556,592,24648
95230,597,295,0,27,3,19,16,0,302
78377,3712,1773,7,80,33,27,86,23,1939
78840,48143,24352,307,1445,403,370,1483,571,23791
5405,4327,1854,72,0,0,77,0,0,2473
54923,8816,4371,18,230,119,29,223,132,4445
69042,12,6,0,1,0,0,0,0,6
20373,144,133,44,0,0,6,0,0,11
3607,440,220,0,11,4,0,6,16,220
16217,65,43,0,0,2,0,0,0,22
48838,18301,9039,65,799,203,224,617,161,9262
51652,1631,836,3,51,14,3,61,25,795
54304,27613,13886,183,946,303,93,886,298,13727
54513,433,229,0,19,7,3,14,17,204
56232,2500,1247,7,58,29,27,84,65,1253
56354,1387,699,0,31,31,4,42,26,688
57642,1997,966,14,40,18,24,69,16,1031
45679,2830,1352,16,100,45,3,59,14,1478
35243,17259,8272,127,524,231,56,597,284,8987
50032,277,101,0,25,0,0,26,60,176
50146,428,211,0,6,4,0,11,14,217
43908,1599,743,0,22,23,8,92,48,856
56325,197,97,0,1,0,0,10,1,100
56760,337,197,1,7,0,0,6,7,140
57274,2589,1300,11,69,37,0,74,23,1289
41604,375,139,0,0,0,0,0,0,236
42732,2109,1021,23,97,41,27,147,45,1088
34685,18899,9057,45,433,287,146,504,354,9842
36110,11829,5650,93,322,52,181,406,140,6179
3254,4095,2003,0,90,107,25,72,38,2092
4476,1180,618,9,15,33,0,49,8,562
92313,12512,6011,93,402,76,20,474,226,6501
92651,24746,12213,221,486,327,98,613,557,12533
93021,38063,18299,274,1038,372,332,1185,577,19764
98014,6911,3437,33,227,146,24,184,167,3474
98662,32430,15745,180,1025,397,162,1232,314,16685
84604,46467,22449,1335,762,319,1660,959,239,24018
85053,29976,15246,172,1047,184,182,984,384,14730
85737,21795,10497,207,425,379,69,734,392,11298
86320,2045,1057,0,33,60,0,58,0,988
75860,6572,3972,34,335,48,0,225,61,2600
79837,278,141,0,5,6,0,0,0,137
88027,292,134,0,0,0,0,0,10,158
89122,49934,24205,310,2069,772,260,1961,587,25729
10989,9300,4135,1,291,137,0,384,184,5165
6708,29709,14286,176,820,241,102,1047,504,15423
719,29119,14252,283,824,199,247,998,347,14867
48629,7372,3669,67,197,99,29,208,175,3703
48809,10789,5168,143,425,96,54,312,124,5621
15870,1106,541,0,19,17,0,22,28,565
16038,3647,1863,30,136,73,16,99,91,1784
7640,4761,2282,0,62,64,0,71,93,2479
12169,222,92,0,16,0,4,16,9,130
12732,689,330,0,79,11,8,26,19,359
22655,20916,10206,73,559,162,99,633,177,10710
24941,1058,604,5,44,9,0,15,22,454
58254,425,221,1,10,13,0,7,16,204
15701,34184,17134,966,781,384,983,659,385,17050
16365,17803,8554,61,324,326,86,426,391,9249
16370,162,104,1,1,12,0,2,4,58
17104,19907,9327,217,471,78,216,647,296,10580
7760,8867,4385,4,170,120,11,231,126,4482
12106,2427,1277,20,61,82,6,52,64,1150
12404,3306,1618,37,149,15,0,93,85,1688
21918,3853,2030,14,87,47,13,50,112,1823
23408,77,24,0,0,0,0,0,0,53
14485,3989,1997,12,134,53,26,97,80,1992
3743,13676,6489,40,282,169,91,361,199,7187
4485,208,96,0,15,2,5,7,1,112
35223,11251,5282,85,248,195,30,361,171,5969
35776,3592,1888,43,75,36,10,125,63,1704
36611,5837,2556,59,90,18,25,183,74,3281
36749,779,401,0,24,59,0,11,26,378
38564,366,205,0,17,11,0,13,7,161
40059,19585,9530,19,485,321,98,603,401,10055
45032,364,161,0,24,0,0,17,4,203
30116,24161,12078,186,796,194,174,846,265,12083
27207,3149,1422,39,41,44,9,42,26,1727
27569,7942,3881,14,404,80,41,206,134,4061
97117,637,350,5,5,33,0,20,29,287
99555,204,113,0,3,0,0,8,1,91
80215,19415,9697,223,705,267,83,579,248,9718
84733,155,53,0,0,0,0,0,0,102
76858,256,129,0,15,0,0,28,2,127
77503,25738,12857,41,822,176,94,713,261,12881
78109,40011,19252,179,1584,209,193,1452,418,20759
94005,4692,2214,51,259,43,27,240,100,2478
90623,15813,7792,97,383,192,79,382,332,8021
90745,56821,27739,558,2006,508,454,1946,830,29082
92347,843,406,0,47,11,51,37,0,437
92374,43633,21227,712,1536,402,559,1466,571,22406
63041,584,321,0,0,3,0,0,2,263
57038,1580,783,2,61,3,5,105,30,797
58702,0,0,0,0,0,0,0,0,0
59082,57,34,0,1,0,0,1,0,23
65733,794,425,0,13,9,0,7,0,369
66741,177,87,0,14,4,8,0,0,90
68343,989,519,16,27,9,0,49,28,470
68653,701,395,4,21,24,0,24,19,306
68669,405,212,0,3,12,0,7,12,193
68710,743,367,0,6,10,7,10,18,376
60561,23163,11115,114,615,408,90,706,432,12048
61534,1806,946,3,70,40,8,49,23,860
54545,823,421,0,3,14,0,3,10,402
70660,1656,921,33,14,65,0,34,37,735
72001,677,350,0,10,3,0,14,24,327
72011,4295,2029,18,238,21,15,197,130,2266
72020,3854,2036,21,158,74,3,88,14,1818
62214,1242,620,0,65,30,0,27,16,622
76621,870,422,3,35,11,0,29,29,448
76685,20,20,0,0,0,0,0,0,0
78024,1152,615,0,4,7,0,18,27,537
80002,18266,8692,116,654,215,123,644,253,9574
59088,1437,781,16,40,22,0,7,0,656
60022,8477,4196,55,200,107,52,146,180,4281
72644,2502,1310,4,23,4,3,16,33,1192
80545,845,451,0,31,29,0,18,18,394
74641,637,344,0,19,10,8,14,10,293
91737,25339,12225,129,560,184,206,835,437,13114
93109,11573,6111,301,245,253,65,246,155,5462
93921,3379,1582,0,90,105,0,38,19,1797
94945,19035,9184,65,506,222,75,616,340,9851
99034,1,1,0,0,0,0,0,0,0
99652,3183,1628,18,75,84,12,111,37,1555
87560,1220,692,0,17,48,0,0,94,528
88414,41,19,0,0,0,0,0,3,22
97037,881,459,0,45,41,6,13,36,422
3902,2593,1466,0,110,43,0,78,19,1127
6479,9592,4821,39,210,115,30,401,88,4771
6901,7049,3401,4,348,119,0,377,34,3648
2453,28877,14097,409,1088,287,294,888,297,14780
30273,14663,7054,73,515,20,141,923,288,7609
31824,1695,834,35,15,39,0,104,40,861
32086,29568,13812,111,690,461,248,815,585,15756
32617,3937,1832,55,161,42,65,43,36,2105
14126,531,231,0,39,0,27,0,31,300
16438,7617,3525,50,171,103,73,158,107,4092
24887,53,36,10,6,0,0,10,0,17
22932,7792,3829,22,255,27,42,468,166,3963
20912,26239,12902,156,1174,253,142,1130,378,13337
21120,7214,3676,26,136,65,16,190,141,3538
77475,889,388,0,49,0,0,48,34,501
78956,5383,2459,0,156,61,39,44,73,2924
80025,365,154,0,0,12,0,2,0,211
64723,798,451,19,17,24,11,20,14,347
67004,756,322,3,22,9,0,18,8,434
75706,9505,4903,126,378,41,110,168,108,4602
75937,925,492,11,19,14,0,30,15,433
70575,111,63,0,17,0,0,17,0,48
93926,9262,4787,101,266,41,27,265,110,4475
95346,1661,931,0,0,41,0,0,0,730
81221,346,176,0,15,4,2,20,1,170
75253,23894,11787,279,858,85,26,951,129,12107
66206,10781,5217,62,401,107,0,430,138,5564
89319,142,76,0,0,12,0,0,10,66
72453,166,89,0,3,1,0,3,2,77
72479,1237,550,8,8,8,12,66,32,687
72712,53959,27696,153,2638,331,176,2415,573,26263
46573,3744,1887,21,72,67,23,101,32,1857
37416,15364,6799,117,372,139,151,559,221,8565
38871,1988,911,5,76,13,10,30,19,1077
60034,2077,1082,0,49,14,11,33,24,995
61057,111,50,0,10,0,0,0,8,61
62883,899,488,0,7,0,0,24,12,411
56118,471,228,0,26,4,3,22,0,243
52548,96,47,0,1,1,2,0,1,49
54611,1176,592,2,31,18,4,53,18,584
54817,2092,1051,3,36,40,0,30,56,1041
55112,45895,21848,291,1377,467,320,1426,562,24047
48635,1618,756,9,54,8,15,49,38,862
51103,17356,8471,101,430,91,67,630,190,8885
1464,7598,4523,148,362,113,104,71,215,3075
13730,2683,1479,4,49,25,0,43,10,1204
38556,11919,5706,60,307,178,142,327,177,6213
16041,2199,1090,16,53,20,5,41,44,1109
55385,1239,660,5,33,17,5,41,15,579
25036,231,139,0,0,0,0,35,0,92
47542,10196,5288,74,218,62,0,247,108,4908
50586,287,140,0,25,2,0,12,2,147
43608,14570,7399,108,579,83,81,514,205,7171
23075,9384,3996,62,156,140,106,443,153,5388
60104,18999,8828,172,650,131,299,589,344,10171
27559,2225,1145,0,58,55,0,44,26,1080
60176,11704,6071,49,539,132,125,538,96,5633
28125,2262,1130,0,63,51,0,130,0,1132
64096,1178,557,14,44,12,12,22,15,621
18651,8511,4144,30,146,91,26,224,137,4367
48917,32264,15299,187,878,306,196,988,611,16965
19541,4301,2192,13,82,56,6,142,110,2109
33409,33875,16145,224,959,394,400,1216,400,17730
28671,577,252,0,13,6,0,25,3,325
29420,22609,11130,157,907,123,184,898,334,11479
12928,1858,1002,54,71,48,15,67,17,856
21207,47687,21805,210,1304,449,317,1351,535,25882
77563,10680,5400,45,268,115,39,328,176,5280
12192,1954,963,36,52,94,0,36,9,991
12913,1162,583,0,34,12,0,13,25,579
14042,3966,1973,17,85,33,0,96,84,1993
66030,23546,11388,107,1053,216,120,1167,303,12158
14145,1785,845,7,63,51,22,21,19,940
68152,6327,3029,37,132,68,44,121,97,3298
24526,1366,602,11,61,47,0,23,6,764
62833,371,202,0,0,5,0,39,5,169
34711,60564,29676,407,1264,1019,429,1257,709,30888
72410,360,203,0,31,4,0,14,0,157
76006,24774,12381,114,985,162,73,832,203,12393
15085,7581,3741,0,177,158,0,287,106,3840
688,12202,6260,137,466,136,18,416,167,5942
1003,11238,5769,837,2,0,892,7,0,5469
55712,595,329,3,4,24,0,16,19,266
4576,587,275,0,15,20,0,7,11,312
5036,1089,550,8,14,28,10,22,6,539
68441,217,86,0,2,4,0,0,3,131
24333,17733,8712,56,486,252,65,598,262,9021
76556,1372,719,10,33,22,38,29,27,653
77661,742,352,0,0,0,46,0,0,390
63876,2302,1049,0,56,32,11,51,35,1253
57555,4424,2200,16,144,30,13,166,31,2224
73135,22790,11214,101,810,201,195,876,248,11576
85646,1286,686,0,13,0,0,0,41,600
88355,0,0,0,0,0,0,0,0,0
99353,15871,7921,75,609,139,53,756,172,7950
95925,209,89,0,0,0,0,0,0,120
96048,713,331,0,20,39,0,37,13,382
47016,949,456,0,15,16,59,30,4,493
92602,26044,12475,72,1035,291,137,1197,194,13569
92677,66406,32320,200,1648,786,222,1931,1261,34086
28675,7033,3418,62,176,88,0,191,41,3615
38585,3970,1968,48,120,65,0,82,81,2002
32608,48905,23443,1100,1625,490,1708,1554,440,25462
46347,4852,2389,0,189,46,24,137,62,2463
32062,2085,1120,0,56,24,0,12,26,965
33625,26242,12539,109,767,354,154,874,436,13703
84714,344,201,0,0,16,0,0,0,143
85024,24675,12411,77,965,123,128,781,251,12264
31329,9950,4986,114,322,77,92,216,73,4964
33317,38360,19252,245,1386,561,207,1472,529,19108
89512,26418,13312,338,706,268,316,874,194,13106
62704,40828,19724,219,1664,527,296,1209,487,21104
29450,3548,1575,33,119,41,86,59,26,1973
56627,273,127,3,4,2,0,6,10,146
30126,41665,19690,134,1311,134,409,1799,579,21975
67485,318,180,0,0,5,0,8,0,138
68036,182,87,0,0,0,0,0,9,95
35554,1054,510,7,28,15,1,10,33,544
69331,83,29,0,0,0,0,7,0,54
13403,7258,4754,88,426,81,11,89,15,2504
60074,39478,20116,118,1519,359,213,1458,414,19362
5485,110,39,0,8,0,0,6,0,71
47654,82,39,0,0,0,0,0,0,43
49220,2412,1257,3,97,48,0,93,30,1155
50047,6120,3008,0,230,53,15,202,30,3112
34145,17692,8675,12,223,347,0,197,214,9017
99134,592,304,0,26,8,0,30,6,288
79035,5177,2771,25,121,62,52,108,46,2406
66536,4267,2031,52,67,16,60,45,43,2236
81524,1817,915,0,23,8,0,26,0,902
67062,4431,2267,118,136,35,0,50,72,2164
97121,1412,736,9,12,17,0,100,30,676
97403,13021,6542,488,344,86,499,188,84,6479
75051,41479,20178,253,1375,253,338,1273,367,21301
75943,1344,722,10,18,8,0,48,30,622
57442,1801,951,6,39,38,0,40,24,850
58788,1257,694,0,37,21,0,44,20,563
72085,240,111,3,12,0,0,6,1,129
73463,3451,1768,14,138,28,21,163,27,1683
53928,106,53,0,0,0,0,1,1,53
44608,2439,1301,19,70,11,23,45,34,1138
94536,73855,37138,363,3711,409,351,3276,893,36717
48108,26185,12820,233,1003,234,329,670,321,13365
98058,43523,21799,118,1521,408,143,1570,695,21724
30318,54152,29044,693,2241,314,412,2150,363,25108
99790,10,6,0,0,0,0,0,0,4
95693,6759,3239,32,93,158,24,82,170,3520
96732,29668,15079,144,818,412,339,923,319,14589
34607,8778,4242,20,51,283,19,143,246,4536
17855,1098,519,10,42,5,16,39,16,579
29356,8459,4208,35,207,120,16,182,89,4251
44473,3609,1828,57,158,42,16,53,54,1781
19070,7017,3400,21,326,119,39,210,130,3617
19140,51667,24630,294,1627,349,593,1599,695,27037
12993,1387,746,9,17,36,0,13,23,641
13421,13291,6473,114,409,230,36,274,146,6818
5730,279,153,0,11,4,0,9,0,126
7036,43607,20816,209,1560,461,360,1445,505,22791
7524,13239,6323,191,523,92,154,407,192,6916
67144,2689,1435,4,114,50,28,60,79,1254
68029,838,392,7,22,0,0,19,8,446
70734,7413,3650,0,236,45,24,396,22,3763
71972,377,170,0,8,13,0,0,0,207
62269,32029,15694,204,1358,271,160,1376,397,16335
64077,1546,766,10,25,16,2,21,30,780
77441,11308,5683,71,409,129,28,549,137,5625
77987,270,156,0,0,3,0,6,0,114
79054,709,352,4,0,1,5,26,5,357
58844,93,30,0,0,0,3,6,5,63
59016,1131,491,40,23,13,16,27,9,640
59327,2691,1396,0,61,8,15,106,9,1295
72165,120,49,0,16,0,0,0,0,71
72860,611,306,0,22,0,0,34,0,305
73058,193,87,0,3,11,0,6,2,106
83543,797,418,0,23,7,0,15,18,379
83629,1722,895,0,32,40,2,39,45,827
85546,20765,11729,210,854,129,129,473,207,9036
85935,4832,2551,0,74,26,0,80,133,2281
83263,9354,4798,1,265,122,39,302,144,4556
64642,867,386,0,25,8,5,31,14,481
66056,1840,862,3,79,14,0,87,21,978
91306,49158,24678,414,2005,405,177,1754,601,24480
92154,86811,44887,763,3448,757,820,2822,1088,41924
92606,24694,12292,147,934,101,304,1122,56,12402
98117,35111,17313,34,1829,286,54,1580,535,17798
99518,10450,5630,41,499,66,0,454,127,4820
3452,5307,2600,119,61,46,113,123,126,2707
3890,149,59,0,0,0,0,0,0,90
7721,3003,1548,0,112,28,10,40,37,1455
1262,1066,378,0,14,18,21,30,20,688
32140,1393,707,0,0,60,0,16,20,686
32668,4700,2408,37,113,47,9,79,103,2292
15464,1669,909,29,133,0,0,110,4,760
23160,2661,2635,11,302,7,0,0,0,26
25671,1376,725,0,37,39,0,44,0,651
20833,7750,3587,0,228,115,86,227,104,4163
20852,46904,21570,208,1786,416,371,2347,592,25334
23015,4047,2007,0,147,69,0,59,44,2040
17860,2559,1319,7,76,47,0,102,67,1240
18223,177,93,0,0,0,0,0,0,84
2726,15786,7688,34,380,273,36,409,173,8098
2804,2004,934,0,31,12,0,48,13,1070
87328,2411,1104,27,40,8,32,102,26,1307
88045,3450,1623,5,146,34,15,71,36,1827
72321,141,78,2,5,5,0,5,0,63
73645,1436,699,21,28,45,0,43,25,737
73651,3968,1979,0,128,51,12,72,15,1989
67347,484,247,3,2,3,0,6,19,237
68506,29097,13733,184,936,363,348,874,397,15364
63774,144,94,0,0,0,0,0,0,50
83278,320,177,0,52,0,0,0,15,143
84052,1566,782,0,113,16,11,72,10,784
85351,29107,11771,67,15,736,0,63,761,17336
76637,558,254,0,21,4,0,14,12,304
77426,2096,1020,8,33,82,75,63,7,1076
60559,24529,11651,170,856,263,91,740,430,12878
61015,1107,506,0,53,1,82,13,15,601
61263,743,359,4,13,10,0,17,9,384
62040,42447,20951,308,1344,518,181,1394,776,21496
79404,10400,5368,66,359,149,74,248,87,5032
79416,33796,16146,528,1164,163,689,899,396,17650
49884,359,192,0,5,12,0,4,11,167
78734,18745,8970,11,519,283,9,525,424,9775
42343,1508,747,0,69,16,7,46,25,761
59337,768,418,20,12,29,0,19,14,350
59936,401,208,6,2,4,0,0,17,193
22436,451,173,0,21,0,25,0,41,278
62009,1814,959,0,66,37,0,73,23,855
29452,484,248,64,30,0,0,0,18,236
93621,94,64,0,0,0,0,0,0,30
95003,24837,11696,135,552,464,75,819,368,13141
18371,864,469,21,110,0,0,47,0,395
18940,29039,14184,84,779,304,127,847,549,14855
32304,47787,23391,3137,530,97,2738,533,190,24396
35581,5709,2406,37,187,38,80,82,94,3303
25271,9630,4869,31,235,119,0,292,275,4761
27291,1735,909,37,21,12,0,31,29,826
27530,38865,18788,274,1136,416,172,947,628,20077
30285,639,304,40,16,45,0,13,0,335
30326,6030,2788,0,172,0,0,225,77,3242
30423,121,66,0,0,0,0,0,4,55
7012,12181,5957,40,463,89,62,412,175,6224
7092,6900,3299,68,160,72,0,155,143,3601
10923,8244,4143,52,118,77,62,135,121,4101
10990,20010,9734,153,483,170,38,431,329,10276
13136,407,234,11,19,2,0,25,4,173
4983,1857,899,3,38,8,0,36,29,958
5039,1129,552,0,9,2,7,13,15,577
70068,34262,16562,193,1159,386,220,1634,498,17700
71419,2156,1191,62,63,73,10,80,46,965
71749,2493,1248,0,43,26,19,77,13,1245
48429,8847,4223,6,249,93,27,311,54,4624
48441,4008,2052,12,104,74,23,113,87,1956
76632,1732,854,0,7,34,0,22,37,878
67656,34,17,0,0,0,0,0,0,17
67849,396,217,4,8,12,0,9,11,179
68111,21479,10012,167,531,146,131,891,325,11467
83802,205,138,0,0,0,0,0,19,67
39177,142,66,0,5,2,0,0,6,76
47403,33370,16523,385,1431,223,306,1058,534,16847
64870,15153,7576,77,555,113,75,670,50,7577
65247,684,344,0,13,9,0,0,7,340
66517,1745,853,27,46,40,0,48,4,892
67351,257,109,0,2,0,5,2,2,148
77445,13524,7266,191,230,210,95,356,185,6258
77565,7945,3983,29,207,83,28,316,211,3962
80136,5026,2329,46,149,26,23,170,69,2697
80290,0,0,0,0,0,0,0,0,0
58640,1565,818,0,40,0,0,47,11,747
59418,182,104,0,2,0,9,14,0,78
73040,1821,764,0,88,11,5,22,22,1057
73842,549,239,7,14,13,0,18,10,310
14227,21846,10667,181,646,190,139,482,435,11179
14748,619,287,0,18,6,8,15,19,332
15437,2734,1284,18,114,27,41,89,68,1450
15828,225,120,0,1,10,0,5,5,105
15927,955,398,4,21,0,0,49,0,557
8829,3558,1813,15,131,8,13,129,58,1745
28732,17479,8475,78,612,171,41,790,354,9004
54465,547,269,0,2,23,0,10,21,278
37385,8284,3905,13,226,69,10,130,237,4379
38075,6668,5251,77,709,126,0,67,43,1417
13113,304,145,0,19,5,0,10,2,159
15725,1584,771,23,12,27,14,42,18,813
16634,340,160,1,19,4,2,25,3,180
18344,3810,1815,0,174,18,25,127,89,1995
18349,100,35,0,0,0,0,30,0,65
2671,877,461,19,21,0,0,8,8,416
3907,1163,545,5,6,17,5,34,6,618
4092,18417,9210,74,406,239,69,499,226,9207
75788,109,71,0,0,0,0,0,0,38
67762,245,126,0,10,4,0,13,3,119
73720,146,99,0,3,2,0,0,0,47
74425,1448,660,2,22,31,15,21,21,788
64664,446,227,0,10,6,0,24,8,219
65349,2539,1267,13,76,31,32,97,9,1272
27017,9236,4601,36,227,60,73,173,98,4635
45657,1925,1015,4,95,17,22,53,11,910
47597,843,424,13,23,14,5,46,13,419
19938,8808,4252,50,339,65,35,374,131,4556
50035,7660,3819,0,331,35,21,232,52,3841
50672,581,292,0,34,8,0,16,10,289
52078,647,318,13,15,8,10,14,19,329
53226,18907,8985,140,683,205,122,624,208,9922
80863,12670,6308,106,411,262,37,482,149,6362
84753,12,10,0,0,0,0,0,0,2
93452,795,537,62,24,0,0,41,8,258
95133,28726,14288,244,980,305,201,905,535,14438
95687,68069,35885,440,2563,708,318,2181,1081,32184
86538,2026,977,11,73,14,12,58,22,1049
89425,426,189,0,0,16,0,46,24,237
61447,1025,514,0,21,5,7,21,30,511
92549,2464,1237,4,21,48,5,56,35,1227
11942,4597,2095,7,56,56,0,84,88,2502
12803,8525,4066,73,280,83,61,291,168,4459
13088,21986,10040,112,701,269,118,709,287,11946
19047,35476,17674,233,1165,445,175,921,591,17802
46342,30634,14581,250,1272,317,131,1439,371,16053
35222,9033,4527,93,408,135,77,396,102,4506
35775,1083,552,0,0,0,1,0,0,531
36277,5529,2550,51,138,105,0,315,52,2979
26601,4970,2680,45,220,83,0,155,117,2290
40962,18220,9667,113,861,189,101,480,211,8553
28618,2581,1319,0,71,52,0,52,34,1262
47849,331,175,0,7,17,0,0,22,156
97053,3218,1622,0,178,132,0,179,98,1596
97351,10585,5191,109,349,70,100,330,110,5394
99557,698,397,2,32,9,6,17,11,301
82430,77,34,0,5,0,0,3,2,43
83314,975,451,2,34,8,7,19,6,524
83811,1255,670,8,64,11,0,16,2,585
76874,0,0,0,0,0,0,0,0,0
77038,31365,15826,185,1386,234,125,1282,389,15539
78404,18376,8999,47,771,223,24,578,240,9377
68313,593,312,0,23,3,0,8,25,281
68428,1358,667,0,13,15,10,26,8,691
56183,1255,596,2,42,19,13,13,32,659
54007,1116,592,2,67,27,15,19,14,524
63089,5409,2756,16,170,134,16,94,71,2653
16832,671,377,17,35,3,0,15,2,294
45347,4479,2095,27,80,69,31,109,124,2384
11422,32082,14880,276,1130,210,241,1127,469,17202
71653,4506,2008,9,161,73,6,147,69,2498
18042,42357,20953,426,1026,320,459,1556,572,21404
60629,111850,54815,910,4499,774,996,3582,1058,57035
28901,4874,2360,27,28,10,26,99,93,2514
29330,8987,4310,68,273,114,123,266,66,4677
27406,63465,28967,403,2123,460,660,2371,764,34498
27054,2388,1075,29,59,27,0,84,0,1313
24848,145,74,0,9,0,0,6,0,71
68339,1298,638,15,29,16,18,15,8,660
26260,1537,781,0,59,94,17,39,46,756
25425,13600,6752,81,365,145,101,434,184,6848
2047,92,52,0,0,20,0,0,0,40
18248,560,307,0,25,16,0,21,0,253
44680,4455,2248,50,165,17,15,165,59,2207
17109,23530,11109,214,764,237,119,936,391,12421
60554,12166,6172,98,401,207,29,210,276,5994
7060,45986,23373,400,2096,509,193,1580,501,22613
62280,445,255,0,34,0,0,10,0,190
20171,50342,25110,152,2016,419,170,2533,586,25232
70079,2917,1454,10,93,20,0,156,25,1463
24350,1286,623,0,33,48,0,0,41,663
79226,2898,1422,32,63,20,22,79,36,1476
75651,1870,963,14,35,41,0,39,12,907
56113,245,120,3,23,0,0,21,0,125
82421,308,164,3,7,9,0,3,5,144
57374,293,156,0,3,3,0,11,3,137
83530,5725,2823,25,174,84,29,101,135,2902
72576,3915,1925,33,162,37,57,66,171,1990
84306,430,225,0,12,0,0,26,0,205
96068,193,150,0,28,0,0,0,0,43
80536,2153,1060,14,108,87,0,18,35,1093
97539,3314,1765,0,53,10,0,69,125,1549
83324,743,352,0,20,11,0,24,20,391
88260,15142,7693,106,477,77,126,511,114,7449
89049,2554,1338,7,77,47,0,71,63,1216
93517,526,335,0,2,36,2,0,23,191
95345,749,277,0,16,12,0,0,0,472
94850,0,0,0,0,0,0,0,0,0
30127,67688,32859,340,1995,634,386,2396,877,34829
98237,4361,2120,49,110,39,3,129,59,2241
31322,25459,12147,156,1082,199,33,662,417,13312
6039,2028,1019,0,94,52,0,109,0,1009
45030,19125,9242,95,600,100,58,704,317,9883
51550,149,77,0,5,1,2,1,3,72
43113,24341,11831,217,691,278,157,766,323,12510
19507,3163,1558,3,115,26,48,82,18,1605
47550,744,339,0,31,0,0,20,0,405
14891,4210,2016,12,132,62,16,102,87,2194
21650,290,186,0,0,0,0,0,14,104
10032,64264,32163,427,2634,558,475,2088,927,32101
91724,26091,12726,226,824,313,73,578,427,13365
54428,964,490,6,13,35,0,11,12,474
95912,5010,2658,74,109,39,0,151,30,2352
98365,4962,2491,0,48,129,0,0,205,2471
72114,11849,5442,95,357,191,45,537,168,6407
86506,1165,573,14,20,2,6,11,34,592
61314,885,441,0,32,3,4,14,19,444
70084,6436,3263,12,53,27,16,113,158,3173
80112,33081,17083,140,1577,248,125,1020,369,15998
31796,1130,538,0,14,60,0,13,19,592
67356,2790,1466,13,65,24,20,101,34,1324
68644,578,296,8,2,9,6,4,12,282
68959,3898,1951,18,193,71,11,119,81,1947
74063,31703,15886,180,912,372,226,892,438,15817
77369,571,262,0,0,0,0,29,13,309
46770,2992,1467,11,79,41,30,129,83,1525
60083,9990,5004,100,346,30,26,413,97,4986
54772,1053,567,4,60,17,2,39,16,486
27540,37520,18011,121,1433,142,200,1817,223,19509
57426,51,33,0,0,0,0,0,0,18
33744,145,123,0,0,0,0,0,0,22
16230,416,180,2,16,1,7,14,8,236
48114,20754,10484,171,633,266,116,610,299,10270
43777,4823,2388,62,142,53,31,194,87,2435
46962,9152,4364,85,231,127,147,219,81,4788
12736,58,36,0,0,4,0,0,0,22
53072,25357,12369,138,743,337,64,694,379,12988
84501,13469,6677,120,317,126,74,524,158,6792
39350,25090,11697,86,648,137,140,675,382,13393
60150,1692,897,0,67,18,4,25,30,795
62963,653,318,9,10,5,8,25,5,335
64089,12910,6238,43,366,82,34,426,168,6672
70363,25335,13246,271,1237,218,97,939,445,12089
74051,2027,1122,4,25,32,0,65,89,905
6784,3738,1792,55,47,29,16,39,65,1946
77532,29608,14622,178,1122,334,157,979,313,14986
22035,0,0,0,0,0,0,0,0,0
67427,382,168,0,11,4,0,7,3,214
62011,172,100,0,12,4,0,3,0,72
68843,770,370,0,24,8,0,20,12,400
18469,235,148,0,0,0,0,8,8,87
65075,927,480,8,35,5,5,33,6,447
14878,484,216,0,7,17,0,3,10,268
80743,1043,538,1,27,29,12,16,16,505
15616,0,0,0,0,0,0,0,0,0
82942,141,42,0,0,0,0,0,0,99
25873,446,263,0,21,24,0,14,32,183
17028,3879,1945,16,130,194,15,160,151,1934
31410,24445,11793,215,756,392,106,848,299,12652
30601,23685,11651,590,601,154,621,499,257,12034
23963,121,49,0,0,0,0,0,0,72
37184,6002,2937,29,125,61,11,218,8,3065
23043,2073,1126,37,94,49,0,53,0,947
56078,487,238,4,13,6,5,22,9,249
29516,1038,460,0,0,11,0,36,11,578
49237,3010,1529,38,75,25,0,79,30,1481
30104,4960,2725,38,50,72,10,111,26,2235
50455,630,320,12,13,11,0,3,1,310
12592,1243,537,16,45,11,14,74,48,706
14031,10301,5182,18,371,129,114,304,107,5119
51632,7012,3885,13,278,163,31,255,63,3127
53585,2243,1100,4,69,35,11,103,14,1143
17355,274,157,10,2,17,0,4,4,117
37209,38794,18517,412,1446,211,241,1268,269,20277
17044,21047,10189,181,399,201,81,486,323,10858
10970,10055,4889,69,114,145,94,354,189,5166
13662,16069,7238,46,679,191,114,368,279,8831
1440,20555,10487,130,611,216,177,513,303,10068
17740,12526,6292,83,418,158,48,293,150,6234
18705,14426,7242,155,500,215,86,421,170,7184
75206,38375,19859,286,1513,197,162,1331,441,18516
78014,5631,3341,0,129,83,54,182,33,2290
84082,866,428,9,51,7,0,28,0,438
84746,933,453,0,19,0,0,28,15,480
85328,302,190,0,0,0,0,0,0,112
88124,1037,539,8,31,23,0,26,6,498
78654,18450,8848,152,690,195,98,612,351,9602
70577,4105,2069,0,115,92,30,58,103,2036
73459,1063,526,12,35,10,7,23,16,537
90808,38860,18819,104,1169,430,77,1424,671,20041
91792,29839,14596,246,988,306,181,959,409,15243
5647,1024,463,5,68,49,5,43,13,561
5872,815,402,0,24,3,4,17,0,413
6798,9617,4575,47,287,72,57,195,220,5042
65345,281,143,0,0,0,0,27,0,138
66425,464,254,4,3,5,5,13,20,210
58570,423,247,0,7,0,0,6,8,176
59467,117,61,0,8,6,0,0,0,56
59483,600,324,5,8,5,0,7,10,276
59827,225,134,0,0,9,0,0,5,91
59847,5712,2860,0,133,26,7,150,91,2852
54130,25700,13048,143,1074,341,56,833,371,12652
37347,7871,3730,13,214,154,0,250,131,4141
23884,33,23,0,3,0,0,0,0,10
44106,25752,12114,381,500,206,626,637,337,13638
44429,2544,1242,0,47,35,11,90,30,1302
55044,53547,26888,186,1577,500,174,1740,648,26659
60827,28577,12911,253,568,230,234,850,465,15666
47515,821,412,18,0,0,0,0,12,409
46032,48853,23502,118,1720,564,103,2094,775,25351
49930,7279,3727,64,156,101,111,150,69,3552
34746,43249,20833,261,1432,506,239,1349,639,22416
39705,13243,6405,101,315,142,54,392,218,6838
87557,6399,2927,52,178,16,124,161,155,3472
88052,200,151,0,0,0,0,0,0,49
98232,4542,2332,21,77,77,109,176,90,2210
98465,7008,3516,115,231,69,41,134,93,3492
98855,5870,2997,49,203,253,8,143,86,2873
1505,4581,2238,23,131,54,43,233,60,2343
2163,2401,1157,30,57,0,19,26,0,1244
49318,1573,865,12,52,46,18,24,16,708
31791,12138,5750,21,232,94,112,252,195,6388
33844,35280,16800,121,957,499,73,1264,261,18480
35650,13992,6479,158,308,93,136,533,284,7513
37326,479,196,4,2,5,0,0,0,283
17934,413,209,0,6,7,2,8,7,204
22504,439,183,0,0,0,0,5,0,256
26291,158,83,0,13,0,0,15,0,75
43610,4343,2038,11,95,25,12,201,83,2305
33776,12872,6063,11,309,236,34,278,227,6809
26761,583,384,0,18,9,13,13,0,199
27016,1395,735,0,21,33,0,15,21,660
27562,1752,938,0,52,6,0,41,13,814
28529,1706,896,2,51,22,71,61,19,810
38683,5412,2621,0,113,53,39,159,144,2791
49901,199,84,1,7,0,0,4,12,115
51640,1495,754,11,14,36,5,42,31,741
56732,1102,518,3,35,9,17,15,15,584
58654,357,174,0,17,18,0,9,9,183
59018,519,261,2,2,6,0,10,3,258
44011,22786,11138,59,662,151,55,926,209,11648
44827,6980,3599,27,240,161,7,203,113,3381
66023,1148,618,26,15,19,0,33,0,530
66067,15253,7260,89,489,191,155,499,201,7993
62666,613,314,0,34,14,0,11,6,299
55318,27657,13591,55,1050,201,152,1069,382,14066
54928,385,196,0,7,6,0,15,5,189
74729,2925,1435,20,81,38,29,110,26,1490
75166,4297,2262,10,154,31,36,158,57,2035
75560,857,406,0,17,2,18,35,2,451
97057,14,7,0,0,0,0,1,0,7
97107,1724,916,6,51,45,4,51,32,808
98239,7273,3692,37,152,119,0,151,273,3581
98546,3259,1729,7,62,44,13,93,46,1530
33414,61301,29141,200,1635,581,231,2331,631,32160
7205,21895,10280,228,409,407,365,611,355,11615
1022,2499,1248,30,100,13,9,57,34,1251
1118,14980,7188,49,488,107,90,553,273,7792
35139,170,71,0,0,0,0,0,0,99
35968,4584,2238,51,145,4,117,190,31,2346
36432,2223,996,4,90,54,10,71,38,1227
38042,726,334,0,0,20,0,3,2,392
38317,2477,1139,49,58,64,5,67,26,1338
38463,2214,1181,16,36,40,12,51,55,1033
97502,28300,13799,87,730,222,68,929,470,14501
56132,439,251,3,3,6,0,8,12,188
57567,1483,715,0,10,15,1,25,24,768
58454,391,240,0,0,7,0,3,5,151
58501,30050,15485,316,971,309,163,641,312,14565
60015,27452,13323,114,755,331,178,746,352,14129
78953,790,387,0,13,20,0,53,3,403
94530,25754,12097,53,1202,376,76,1112,471,13657
94559,27523,14057,151,931,387,157,1041,378,13466
22948,154,84,0,0,0,0,0,0,70
23148,1980,961,0,35,17,0,21,39,1019
2860,47127,23614,332,1446,358,328,1646,416,23513
4923,514,227,0,12,8,0,0,17,287
7107,37524,18179,360,1290,247,533,1422,425,19345
7876,10400,5050,34,190,126,32,144,258,5350
11021,18185,8355,47,719,151,72,605,299,9830
29436,4231,1929,0,260,22,0,93,159,2302
12502,1223,615,0,48,32,0,41,18,608
13051,299,124,0,0,12,0,0,0,175
28098,3629,1798,8,172,20,21,93,37,1831
80654,2647,1331,4,40,43,0,83,39,1316
81236,1364,628,0,55,50,0,21,21,736
65237,937,490,24,22,15,4,66,15,447
65655,3008,1462,15,37,65,39,45,30,1546
65672,9437,4432,120,278,48,116,128,126,5005
66083,9542,4664,24,415,141,0,437,85,4878
13602,4007,3572,561,65,0,0,33,0,435
13865,6135,3072,69,139,14,38,119,88,3063
15033,4762,2363,56,127,31,56,95,54,2399
17065,4153,2201,11,124,26,6,79,48,1952
17252,3690,1721,18,133,48,1,85,130,1969
3884,3896,1859,1,112,71,28,92,85,2037
19973,25134,12149,204,847,425,161,791,368,12985
20187,17713,8855,92,546,183,79,661,280,8858
20619,13533,6623,69,544,47,17,675,123,6910
74944,1195,624,14,23,11,3,22,17,571
83450,880,477,4,21,1,4,37,5,403
83541,1012,517,0,25,18,0,47,17,495
95524,1724,872,26,65,31,0,50,26,852
94066,43124,21159,215,1840,393,139,1792,507,21965
47965,609,315,6,39,8,9,32,3,294
11970,264,119,0,0,0,0,0,0,145
12520,2947,1335,18,64,29,78,69,46,1612
971,26640,13419,102,858,199,181,918,649,13221
41819,295,113,0,0,0,0,0,17,182
42372,1528,704,0,72,3,8,47,43,824
66080,922,455,7,19,8,3,19,14,467
68647,672,328,9,17,13,3,5,9,344
68853,1496,728,0,36,27,5,48,28,768
98575,157,74,1,0,2,11,0,9,83
97065,517,281,5,19,1,0,12,4,236
68454,720,390,2,17,2,2,24,2,330
78595,6053,2599,21,176,38,57,214,55,3454
92881,33996,17179,320,611,265,83,861,457,16817
83262,1283,686,0,30,0,0,33,44,597
86004,35798,17922,191,1338,491,333,1368,559,17876
86324,4589,2040,0,5,241,2,6,38,2549
66064,5857,2955,35,111,62,0,138,27,2902
72328,93,34,0,0,0,0,0,0,59
45853,1264,623,11,28,3,16,35,20,641
47035,210,109,0,14,0,0,0,0,101
47943,1065,527,20,0,0,0,0,0,538
47951,2265,1132,3,64,10,5,86,27,1133
48326,21829,11258,194,974,170,246,665,295,10571
48421,6323,3265,9,105,88,58,152,120,3058
37779,3110,1555,15,74,46,15,99,46,1555
39071,6108,2999,15,246,114,61,126,48,3109
62279,7,0,0,0,0,0,0,0,7
62892,374,166,0,25,4,23,7,6,208
52588,34,25,0,0,0,0,0,0,9
54613,1650,890,0,34,59,4,31,27,760
44830,18690,9239,152,499,234,111,773,234,9451
5352,964,510,4,34,11,3,21,24,454
13672,763,364,0,37,18,19,25,6,399
16669,1994,1007,10,40,44,4,50,29,987
24328,1562,744,0,61,71,0,69,76,818
10577,6373,2945,221,56,11,290,48,37,3428
11361,27246,13337,145,892,362,101,871,356,13909
20876,28919,13853,162,984,270,153,1285,316,15066
27865,2168,1045,62,34,17,18,62,53,1123
28334,24780,11646,367,564,270,105,564,338,13134
18954,9149,4581,58,282,144,42,215,127,4568
78352,487,236,0,0,0,0,26,18,251
58492,501,264,6,5,2,0,15,1,237
59039,39,19,0,2,7,0,0,2,20
59751,217,98,0,0,0,0,4,4,119
65644,1929,879,0,44,62,0,45,15,1050
66746,224,99,0,17,1,2,3,3,125
67142,377,206,0,5,8,0,0,8,171
70638,1227,588,12,39,1,3,39,53,639
57049,6399,3261,0,189,150,44,128,85,3138
57224,178,95,0,0,2,0,0,1,83
57243,780,386,20,19,5,22,9,9,394
57441,535,277,0,6,6,0,9,5,258
72515,0,0,0,0,0,0,0,0,0
73557,394,175,3,7,4,0,2,7,219
74349,312,146,1,6,4,5,8,1,166
32565,4826,2412,9,157,24,11,198,141,2414
46970,23381,12526,199,1016,311,101,602,213,10855
49868,5282,3170,74,325,58,17,117,112,2112
49970,288,173,0,3,3,0,5,6,115
54893,3711,1837,62,99,47,17,82,58,1874
55616,6882,3571,10,189,116,20,236,73,3311
56009,1345,675,2,44,20,9,41,23,670
56330,1723,857,9,63,16,5,71,28,866
38577,1209,629,15,0,7,0,13,44,580
38677,4644,1908,81,0,0,118,14,0,2736
30329,27878,13171,284,1141,159,233,1346,179,14707
33809,30137,14557,129,724,372,73,783,589,15580
46781,800,420,0,39,2,2,13,15,380
48133,5652,2726,0,171,45,43,150,67,2926
48725,2093,1056,30,30,33,0,24,60,1037
17250,95,60,0,0,0,0,0,0,35
17836,173,86,0,5,3,0,2,0,87
6260,9353,4279,68,223,111,27,318,87,5074
7418,2304,1281,28,68,43,10,42,44,1023
7718,7139,3522,13,140,50,66,242,88,3617
27939,2547,1141,0,48,44,0,118,24,1406
28431,7131,3781,8,72,83,141,204,85,3350
22642,4859,2517,62,314,21,33,169,64,2342
23459,1330,750,15,50,0,12,75,0,580
23708,476,366,115,24,0,9,0,0,110
25009,1381,751,0,38,0,12,54,30,630
19956,14777,6845,71,358,201,99,395,246,7932
25088,130,69,0,0,0,0,0,7,61
25214,503,231,0,20,0,0,0,0,272
26218,3014,1440,0,84,10,0,86,58,1574
26366,33,33,0,0,0,0,0,0,0
27502,40280,19738,114,1563,278,153,2105,312,20542
14468,17789,8846,35,523,181,21,652,343,8943
96126,103,74,0,0,0,0,0,0,29
93226,180,96,0,3,16,0,0,6,84
97636,431,217,2,13,12,0,6,4,214
3064,14301,7082,101,509,131,104,588,202,7219
3287,1566,717,11,22,10,5,13,39,849
601,17242,8426,78,447,283,165,499,309,8816
1223,2402,1244,5,57,39,9,49,34,1158
62807,702,374,15,27,0,2,35,1,328
62893,992,465,2,32,7,38,33,32,527
80905,16363,8492,113,633,149,147,616,314,7871
71837,5312,2836,119,174,31,0,195,43,2476
72209,32016,15802,228,1033,247,326,1126,467,16214
82838,248,134,0,32,9,0,17,29,114
83686,47628,23156,366,1640,446,248,1887,516,24472
57560,563,298,4,12,0,0,32,0,265
59028,547,306,0,11,14,7,24,16,241
65802,46888,22829,516,1842,318,514,1716,439,24059
73728,1969,999,0,47,17,18,22,19,970
77451,62,31,0,0,0,0,2,0,31
48820,17893,8618,85,448,261,82,626,230,9275
59242,61,32,0,3,3,0,4,0,29
34139,486,261,7,5,10,0,12,0,225
35548,1704,817,11,69,0,0,63,28,887
4005,23345,11421,232,532,299,264,644,359,11924
48601,35270,16630,237,702,411,196,1012,600,18640
45888,188,106,3,12,1,0,4,0,82
50134,749,422,13,27,10,0,28,6,327
50211,12816,6536,60,412,86,115,455,142,6280
36048,1470,732,68,35,18,1,68,19,738
30648,3094,1475,0,54,72,15,144,15,1619
2664,8850,4098,58,209,79,70,262,184,4752
24701,19667,9219,142,370,286,84,655,317,10448
20124,15761,8148,123,355,282,54,341,227,7613
20551,0,0,0,0,0,0,0,0,0
30120,41253,20124,265,1437,243,284,1676,528,21129
28307,17830,10409,895,356,0,328,269,7,7421
19320,54675,26806,332,1628,430,297,1577,765,27869
76463,382,192,0,4,0,0,1,3,190
28097,6074,2997,17,130,68,4,137,57,3077
34758,41094,21362,271,1440,396,266,1841,521,19732
85087,8510,4205,107,189,213,41,132,98,4305
24558,6037,2935,28,73,101,4,172,112,3102
90024,50288,22580,1899,990,312,2873,820,416,27708
78586,56284,27410,318,1994,471,267,1659,685,28874
78739,20312,10300,72,964,124,26,979,202,10012
79847,156,129,0,19,0,0,0,0,27
26422,464,194,0,32,0,0,19,14,270
98303,1187,626,0,0,17,0,31,0,561
96748,4380,2118,4,156,20,0,119,43,2262
27607,29536,14383,458,853,118,525,741,248,15153
6793,1368,735,0,37,49,17,0,0,633
40982,327,160,0,9,0,0,7,14,167
25025,122,60,0,0,0,0,0,0,62
51440,327,160,2,8,10,0,5,0,167
14755,3080,1634,17,104,35,11,67,32,1446
72012,13073,6518,90,575,272,106,480,200,6555
59029,742,377,0,9,7,4,14,5,365
61537,2754,1369,15,50,30,13,87,36,1385
84735,237,125,0,4,0,0,4,0,112
74441,5855,3097,30,164,38,17,181,69,2758
75235,19141,10227,193,591,210,287,780,165,8914
75601,16144,7765,56,533,168,105,421,143,8379
76490,79,47,0,0,5,0,0,0,32
81430,711,387,0,12,39,0,11,10,324
82061,0,0,0,0,0,0,0,0,0
89427,1207,589,10,31,3,15,37,3,618
91935,8332,4109,18,272,115,53,250,243,4223
78576,10971,5230,49,399,23,50,522,16,5741
79730,259,152,0,1,0,0,1,0,107
98276,660,346,5,24,0,5,16,0,314
98631,3529,1732,0,51,79,8,53,53,1797
73099,68676,33673,447,2727,616,437,2788,850,35003
66406,395,221,0,0,12,0,0,15,174
29406,33984,16602,428,1359,233,363,1398,212,17382
10709,9663,4527,25,161,110,40,231,119,5136
12137,1762,810,26,6,23,22,74,35,952
12738,328,148,0,16,0,0,31,12,180
13464,1378,696,6,9,11,4,21,3,682
14467,10056,5192,24,322,186,23,328,130,4864
63446,560,297,0,15,20,0,0,5,263
63457,308,150,13,10,0,0,0,4,158
71426,292,160,0,5,0,0,5,4,132
71838,948,491,0,0,43,0,36,30,457
50208,20693,10741,107,643,238,84,557,236,9952
50622,3230,1581,17,104,30,30,126,29,1649
48160,13502,7256,53,730,132,62,456,184,6246
48468,1048,543,3,19,45,2,14,32,505
21813,2654,1528,0,39,70,0,8,13,1126
21829,461,234,0,0,0,24,0,0,227
22509,40,40,0,0,0,0,0,0,0
23930,5148,2398,78,127,50,55,205,122,2750
3216,2548,1387,0,140,38,0,73,34,1161
4932,1192,561,4,34,8,2,11,19,631
5824,1220,591,0,22,3,14,40,25,629
16343,451,212,0,14,0,0,0,16,239
8722,11210,5734,56,315,119,153,374,65,5476
10930,8990,4724,14,180,86,63,252,144,4266
17982,462,205,3,6,8,0,12,10,257
18229,8791,4310,80,208,166,89,209,209,4481
87551,297,155,0,0,53,0,0,0,142
98068,392,191,6,10,20,0,0,0,201
98925,535,279,0,7,0,0,5,22,256
99645,30450,15632,332,1127,337,238,953,379,14818
77627,21636,10684,141,783,262,199,604,251,10952
77713,13469,7170,94,471,279,63,500,262,6299
54433,1835,947,7,69,44,8,43,28,888
54562,1921,967,7,19,30,0,60,48,954
55426,26550,13104,47,867,162,109,913,231,13446
65305,4029,2458,277,139,0,65,107,6,1571
65501,158,81,0,5,8,0,5,20,77
66612,2117,1103,0,92,21,65,109,26,1014
67747,238,128,0,2,2,0,5,6,110
68973,410,217,2,25,6,0,22,5,193
86505,8002,3838,87,192,48,43,221,87,4164
87410,17287,8101,135,481,226,46,614,190,9186
65706,15690,7864,53,518,228,119,401,153,7826
67475,160,79,3,3,0,0,7,1,81
69039,76,40,0,9,5,0,0,2,36
69150,316,167,8,9,9,0,2,6,149
59542,155,96,0,2,1,0,8,0,59
56050,1452,727,5,50,42,5,34,41,725
56318,1089,567,0,34,17,9,31,19,522
56720,18,13,0,0,0,0,0,0,5
63739,477,193,0,7,0,0,18,32,284
98418,9469,4558,7,388,127,23,333,121,4911
92845,16600,8352,122,512,161,84,495,281,8248
77364,1551,821,0,21,28,0,13,29,730
57356,1960,1006,14,48,11,16,47,17,954
72168,2475,2271,21,370,20,0,1,8,204
75126,44740,22083,173,1849,174,184,1861,357,22657
75652,16946,10145,166,847,137,50,442,120,6801
49791,360,181,0,8,13,9,3,0,179
51556,421,210,0,9,5,0,14,3,211
52253,3476,1695,9,81,31,34,80,41,1781
52625,2679,1330,7,66,18,48,46,17,1349
63743,80,50,0,4,0,0,0,0,30
65625,8570,4182,12,356,37,38,346,70,4388
66414,2926,1451,0,77,20,11,58,36,1475
68466,1779,985,0,51,34,0,20,19,794
54984,3172,1567,10,78,62,16,41,43,1605
70346,11388,5504,87,342,50,44,321,121,5884
61008,34292,16669,310,998,285,314,1248,289,17623
62215,1907,1032,8,36,7,12,99,26,875
82441,221,152,0,29,0,0,0,0,69
80623,951,465,4,27,3,7,28,6,486
95661,31327,15010,169,901,317,195,926,363,16317
98007,29174,15817,101,1433,62,167,865,183,13357
88268,173,110,0,0,0,0,0,34,63
93624,1041,647,11,71,23,0,72,4,394
92835,23867,11511,66,438,173,165,428,333,12356
77050,4999,2406,0,252,30,27,245,67,2593
99826,416,192,0,8,23,0,4,19,224
99927,38,20,0,0,0,0,0,0,18
37890,6799,3193,37,177,92,71,122,132,3606
41762,0,0,0,0,0,0,0,0,0
42788,302,144,0,0,0,0,0,0,158
97841,610,343,7,21,8,0,34,7,267
99734,1458,1159,7,128,34,0,22,27,299
1760,35763,17432,156,1261,388,36,1355,506,18331
56129,741,345,14,16,9,3,14,25,396
57067,459,206,0,20,0,5,6,0,253
41226,324,183,0,0,19,0,0,0,141
43438,202,116,0,3,4,0,1,5,86
35098,1068,578,0,23,31,9,41,7,490
52236,779,408,0,87,20,0,32,13,371
52776,4906,2513,7,174,47,14,163,26,2393
53039,4559,2403,18,83,50,28,110,93,2156
48328,26215,12750,114,929,359,120,680,439,13465
30555,2273,1282,0,108,25,0,103,40,991
31722,496,227,0,32,20,4,26,2,269
37771,17276,8420,108,522,227,71,690,267,8856
37851,50,29,0,0,0,0,0,8,21
38024,27329,12888,141,872,363,311,1094,331,14441
38369,1728,872,37,32,13,10,30,42,856
38481,1026,561,10,21,20,0,19,15,465
38961,932,362,0,0,0,0,68,0,570
39167,0,0,0,0,0,0,0,0,0
46184,13508,6577,107,366,87,54,508,248,6931
46705,1676,878,0,42,5,14,102,30,798
81418,1736,789,0,0,54,16,91,49,947
83123,477,239,0,22,0,0,21,0,238
62859,5829,2925,65,155,53,20,134,43,2904
63940,1344,690,0,33,58,0,40,22,654
71082,5095,2563,7,82,30,13,96,68,2532
71835,1212,692,0,3,5,0,29,9,520
68835,597,358,3,23,37,0,9,20,239
17967,2471,1255,9,74,33,0,86,59,1216
19081,10109,4953,73,291,98,189,160,99,5156
4730,9797,4791,11,353,113,102,330,126,5006
5669,675,340,0,21,5,0,15,21,335
6112,21100,9364,307,534,195,337,528,192,11736
15232,11320,5409,270,315,43,123,258,69,5911
69346,646,330,8,11,7,11,12,27,316
60040,5366,2753,64,227,38,0,259,66,2613
13642,9871,5547,39,162,89,20,170,200,4324
14091,1111,607,8,21,16,7,16,19,504
60424,2465,1257,21,34,18,20,36,25,1208
47803,20593,10629,387,684,242,244,459,267,9964
17815,30375,14406,690,860,347,905,756,366,15969
3885,7387,3895,0,281,77,95,229,120,3492
4265,1022,433,0,55,37,0,8,14,589
4564,602,320,0,0,12,0,16,16,282
16636,781,420,2,35,16,0,21,6,361
17066,5391,2571,25,129,123,38,145,64,2820
22041,28614,14166,144,916,387,180,1053,312,14448
1089,28666,14224,183,763,255,281,873,380,14442
19608,22697,11027,54,706,323,123,621,278,11670
29474,2136,1001,0,51,22,0,84,108,1135
12025,5404,2590,36,108,88,38,125,120,2814
27853,642,320,23,0,10,0,54,11,322
7853,12926,6393,70,383,185,178,343,199,6533
39751,1457,713,0,33,28,0,71,4,744
40444,14412,7017,111,311,113,34,448,144,7395
42029,6210,3115,77,162,161,9,215,112,3095
43128,2558,1282,6,96,19,7,47,16,1276
53577,1415,748,12,42,18,14,35,9,667
53933,4395,3032,29,348,44,19,53,52,1363
36768,898,412,0,3,36,15,46,0,486
38671,37554,17601,398,1514,317,363,1644,299,19953
56467,2561,1295,4,65,52,4,71,62,1266
56584,1356,686,12,26,13,11,41,24,670
56723,925,474,0,12,9,7,14,3,451
38610,3108,1650,102,49,23,26,43,12,1458
49010,17603,9379,63,710,221,96,481,254,8224
45698,305,127,4,0,4,0,27,19,178
41526,79,27,0,0,27,0,0,0,52
43512,27951,14086,265,795,298,106,859,480,13865
49417,31330,15512,164,907,391,179,836,412,15818
33931,10675,5178,17,41,305,12,41,228,5497
40940,478,259,0,17,0,0,32,6,219
7022,14269,6766,38,741,106,177,648,139,7503
1364,7785,3717,53,325,94,13,170,129,4068
2131,33771,15427,274,1446,283,170,1572,673,18344
93254,858,397,0,11,2,13,10,0,461
97239,17666,8516,52,752,235,29,683,125,9150
83011,39,4,0,0,0,0,0,0,35
84098,19362,9781,93,507,278,148,566,263,9581
84301,729,391,0,24,4,3,19,9,338
85934,322,165,0,0,0,0,0,35,157
77440,23,23,0,0,0,0,0,0,0
95825,35825,17270,362,1258,224,382,1286,381,18555
79380,124,70,3,2,0,0,2,2,54
79834,213,111,0,9,0,0,4,8,102
88424,60,50,0,0,0,0,0,0,10
91604,32117,15778,64,1312,261,107,1291,360,16339
12765,1095,583,0,33,0,0,8,9,512
13215,14892,7096,99,370,155,81,441,276,7796
14779,6785,3203,17,167,61,51,181,79,3582
14845,20451,9711,40,589,191,33,495,340,10740
8610,30493,15533,354,1077,301,259,1107,546,14960
17271,286,156,0,7,0,0,7,7,130
1564,8052,3958,34,360,96,23,266,59,4094
47969,152,76,0,4,1,0,9,2,76
15671,690,391,0,95,26,0,40,10,299
16036,160,74,0,2,1,0,2,7,86
17260,1106,532,7,24,25,4,13,16,574
6377,2898,1504,27,130,33,0,36,33,1394
6403,6115,2809,57,125,57,95,129,33,3306
12188,10952,5326,66,311,157,74,300,184,5626
4619,2998,1480,37,17,31,23,69,69,1518
14592,192,94,0,0,0,0,16,21,98
14859,804,388,8,18,15,0,19,19,416
77374,348,141,0,0,0,0,0,0,207
59727,214,120,0,7,1,0,6,13,94
15536,440,193,3,19,4,4,13,9,247
26062,20936,10121,76,448,269,76,541,267,10815
6234,8269,4804,107,199,152,0,287,73,3465
7111,54035,25769,414,1832,378,411,2006,689,28266
8826,5361,2713,52,200,38,24,156,100,2648
12603,42589,20622,447,1218,422,591,1057,483,21967
23056,471,228,0,0,0,0,0,23,243
13475,16,6,0,0,0,0,0,2,10
14105,4570,2097,10,103,44,11,149,52,2473
1346,427,180,3,7,10,5,15,3,247
38617,681,326,0,23,3,6,10,2,355
39232,7886,3581,34,315,60,180,307,212,4305
53532,15099,7199,75,689,185,37,600,265,7900
54121,2986,1580,0,48,28,25,52,50,1406
66106,24441,11939,217,868,174,68,837,203,12502
67418,137,69,0,1,2,0,0,0,68
64123,9580,4794,0,421,106,15,283,72,4786
57026,1198,645,3,81,6,2,36,33,553
60934,259,138,0,17,1,1,20,2,121
61614,28012,13243,118,1089,255,177,928,366,14769
73659,220,73,0,3,8,0,0,5,147
74837,255,115,0,1,0,2,8,5,140
75669,489,251,0,0,0,36,6,0,238
56345,14557,7217,56,426,212,19,504,246,7340
55725,121,52,0,1,4,0,0,5,69
56090,708,369,1,24,5,2,25,5,339
37380,6402,3089,12,101,114,21,116,148,3313
40337,5188,2503,46,146,54,29,129,135,2685
31757,10764,5017,43,279,124,74,439,192,5747
32033,4660,2385,126,94,36,8,49,10,2275
32796,20948,10251,102,362,294,118,488,390,10697
44023,17473,8755,11,304,259,10,509,294,8718
33913,23816,11597,146,397,423,254,636,365,12219
35211,24594,10947,265,528,263,198,616,483,13647
48616,7294,3707,17,227,136,26,266,68,3587
29126,2035,1076,6,75,28,0,59,41,959
50039,376,186,0,1,3,29,4,3,190
14619,14602,6622,255,313,71,121,524,165,7980
16841,6317,3284,45,185,176,61,139,73,3033
3047,1765,887,14,33,48,11,21,28,878
6249,7256,3902,21,234,127,129,214,91,3354
6457,46473,22598,510,1423,421,766,1374,845,23875
23358,85,42,0,0,0,0,0,0,43
24244,5886,3141,96,175,67,19,177,64,2745
18343,4155,1859,38,105,17,14,177,80,2296
13124,94,60,0,0,5,0,4,5,34
961,30784,14775,279,980,271,229,1033,482,16009
58542,259,148,4,6,13,2,0,1,111
59875,3961,2021,33,151,102,14,53,75,1940
61424,135,72,0,22,0,5,9,0,63
57383,799,414,0,33,13,12,16,6,385
32641,14989,7034,174,533,121,247,424,191,7955
40013,5143,2584,21,148,45,37,141,49,2559
40206,19804,9654,120,767,242,155,614,272,10150
41260,889,415,18,0,0,0,0,0,474
46322,22743,11177,159,645,215,117,667,370,11566
48174,31199,15441,177,820,289,337,1115,384,15758
50573,82,41,0,5,0,0,5,0,41
12130,729,334,0,0,0,0,9,0,395
13044,2621,1294,8,118,0,0,84,49,1327
31794,27308,13383,62,814,172,129,872,464,13925
24091,7564,3630,64,128,150,21,324,124,3934
30088,29984,13378,148,627,361,126,1409,491,16606
87564,284,181,0,17,64,0,0,0,103
94568,54420,27069,234,2700,332,157,2676,571,27351
94707,11916,5846,36,253,190,25,210,140,6070
98408,20531,10696,151,989,255,30,517,298,9835
99628,824,442,7,35,12,8,61,2,382
8343,5288,2541,49,135,130,20,150,76,2747
4684,1599,747,3,33,57,0,56,29,852
660,16180,7461,53,386,155,86,491,229,8719
1436,3392,1783,79,155,68,48,94,0,1609
26421,120,69,5,0,4,0,0,2,51
27511,34525,17145,145,1118,304,131,1301,564,17380
33467,53339,25644,266,1198,621,234,1390,426,27695
36526,34669,17147,238,1091,230,70,1260,619,17522
37034,7246,3331,44,340,91,19,430,146,3915
38103,14044,8227,152,760,154,65,335,114,5817
19803,22236,10401,25,611,228,72,649,316,11835
20785,37601,17025,168,1173,318,285,1143,468,20576
24934,340,207,0,17,0,0,0,21,133
82701,5486,2904,36,180,72,28,165,123,2582
71603,31731,15343,177,830,284,96,1027,604,16388
72041,1352,704,0,16,24,7,45,23,648
72941,5400,2658,12,173,25,17,181,76,2742
73098,4394,2227,58,135,34,28,172,51,2167
94560,46276,23427,262,1751,477,346,1615,539,22849
95843,46709,23246,346,1459,197,451,1774,359,23463
95953,10942,5518,83,385,100,139,338,97,5424
97358,2689,1330,0,103,0,8,71,47,1359
97760,7117,3605,14,120,150,0,277,64,3512
97865,1076,528,7,12,14,5,14,10,548
97908,34,13,0,0,0,0,0,0,21
91343,66590,32471,596,2251,403,574,2352,616,34119
94112,85166,42556,556,2953,1099,489,2243,1375,42610
74567,96,45,0,0,3,0,0,0,51
85022,51426,24382,318,1435,504,313,1753,814,27044
38639,1116,479,18,39,5,25,37,23,637
39189,3821,2029,87,178,65,38,117,29,1792
42023,2290,1095,7,51,30,5,59,19,1195
42024,1179,548,1,27,15,4,33,9,631
54971,10579,4958,93,294,179,134,334,197,5621
2048,23761,11860,136,477,284,59,667,238,11901
2124,55821,25276,516,1478,429,257,2074,503,30545
68759,213,111,0,0,2,0,0,5,102
60917,529,254,21,28,1,0,34,12,275
62204,7954,3624,53,238,94,78,241,186,4330
56211,402,219,0,8,10,2,7,17,183
62867,506,229,0,6,3,0,8,2,277
71485,2142,1011,0,37,4,5,51,47,1131
78143,249,72,0,0,0,0,1,0,177
78725,7886,4172,31,508,25,72,304,90,3714
95672,5220,2444,17,128,93,19,211,100,2776
97134,175,106,0,0,12,0,0,12,69
99030,1037,581,5,15,28,8,26,17,456
93634,21,8,0,0,0,0,0,0,13
38928,128,47,0,0,0,0,0,0,81
40036,198,106,0,3,0,0,0,0,92
33322,39049,17719,169,1079,465,195,920,605,21330
33470,26384,13410,346,721,196,133,917,425,12974
33635,18353,8815,97,733,169,126,832,191,9538
62803,1078,537,4,35,8,5,44,16,541
19153,13190,6063,104,512,61,253,550,180,7127
70661,1978,801,0,44,0,0,103,9,1177
70750,1443,691,30,33,27,19,91,10,752
57446,398,207,0,24,4,0,12,5,191
49630,1398,695,13,12,52,2,26,32,703
52157,1787,883,5,48,31,0,53,11,904
44708,25541,12287,89,852,314,99,760,387,13254
46571,5465,2810,23,205,13,27,176,45,2655
50548,5663,2662,28,208,89,74,148,78,3001
54017,17585,8856,118,707,186,63,707,226,8729
36916,846,459,0,16,13,0,7,7,387
37130,57071,27402,1026,1307,377,1142,1569,380,29669
37828,1264,593,0,23,7,0,35,24,671
37886,4967,2307,17,68,25,21,133,80,2660
58707,515,276,32,1,0,24,0,0,239
38947,312,139,0,13,0,0,12,5,173
40214,45352,22149,336,1655,481,282,1765,461,23203
40964,42,19,0,0,11,0,0,7,23
55012,2013,1097,16,48,40,14,20,31,916
55397,2825,1415,6,71,35,0,190,59,1410
28589,182,75,0,0,0,0,8,0,107
29006,10720,5068,57,256,181,21,347,104,5652
30350,39464,19183,239,1441,166,137,2294,423,20281
31037,4619,2806,39,159,37,7,158,58,1813
18334,5182,2614,0,87,48,0,195,65,2568
14622,11976,5768,34,345,240,0,297,218,6208
32616,1142,607,0,38,3,8,54,0,535
23507,6715,3245,63,184,71,34,158,88,3470
24378,1068,498,7,9,37,0,10,31,570
4671,523,273,4,12,6,0,9,3,250
11557,7480,3485,8,193,62,26,181,139,3995
11796,3826,1857,21,74,29,12,87,37,1969
11978,3058,1493,0,100,42,14,53,66,1565
12020,33456,16807,327,1108,323,120,1136,434,16649
6512,28778,13424,87,824,332,126,611,430,15354
3580,1306,623,3,5,23,24,7,45,683
54476,18916,9442,107,604,298,142,775,167,9474
4062,18270,9146,145,649,200,70,588,207,9124
61091,45,20,0,0,0,0,0,0,25
69125,328,175,0,8,8,0,6,3,153
76372,1179,529,7,32,6,0,40,2,650
41759,271,136,0,9,0,0,0,9,135
78251,60107,28795,440,2113,299,625,2542,578,31312
39211,24628,11434,134,765,168,221,883,209,13194
56387,7316,3450,82,180,40,84,74,76,3866
72555,168,81,0,0,5,0,0,0,87
84520,1073,519,18,15,13,0,24,20,554
40759,2493,1119,0,95,9,0,65,0,1374
40823,3640,1670,0,111,34,7,118,48,1970
98512,29679,15134,146,1338,304,156,987,542,14545
99648,86,43,3,1,1,3,4,1,43
97221,12328,6184,38,512,225,51,427,230,6144
89404,28,13,0,0,0,0,0,0,15
30134,44114,20676,399,1099,387,248,1967,517,23438
30455,465,218,0,12,0,0,11,5,247
27896,20681,9910,102,376,222,58,527,352,10771
28012,22968,11222,96,954,201,126,671,384,11746
44839,12264,5886,56,224,207,84,308,128,6378
45827,2050,1025,0,79,24,14,46,30,1025
33327,23762,11310,101,498,115,323,783,392,12452
97341,2532,1278,14,63,30,0,38,90,1254
32445,2525,1884,21,236,37,5,22,7,641
98844,4373,2278,15,72,44,14,120,84,2095
45696,1595,601,0,0,0,0,30,0,994
16351,1526,768,0,29,27,7,36,41,758
16648,14922,7139,36,295,230,25,412,193,7783
17068,4180,2109,11,174,51,18,89,85,2071
21146,28006,13820,65,867,270,71,687,409,14186
23944,3585,1503,45,128,63,30,29,74,2082
29664,2084,1022,0,43,32,20,46,28,1062
18853,4089,2025,11,108,50,24,114,81,2064
19544,131,88,0,19,0,0,5,0,43
4049,3727,1804,0,103,81,0,121,27,1923
61084,3085,1473,55,41,13,0,46,29,1612
2532,13238,6470,63,184,90,40,357,221,6768
55438,16469,7828,35,453,192,24,392,303,8641
21702,42028,20169,283,1382,323,165,1496,391,21859
78634,30934,15040,108,1446,99,134,1686,252,15894
99626,283,149,1,4,1,9,16,5,134
67449,2919,1491,0,122,92,0,70,67,1428
97457,10189,5123,25,232,252,0,231,166,5066
1721,17576,8599,36,571,168,103,609,215,8977
39361,1173,523,11,10,30,0,50,44,650
76225,3035,1517,21,94,17,21,101,43,1518
82423,145,67,0,0,0,0,3,0,78
59085,122,68,0,0,3,0,0,3,54
93285,2085,978,48,51,57,0,0,53,1107
42635,4602,3077,15,300,37,15,12,25,1525
48836,13920,7105,64,470,112,103,453,148,6815
32227,3087,2078,266,76,0,54,72,0,1009
11561,37662,17933,228,1022,440,191,1017,758,19729
12972,6034,3040,64,151,110,0,177,64,2994
67736,193,94,0,7,4,0,6,4,99
36482,573,271,0,0,0,0,32,0,302
70345,9677,4774,0,331,76,11,556,175,4903
18854,1611,762,3,67,31,5,63,49,849
65301,33830,16545,311,913,428,310,974,451,17285
62953,313,164,0,2,1,0,4,0,149
23414,175,139,0,0,0,0,0,0,36
65664,165,76,0,14,3,0,20,0,89
8019,1115,621,17,48,14,11,15,18,494
20742,6719,3487,161,0,0,99,0,0,3232
11804,4916,2429,22,130,46,10,200,29,2487
61417,286,139,0,0,0,10,0,0,147
12148,4414,2051,0,194,112,17,150,58,2363
39202,8013,4022,110,138,194,106,246,56,3991
18077,2385,1222,13,65,51,0,71,47,1163
39479,5533,2710,10,204,39,0,168,113,2823
26576,544,213,0,66,0,0,55,9,331
67138,336,149,5,1,6,0,1,0,187
48835,3144,1662,25,96,45,22,58,21,1482
35060,332,176,0,23,0,0,0,0,156
89042,990,426,0,0,0,20,0,0,564
90064,25429,12354,127,899,251,83,835,369,13075
75153,397,185,0,14,0,2,0,7,212
94301,17191,8544,16,502,266,25,543,145,8647
94922,603,272,29,12,0,0,14,4,331
96137,3336,1619,0,62,99,22,93,120,1717
16617,2781,1473,3,82,29,3,66,51,1308
61845,383,187,0,17,7,0,2,37,196
19012,6702,3443,13,175,94,24,158,147,3259
68714,1181,598,12,29,14,5,30,12,583
20781,11626,5945,82,582,62,104,477,105,5681
72061,119,63,10,13,0,16,0,0,56
25121,886,424,18,0,0,0,0,0,462
25654,285,164,11,0,0,0,0,0,121
79830,7883,3878,37,394,103,14,128,90,4005
76630,1271,723,0,33,22,0,32,22,548
56716,9274,4715,192,274,157,153,263,153,4559
83228,735,346,14,38,2,3,56,12,389
85940,1325,748,53,41,42,0,29,53,577
96734,50386,26469,908,1760,517,265,1556,657,23917
91108,13538,6394,64,268,338,13,417,333,7144
92115,65853,31899,1048,2005,401,1162,2043,600,33954
95075,484,222,0,2,0,0,7,15,262
30152,43310,20870,263,1372,275,384,1370,648,22440
5152,355,159,0,2,8,0,8,3,196
2720,30699,15010,316,1035,377,295,790,525,15689
41464,635,369,0,58,0,0,26,10,266
54760,279,116,0,3,11,0,12,0,163
1062,10495,5108,74,261,228,0,267,96,5387
54913,20699,10309,61,585,140,78,686,190,10390
55310,1303,652,0,40,25,2,17,50,651
17765,1196,613,3,22,12,0,29,20,583
42743,9145,4452,63,232,126,12,211,110,4693
18464,1195,648,11,15,51,9,20,23,547
43106,1589,796,0,40,19,2,52,2,793
19456,630,288,0,0,7,0,0,0,342
37035,3340,1628,0,72,24,7,115,31,1712
53924,1457,750,3,36,25,7,37,12,707
92260,34225,16598,123,814,585,75,659,396,17627
58528,785,351,0,18,0,0,30,3,434
72102,3381,1570,0,98,1,1,82,17,1811
99185,1275,647,0,30,23,10,20,18,628
74127,15724,7460,51,409,178,115,463,155,8264
37404,12772,6617,145,566,131,111,528,186,6155
50642,509,228,2,24,9,25,3,3,281
79124,8805,4224,22,482,111,11,250,134,4581
30655,25210,12095,238,696,51,146,781,367,13115
80227,36034,17339,241,1233,519,276,1115,603,18695
32609,19906,9686,190,826,278,147,528,250,10220
33142,58574,28467,322,1983,413,375,1946,787,30107
68861,91,50,0,7,0,0,2,0,41
36615,0,0,0,0,0,0,0,0,0
72624,438,146,0,8,6,69,8,0,292
38748,3488,1672,47,91,6,38,71,47,1816
76424,8811,4462,102,249,120,34,287,110,4349
46390,3085,1564,8,108,52,19,131,16,1521
86303,17194,8174,14,320,551,25,281,371,9020
34239,15499,7418,129,412,198,20,410,402,8081
26707,254,127,3,6,7,0,7,8,127
55924,1388,778,18,24,18,3,41,18,610
4541,41,27,0,0,0,0,0,0,14
48313,33610,16556,189,939,503,283,956,418,17054
35766,123,60,0,6,0,0,9,0,63
43504,1261,639,19,21,26,6,51,27,622
48229,9372,4338,23,336,61,0,343,127,5034
45620,955,527,20,13,24,0,6,15,428
58569,73,51,0,2,0,0,0,0,22
47610,5028,2365,0,164,94,9,172,80,2663
37818,5651,2892,57,270,84,1,243,77,2759
12864,24,13,0,2,0,0,3,0,11
12944,4100,2075,5,138,51,23,171,69,2025
60639,90517,45009,614,3680,711,757,3308,924,45508
15235,34744,16210,150,1124,434,215,966,697,18534
64125,1389,719,5,80,4,0,41,13,670
79036,5135,2493,8,121,62,4,177,115,2642
80015,67959,33564,309,2471,579,223,2567,866,34395
59052,138,82,0,0,0,0,0,1,56
76088,11827,5854,60,190,147,97,267,163,5973
20002,64895,31111,236,3472,249,339,3032,579,33784
59856,431,256,22,9,10,0,7,3,175
23801,5409,2940,81,266,7,30,191,21,2469
68640,1598,900,3,33,14,0,30,15,698
62443,1678,881,0,56,28,51,54,42,797
18438,1122,555,0,18,0,12,39,24,567
70372,2931,1551,28,86,81,0,84,45,1380
19518,15586,7710,129,428,103,59,340,202,7876
85718,26398,12847,31,491,661,103,540,569,13551
15764,176,101,0,3,11,0,0,0,75
13676,17016,8921,630,279,137,452,335,149,8095
26679,1870,990,0,22,36,0,81,49,880
32044,1824,843,0,19,7,57,32,30,981
32953,24181,11727,105,490,255,77,640,459,12454
44651,656,351,0,46,13,0,8,7,305
8080,36988,17923,296,791,486,234,973,632,19065
48911,40041,18494,172,1277,513,304,1116,465,21547
29809,2568,1185,0,65,12,31,134,5,1383
49818,972,486,0,18,24,0,26,6,486
12439,290,120,0,0,0,0,0,9,170
31038,566,321,0,15,0,0,0,5,245
12874,153,75,0,0,2,0,0,0,78
15207,11324,5442,0,351,125,26,375,99,5882
52647,210,112,2,10,1,2,14,1,98
16683,348,186,0,8,1,0,13,12,162
